	sequence	group
AACATAGGGGGCAAGCGTTGTCCGGAATCACTGGGCGTAAAGGGCGCGTAGGTGGTCTGTTAAGTCAGATGTGAAATGTAAGGGCTCAACCCTTAACGTGCATCTGATACTGGCAGACTTGAGTGCGGAAGAGGCAAGTGGAATTCCTAG	AACATAGGGGGCAAGCGTTGTCCGGAATCACTGGGCGTAAAGGGCGCGTAGGTGGTCTGTTAAGTCAGATGTGAAATGTAAGGGCTCAACCCTTAACGTGCATCTGATACTGGCAGACTTGAGTGCGGAAGAGGCAAGTGGAATTCCTAG	1.0
AACGGAGGGAGCTAGTGTTATTATGTTGACTGGGCGTAGGGTACGTAGGTGGTGAAATAAATAAAAAATGAAATACTAGATTATCATCTTTTCTGTTTTTTTGTAATTTCACTTGAATCTTAGATGGGACGATGGTACTTTTTAAGTAAC	AACGGAGGGAGCTAGTGTTATTATGTTGACTGGGCGTAGGGTACGTAGGTGGTGAAATAAATAAAAAATGAAATACTAGATTATCATCTTTTCTGTTTTTTTGTAATTTCACTTGAATCTTAGATGGGACGATGGTACTTTTTAAGTAAC	1.0
AACGGGGGGAGCTAGTGTTATTGTGTTGACTGGGCGTAGGGTATGTAGGTGGTGAAAAAAGGAGTAAATGAAATACTGGAACATCATCCTTTATGTTTTCTCGTCTATTTCACTAGAATTTAGAGAGGACAAAGGTACATTATATGGAAG	AACGGGGGGAGCTAGTGTTATTGTGTTGACTGGGCGTAGGGTATGTAGGTGGTGAAAAAAGGAGTAAATGAAATACTGGAACATCATCCTTTATGTTTTCTCGTCTATTTCACTAGAATTTAGAGAGGACAAAGGTACATTATATGGAAG	1.0
AACGTAGGTCACAAGCGTTGTCCGGAATTACTGGGTGTAAAGGGAGCGCAGGCGGGAATGCAAGTTGGGAGTGAAATCTACGGGCTCAACCCGTAAACTGCTCTCAAAACTGTATTTCTTGAGTAGTGCAGAGGTAGGCGGAATTCCCGG	AACGTAGGTCACAAGCGTTGTCCGGAATTACTGGGTGTAAAGGGAGCGCAGGCGGGAATGCAAGTTGGGAGTGAAATCTACGGGCTCAACCCGTAAACTGCTCTCAAAACTGTATTTCTTGAGTAGTGCAGAGGTAGGCGGAATTCCCGG	1.0
AACGTAGGTCACAAGCGTTGTCCGGAATTACTGGGTGTAAAGGGAGCGCAGGCGGGTATGCAAGTTGGAAGTGAAATACATGGGCTCAACCCATGAACTGCTTTCAAAACTGTGTATCTTGAGTAGTGCAGAGGTAGGCGGAATTCCCGG	AACGTAGGTCACAAGCGTTGTCCGGAATTACTGGGTGTAAAGGGAGCGCAGGCGGGTATGCAAGTTGGAAGTGAAATACATGGGCTCAACCCATGAACTGCTTTCAAAACTGTGTATCTTGAGTAGTGCAGAGGTAGGCGGAATTCCCGG	1.0
AACGTAGGTCACAAGCGTTGTCCGGAATTACTGGGTGTAAAGGGAGCGCAGGCGGGTATGCAAGTTGGGAGTGAAATACATGGGCTCAACCCATGAACTGCTCTCAAAACTGTGTATCTTGAGTAGTGCAGAGGTAGGCGGAATTCCCGG	AACGTAGGTCACAAGCGTTGTCCGGAATTACTGGGTGTAAAGGGAGCGCAGGCGGGTATGCAAGTTGGGAGTGAAATACATGGGCTCAACCCATGAACTGCTCTCAAAACTGTGTATCTTGAGTAGTGCAGAGGTAGGCGGAATTCCCGG	1.0
AACGTAGGTCACAAGCGTTGTCCGGAATTACTGGGTGTAAAGGGAGCGCAGGCGGGTTTTCAAGTTGGGAGTGAAATACATGGGCTCAACCCATGAACTGCTCTCAAAACTGGAGATCTTGAGTAGTGCAGAGGTAGGCGGAATTCCCGG	AACGTAGGTCACAAGCGTTGTCCGGAATTACTGGGTGTAAAGGGAGCGCAGGCGGGTTTTCAAGTTGGGAGTGAAATACATGGGCTCAACCCATGAACTGCTCTCAAAACTGGAGATCTTGAGTAGTGCAGAGGTAGGCGGAATTCCCGG	1.0
AACGTAGGTCACGAGCGTTGTCCGGAATTACTGGGTGTAAAGGGAGCGCAGGCGGGTAGACAAGTTGGGAGTGAAATGCATGGGCTCAACCCATGAACTGCTCTCAAAACTGTAGATCTTGAGTAGTGCAGAGGTAGGCGGAATTCCCGG	AACGTAGGTCACGAGCGTTGTCCGGAATTACTGGGTGTAAAGGGAGCGCAGGCGGGTAGACAAGTTGGGAGTGAAATGCATGGGCTCAACCCATGAACTGCTCTCAAAACTGTAGATCTTGAGTAGTGCAGAGGTAGGCGGAATTCCCGG	1.0
AACGTAGGTCACGAGCGTTGTCCGGAATTACTGGGTGTAAAGGGAGCGCAGGCGGGTATGCAAGTTGGGAGTGAAATACATGGGCTCAACCCATGAACTGCTCTCAAAACTGTGTATCTTGAGTAGTGCAGAGGTAGGCGGAATTCCCGG	AACGTAGGTCACGAGCGTTGTCCGGAATTACTGGGTGTAAAGGGAGCGCAGGCGGGTATGCAAGTTGGGAGTGAAATACATGGGCTCAACCCATGAACTGCTCTCAAAACTGTGTATCTTGAGTAGTGCAGAGGTAGGCGGAATTCCCGG	1.0
AACGTAGGTGGCAAGCGTTGTCCGGAATTACTGGGTGTAAAGGGAGCGCAGGCGGGAGAGCAAGTTGGGAGTGAAATCTATGGGCTCAACCCATAAATTGCTTTCAAAACTGCTTTTCTTGAGTAGTGCAGAGGTAGGCGGAATTCCCGG	AACGTAGGTGGCAAGCGTTGTCCGGAATTACTGGGTGTAAAGGGAGCGCAGGCGGGAGAGCAAGTTGGGAGTGAAATCTATGGGCTCAACCCATAAATTGCTTTCAAAACTGCTTTTCTTGAGTAGTGCAGAGGTAGGCGGAATTCCCGG	1.0
AACGTAGGTGGCAAGCGTTGTCCGGAATTACTGGGTGTAAAGGGAGCGCAGGCGGGCTGTCAAGTTGGAAGTGAAATCTATGGGCTCAACCCATAAATTGCTTTCAAAACTGATGGTCTTGAGTAGTGCAGAGGTAGGCGGAATTCCCGG	AACGTAGGTGGCAAGCGTTGTCCGGAATTACTGGGTGTAAAGGGAGCGCAGGCGGGCTGTCAAGTTGGAAGTGAAATCTATGGGCTCAACCCATAAATTGCTTTCAAAACTGATGGTCTTGAGTAGTGCAGAGGTAGGCGGAATTCCCGG	1.0
AACGTAGGTGGCGAGCGTTATCCGGAATTATTGGGCGTAAAGAGGGAGCAGGCGGTCGTGAAGGTCCACTGGTAAAAGACCGGGGCTAAACCCCGGTAGGCCGAGGAAACCGTACGACTAGAGTACAGCAGAGGATCGTGGAATTCCATG	AACGTAGGTGGCGAGCGTTATCCGGAATTATTGGGCGTAAAGAGGGAGCAGGCGGTCGTGAAGGTCCACTGGTAAAAGACCGGGGCTAAACCCCGGTAGGCCGAGGAAACCGTACGACTAGAGTACAGCAGAGGATCGTGGAATTCCATG	1.0
CACAAGTAAGACAAGTGTTATTCATCATTATTAGGTTTAAAGCGTACCTAGACGGCAATTTACACGAAAGTTAATTTTTTGCTAGAGTTTAATAGGGGAGGATAATATTAGGACGATTGGTGTAGAGATGAAATTCTTTGATACTAATCG	CACAAGTAAGACAAGTGTTATTCATCATTATTAGGTTTAAAGCGTACCTAGACGGCAATTTACACGAAAGTTAATTTTTTGCTAGAGTTTAATAGGGGAGGATAATATTAGGACGATTGGTGTAGAGATGAAATTCTTTGATACTAATCG	1.0
CACAAGTAAGACAAGTGTTATTCATCATTATTAGGTTTAAAGCGTACCTAGACGGCAATTTACACGAGAGTCAATTTTTTGCTAGAGTTTAATAGGGGAGGAAAATATTAGGACGATTGGTGTAGAGATGAAATTCTTTGATACTAATCG	CACAAGTAAGACAAGTGTTATTCATCATTATTAGGTTTAAAGCGTACCTAGACGGCAATTTACACGAGAGTCAATTTTTTGCTAGAGTTTAATAGGGGAGGAAAATATTAGGACGATTGGTGTAGAGATGAAATTCTTTGATACTAATCG	1.0
CACAAGTAAGACAAGTGTTATTCATCATTATTAGGTTTAAAGCGTACCTAGACGGCAATTTATACGTAAGTCAATTTTTTGCTAGAGTTTAATAGGGGAGGAAGATATTAGGACTATTGGTGTAGAGATGAAATTTTTTGATACTAATAG	CACAAGTAAGACAAGTGTTATTCATCATTATTAGGTTTAAAGCGTACCTAGACGGCAATTTATACGTAAGTCAATTTTTTGCTAGAGTTTAATAGGGGAGGAAGATATTAGGACTATTGGTGTAGAGATGAAATTTTTTGATACTAATAG	1.0
CACAAGTAAGACGAGTGTTATTCATCATTATTAGGTTTAAAGCGTACCTAGACGGCATTTTACACCGATGGAAAGGTTAATTTTTTGCTGGAGTTTAATAGGAGAGGTAGATATTAGGACTATTGGTGTAGAGATGAAATTCTTTGATAC	CACAAGTAAGACGAGTGTTATTCATCATTATTAGGTTTAAAGCGTACCTAGACGGCATTTTACACCGATGGAAAGGTTAATTTTTTGCTGGAGTTTAATAGGAGAGGTAGATATTAGGACTATTGGTGTAGAGATGAAATTCTTTGATAC	1.0
CACGTAGGGGGCAAGCGTTGTCCGGATTTATTGGGCGTAAAGAGCTCGTAGGCGGCTGAGTAAGTCGGATGTCAAATCCTCAGGCTCAACCTGGGGCTCCATCCGATACTGCTCTGGCTAGAGTCCGGTAGGGGAGCGTGGAATTCCTGG	CACGTAGGGGGCAAGCGTTGTCCGGATTTATTGGGCGTAAAGAGCTCGTAGGCGGCTGAGTAAGTCGGATGTCAAATCCTCAGGCTCAACCTGGGGCTCCATCCGATACTGCTCTGGCTAGAGTCCGGTAGGGGAGCGTGGAATTCCTGG	1.0
GACAAGGGAGACAAGTGTTATTCATCTTTAACAGGTATATAGGGTACCTAGACGGTGTACAAAGGCTTTTATAAGTACCTATTACACTTGAGTTTGATATGGAAGAGGAATATGTCGGAATTAATGGTGTAAAGATGAAATTTGTTAATA	GACAAGGGAGACAAGTGTTATTCATCTTTAACAGGTATATAGGGTACCTAGACGGTGTACAAAGGCTTTTATAAGTACCTATTACACTTGAGTTTGATATGGAAGAGGAATATGTCGGAATTAATGGTGTAAAGATGAAATTTGTTAATA	1.0
GACAAGGGAGACAAGTGTTATTCATCTTTAACAGGTATATAGGGTACCTAGACGGTGTACAAAGGCTTTTATAAGTACCTATTACACTTGAGTTTGATATGGAAGAGGAATATGTCGGAATTAGTGGTGTAAAGATGAAATTTGTTAATA	GACAAGGGAGACAAGTGTTATTCATCTTTAACAGGTATATAGGGTACCTAGACGGTGTACAAAGGCTTTTATAAGTACCTATTACACTTGAGTTTGATATGGAAGAGGAATATGTCGGAATTAGTGGTGTAAAGATGAAATTTGTTAATA	1.0
GACAAGGGAGACGAGTGTTATTCATCTTTAACAGGTATATAGGGTACCTAGACGGTGTGCAATGGCTTAAATAAGTACCTGGTACACTTGAGTTTGATATGTGAGAGGAATATGTCGGAATTGTTGGAGGAAAGATGAAATTTGTTAATA	GACAAGGGAGACGAGTGTTATTCATCTTTAACAGGTATATAGGGTACCTAGACGGTGTGCAATGGCTTAAATAAGTACCTGGTACACTTGAGTTTGATATGTGAGAGGAATATGTCGGAATTGTTGGAGGAAAGATGAAATTTGTTAATA	1.0
GACAAGTAAGACTAGTGTTATTCATCTTTAATAGGTGTAAAGGGTACCTAGACGGTAAATTTAGCCCCTAAAGGGTACAGATTTTACTAGAGTTTAGTTGTGAGAGGTATATATTAGTACTGTTAGTGTAGAGATAAAATTCTTTGATAG	GACAAGTAAGACTAGTGTTATTCATCTTTAATAGGTGTAAAGGGTACCTAGACGGTAAATTTAGCCCCTAAAGGGTACAGATTTTACTAGAGTTTAGTTGTGAGAGGTATATATTAGTACTGTTAGTGTAGAGATAAAATTCTTTGATAG	1.0
GACAGAAAGGGCGACCCATTGGAGTTTTAAATTGGTGTAAAGGATACGTAGCCGGCCATAAAAATGGCTAGAGTCAAATAGAAGTAATTACAATACCTAGAGTAGGGCTGATATCTTATGATACTAGGGGGAGTGCTAAAGGCGAAGGCA	GACAGAAAGGGCGACCCATTGGAGTTTTAAATTGGTGTAAAGGATACGTAGCCGGCCATAAAAATGGCTAGAGTCAAATAGAAGTAATTACAATACCTAGAGTAGGGCTGATATCTTATGATACTAGGGGGAGTGCTAAAGGCGAAGGCA	1.0
GACGTAGAAGACTAGTGTTATTCATCTTTAATAGGTTTAAAGGGTACCTAGACGGTGTAATTAGTCCTAAATAAGAAACGATTATACTAGAGTTATATATGAGGAGGGGAGTATTTATGGAGTAGAGTTGAAATTCTGTCATACTATAAC	GACGTAGAAGACTAGTGTTATTCATCTTTAATAGGTTTAAAGGGTACCTAGACGGTGTAATTAGTCCTAAATAAGAAACGATTATACTAGAGTTATATATGAGGAGGGGAGTATTTATGGAGTAGAGTTGAAATTCTGTCATACTATAAC	1.0
GACGTGGAAGACTAGTGTTATTCATCTTTAATAGGTTTAAAGGGTACCTAGACGGTAAATCCAGCCAAATAGGTACAGATTTGCTAGAGTTTAATATGTAAGAAGGTAGTATTTTTGGTGGAGAGATAGAATATTTTTATACCAGAAGGA	GACGTGGAAGACTAGTGTTATTCATCTTTAATAGGTTTAAAGGGTACCTAGACGGTAAATCCAGCCAAATAGGTACAGATTTGCTAGAGTTTAATATGTAAGAAGGTAGTATTTTTGGTGGAGAGATAGAATATTTTTATACCAGAAGGA	1.0
GACggggggggCAAGTGTTATTCGGAATGACTAGGCGTAAAGGGCACGTAGGCGGTGAATCTGCAGGGTTGGAAGTGAAAGTCGCCAACAATTGGCGGGGTGCTTTCGGAACCAATTCACTTGAGTGAGATAGGGGAGAGTGGAATTTCG	GACggggggggCAAGTGTTATTCGGAATGACTAGGCGTAAAGGGCACGTAGGCGGTGAATCTGCAGGGTTGGAAGTGAAAGTCGCCAACAATTGGCGGGGTGCTTTCGGAACCAATTCACTTGAGTGAGATAGGGGAGAGTGGAATTTCG	1.0
GACggggggggCAAGTGTTCTTCGGAATGACTGGGCGTAAAGGGCACGTAGGCGGTGAATCGGGTTGAAAGTGAAAGTCGCCAAAAAGTGGCGGAATGCTCTCGAAACCAATTCACTTGAGTGAGACAGAGGAGAGTGGAATTTCGTGTG	GACggggggggCAAGTGTTCTTCGGAATGACTGGGCGTAAAGGGCACGTAGGCGGTGAATCGGGTTGAAAGTGAAAGTCGCCAAAAAGTGGCGGAATGCTCTCGAAACCAATTCACTTGAGTGAGACAGAGGAGAGTGGAATTTCGTGTG	1.0
TACAAGTAAGACTAGTGTTATTCATCTTAATTAGGTTTAAAGGGTACCTAGACAGTATTTCTAGCCTCCAAAGGGAACAGATTTACTAGAGTTTTATGTGAGAGGAAAATATTAGAACCATTGGAGTAGTGATAAAATGTTTTGATACTA	TACAAGTAAGACTAGTGTTATTCATCTTAATTAGGTTTAAAGGGTACCTAGACAGTATTTCTAGCCTCCAAAGGGAACAGATTTACTAGAGTTTTATGTGAGAGGAAAATATTAGAACCATTGGAGTAGTGATAAAATGTTTTGATACTA	1.0
TACAGAGGGTGCAAGCGTTAATCGGAATTACTGGGCGTAAAGCGAGCGTAGGTGGCTTGATAAGTCAGATGTGAAAGCCCCGGGCTTAACCTGGGAACGGCATCTGATACTGTTAGGCTAGAGTAGGTGAGAGGAAGGTAGAATTCCAGG	TACAGAGGGTGCAAGCGTTAATCGGAATTACTGGGCGTAAAGCGAGCGTAGGTGGCTTGATAAGTCAGATGTGAAAGCCCCGGGCTTAACCTGGGAACGGCATCTGATACTGTTAGGCTAGAGTAGGTGAGAGGAAGGTAGAATTCCAGG	1.0
TACAGAGGGTGCAAGCGTTAATCGGAATTACTGGGCGTAAAGCGCGCGTAGGTGGTTTGTTAAGTTGAATGTGAAATCCCCGGGCTCAACCTGGGAACTGCATCCAAAACTGGCAAGCTAGAGTAGGGCAGAGGGTGGTGGAATTTCCTG	TACAGAGGGTGCAAGCGTTAATCGGAATTACTGGGCGTAAAGCGCGCGTAGGTGGTTTGTTAAGTTGAATGTGAAATCCCCGGGCTCAACCTGGGAACTGCATCCAAAACTGGCAAGCTAGAGTAGGGCAGAGGGTGGTGGAATTTCCTG	1.0
TACAGAGGGTGCAAGCGTTAATCGGAATTACTGGGCGTAAAGCGCGCGTAGGTGGTTTGTTAAGTTGGATGTGAAAGCCCCGGGCTCAACCTGGGAACTGCATCCAAAACTGGCAAGCTAGAGTACAGTAGAGGGTGGTGGAATTTCCTG	TACAGAGGGTGCAAGCGTTAATCGGAATTACTGGGCGTAAAGCGCGCGTAGGTGGTTTGTTAAGTTGGATGTGAAAGCCCCGGGCTCAACCTGGGAACTGCATCCAAAACTGGCAAGCTAGAGTACAGTAGAGGGTGGTGGAATTTCCTG	1.0
TACAGAGGGTGCAAGCGTTAATCGGAATTACTGGGCGTAAAGCGCGCGTAGGTGGTTTGTTAAGTTGGATGTGAAATCCCCGGGCTCAACCTGGGAACTGCATTCAAAACTGACTGACTAGAGTATGGTAGAGGGTGGTGGAATTTCCTG	TACAGAGGGTGCAAGCGTTAATCGGAATTACTGGGCGTAAAGCGCGCGTAGGTGGTTTGTTAAGTTGGATGTGAAATCCCCGGGCTCAACCTGGGAACTGCATTCAAAACTGACTGACTAGAGTATGGTAGAGGGTGGTGGAATTTCCTG	1.0
TACAGAGGGTGCAAGCGTTAATCGGATTTACTGGGCGTAAAGCGCGCGTAGGTGGCCAATTAAGTCAAATGTGAAATCCCCGAGCTTAACTTGGGAATTGCATTCGATACTGGTTGGCTAGAGTATGGGAGAGGATGGTAGAATTCCAGG	TACAGAGGGTGCAAGCGTTAATCGGATTTACTGGGCGTAAAGCGCGCGTAGGTGGCCAATTAAGTCAAATGTGAAATCCCCGAGCTTAACTTGGGAATTGCATTCGATACTGGTTGGCTAGAGTATGGGAGAGGATGGTAGAATTCCAGG	1.0
TACAGAGGGTGCGAGCGTTAATCGGAATTACTGGGCGTAAAGCGAGTGTAGGTGGCTCATTAAGTCACATGTGAAATCCCCGGGCTTAACCTGGGAACTGCATGTGATACTGGTGGTGCTAGAATATGTGAGAGGGAAGTAGAATTCCAG	TACAGAGGGTGCGAGCGTTAATCGGAATTACTGGGCGTAAAGCGAGTGTAGGTGGCTCATTAAGTCACATGTGAAATCCCCGGGCTTAACCTGGGAACTGCATGTGATACTGGTGGTGCTAGAATATGTGAGAGGGAAGTAGAATTCCAG	1.0
TACGAAGGGGGCTAGCGTTGCTCGGAATTACTGGGCGTAAAGGGCGCGTAGGCGGCTCTGTTAGTCAGGCGTGAAATTCCCGGGCTTAACCTGGGGACTGCGCTTGATACTGCGGAGCTTGAGGGTGGAAGAGGGTCGTGGAATTCCCAG	TACGAAGGGGGCTAGCGTTGCTCGGAATTACTGGGCGTAAAGGGCGCGTAGGCGGCTCTGTTAGTCAGGCGTGAAATTCCCGGGCTTAACCTGGGGACTGCGCTTGATACTGCGGAGCTTGAGGGTGGAAGAGGGTCGTGGAATTCCCAG	1.0
TACGAAGGGGGCTAGCGTTGTTCGGAATTACTGGGCGTAAAGCGCACGTAGGCGGATATTTAAGTCAGGGGTGAAATCCCAGAGCTCAACTCTGGAACTGCCTTTGATACTGGGTATCTTGAGTATGGAAGAGGTAAGTGGAATTGCGAG	TACGAAGGGGGCTAGCGTTGTTCGGAATTACTGGGCGTAAAGCGCACGTAGGCGGATATTTAAGTCAGGGGTGAAATCCCAGAGCTCAACTCTGGAACTGCCTTTGATACTGGGTATCTTGAGTATGGAAGAGGTAAGTGGAATTGCGAG	1.0
TACGAAGGGTGCAAGCGTTAATCGGAATTACTGGGCGTAAAGCGCGCGTAGGTGGCTTGATAAGTTGGATGTGAAATCCCCGGGCTCAACCTGGGAACTGCATCCAAAACTGTCTGGCTAGAGTGCGGTAGAGGGTAGTGGAATTTCCAG	TACGAAGGGTGCAAGCGTTAATCGGAATTACTGGGCGTAAAGCGCGCGTAGGTGGCTTGATAAGTTGGATGTGAAATCCCCGGGCTCAACCTGGGAACTGCATCCAAAACTGTCTGGCTAGAGTGCGGTAGAGGGTAGTGGAATTTCCAG	1.0
TACGAAGGGTGCAAGCGTTACTCGGAATTACTGGGCGTAAAGCGTGCGTAGGTGGTTTGTTAAGTCTGATGTGAAAGCCCTGGGCTCAACCTGGGAATTGCATTGGATACTGGCAGGCTAGAGTGCGGTAGAGGGTAGTGGAATTCCCGG	TACGAAGGGTGCAAGCGTTACTCGGAATTACTGGGCGTAAAGCGTGCGTAGGTGGTTTGTTAAGTCTGATGTGAAAGCCCTGGGCTCAACCTGGGAATTGCATTGGATACTGGCAGGCTAGAGTGCGGTAGAGGGTAGTGGAATTCCCGG	1.0
TACGAAGGGTGCAAGCGTTACTCGGAATTACTGGGCGTAAAGGGTGCGTAGGTGGTTCGTTAAGTCTGATGTGAAAGCCCTGGGCTCAACCTGGGAATTGCATTGGATACTGGCGGGCTAGAGTGCGGTAGAGGGTAGTGGAATTCCCGG	TACGAAGGGTGCAAGCGTTACTCGGAATTACTGGGCGTAAAGGGTGCGTAGGTGGTTCGTTAAGTCTGATGTGAAAGCCCTGGGCTCAACCTGGGAATTGCATTGGATACTGGCGGGCTAGAGTGCGGTAGAGGGTAGTGGAATTCCCGG	1.0
TACGAGGAAGACTAGTGTTATTCATATTTAATAGGTTTAAAGGGTAACTAGACGGTATTTCTAGCCAATTATGGTACGGATTTACTAGAGTTTAATGTGAGAAGGCAGTATTTTTGGTGTAGAGTTAATATTCTGTGATACCTTAAGGAC	TACGAGGAAGACTAGTGTTATTCATATTTAATAGGTTTAAAGGGTAACTAGACGGTATTTCTAGCCAATTATGGTACGGATTTACTAGAGTTTAATGTGAGAAGGCAGTATTTTTGGTGTAGAGTTAATATTCTGTGATACCTTAAGGAC	1.0
TACGCAGAAGACAAGTGTTATTCATCTTTAATCGGTTTAAAGGGTACCTAGACGGGAAATCAAGCCATAGTAGGGACTAATTTTCTAGAGTTTTATGGGTGAAAGTCGAATGTCTGGAGTAGAGATAAAATATTGTAATACTAGATGGAC	TACGCAGAAGACAAGTGTTATTCATCTTTAATCGGTTTAAAGGGTACCTAGACGGGAAATCAAGCCATAGTAGGGACTAATTTTCTAGAGTTTTATGGGTGAAAGTCGAATGTCTGGAGTAGAGATAAAATATTGTAATACTAGATGGAC	1.0
TACGCAGAATACAAGTGTTATTCATCTTTATTGGGTTTAAAGGGTACCTAGACGGGAAATCAAGCCTATATAAAAAGGGACTAATTTTCTAGAGTTTTATGTATGAATGTCGAACTATTGGAGTAGAGTCTGCATTTTTTAATACCAATG	TACGCAGAATACAAGTGTTATTCATCTTTATTGGGTTTAAAGGGTACCTAGACGGGAAATCAAGCCTATATAAAAAGGGACTAATTTTCTAGAGTTTTATGTATGAATGTCGAACTATTGGAGTAGAGTCTGCATTTTTTAATACCAATG	1.0
TACGGAGGATCCAAGCGTTATCCGGAATCATTGGGTTTAAAGGGTCCGTAGGCGGTTTGGTAAGTCAGTGGTGAAAGCCCATCGCTCAACGGTGGAACGGCCATTGATACTGCCAGACTTGAATTATTAGGAAGTAACTAGAATATGTAG	TACGGAGGATCCAAGCGTTATCCGGAATCATTGGGTTTAAAGGGTCCGTAGGCGGTTTGGTAAGTCAGTGGTGAAAGCCCATCGCTCAACGGTGGAACGGCCATTGATACTGCCAGACTTGAATTATTAGGAAGTAACTAGAATATGTAG	1.0
TACGGAGGATCCAAGCGTTATCCGGATTTATTGGGTTTAAAGGGTGCGTAGGCGGTCCTATAAGTCAGTGGTGAAAGACGGCAGCTTAACTGTCGCAGTGCCTTTGATACTGTAGGACTTGAATCTATTTGAAGTGGGCGGAATAAGACA	TACGGAGGATCCAAGCGTTATCCGGATTTATTGGGTTTAAAGGGTGCGTAGGCGGTCCTATAAGTCAGTGGTGAAAGACGGCAGCTTAACTGTCGCAGTGCCTTTGATACTGTAGGACTTGAATCTATTTGAAGTGGGCGGAATAAGACA	1.0
TACGGAGGGAGCTAGCGTTATTCGGAATTACTGGGCGTAAAGCGCACGTAGGCGGCTTTGTAAGTAAGAGGTGAAAGCCTGGAGCTCAACTCCAGAATTGCCTTTTAGACTGCATCGCTCGAATCATGGAGAGGTCAGTGGAATTCCGAG	TACGGAGGGAGCTAGCGTTATTCGGAATTACTGGGCGTAAAGCGCACGTAGGCGGCTTTGTAAGTAAGAGGTGAAAGCCTGGAGCTCAACTCCAGAATTGCCTTTTAGACTGCATCGCTCGAATCATGGAGAGGTCAGTGGAATTCCGAG	1.0
TACGGAGGGAGCTAGCGTTGTTCGGAATTACTGGGCGTAAAGCGCACGTAGGCGGCTTTGTAAGTTAGAGGTGAAAGCCTGGAGCTCAACTCCAGAATTGCCTTTGATACTGCATGGCTTGAATCCGGGAGAGGTGAGTGGAATTCCGAG	TACGGAGGGAGCTAGCGTTGTTCGGAATTACTGGGCGTAAAGCGCACGTAGGCGGCTTTGTAAGTTAGAGGTGAAAGCCTGGAGCTCAACTCCAGAATTGCCTTTGATACTGCATGGCTTGAATCCGGGAGAGGTGAGTGGAATTCCGAG	1.0
TACGGAGGGAGCTAGCGTTGTTCGGAATTACTGGGCGTAAAGCGCGCGTAGGCGGTTACTCAAGTCAGAGGTGAAAGCCCGGGGCTCAACCCCGGAACTGCCTTTGAAACTAGGTGACTAGAATCTTGGAGAGGTCAGTGGAATTCCGAG	TACGGAGGGAGCTAGCGTTGTTCGGAATTACTGGGCGTAAAGCGCGCGTAGGCGGTTACTCAAGTCAGAGGTGAAAGCCCGGGGCTCAACCCCGGAACTGCCTTTGAAACTAGGTGACTAGAATCTTGGAGAGGTCAGTGGAATTCCGAG	1.0
TACGGAGGGAGCTAGCGTTGTTCGGAATTACTGGGCGTAAAGCGCGCGTAGGCGGTTTTTTAAGTCAGAGGTGAAAGCCCAGTGCTCAACACTGGAACTGCCTTTGAAACTGGAAAACTTGAATCTTGGAGAGGTCAGTGGAATTCCGAG	TACGGAGGGAGCTAGCGTTGTTCGGAATTACTGGGCGTAAAGCGCGCGTAGGCGGTTTTTTAAGTCAGAGGTGAAAGCCCAGTGCTCAACACTGGAACTGCCTTTGAAACTGGAAAACTTGAATCTTGGAGAGGTCAGTGGAATTCCGAG	1.0
TACGGAGGGGGCTAGCGTTGTTCGGAATTACTGGGCGTAAAGCGCACGTAGGCGGACCAAAAAGTCAGAGGTGAAATCCCAGGGCTCAACCTTGGAACTGCCTTTGAAACTCTTGGTCTTGAGTTCGAGAGAGGTGAGTGGAATTCCGAG	TACGGAGGGGGCTAGCGTTGTTCGGAATTACTGGGCGTAAAGCGCACGTAGGCGGACCAAAAAGTCAGAGGTGAAATCCCAGGGCTCAACCTTGGAACTGCCTTTGAAACTCTTGGTCTTGAGTTCGAGAGAGGTGAGTGGAATTCCGAG	1.0
TACGGAGGGGGCTAGCGTTGTTCGGAATTACTGGGCGTAAAGCGCACGTAGGCGGACCAGAAAGTTGGGGGTGAAATCCCGGGGCTCAACCTCGGAACTGCCTTCAAAACTACTGGTCTGGAGTTCGAGAGAGGTGAGTGGAATTCCGAG	TACGGAGGGGGCTAGCGTTGTTCGGAATTACTGGGCGTAAAGCGCACGTAGGCGGACCAGAAAGTTGGGGGTGAAATCCCGGGGCTCAACCTCGGAACTGCCTTCAAAACTACTGGTCTGGAGTTCGAGAGAGGTGAGTGGAATTCCGAG	1.0
TACGGAGGGGGCTAGCGTTGTTCGGAATTACTGGGCGTAAAGCGCACGTAGGCGGACTGGAAAGTCAGAGGTGAAATCCCAGGGCTCAACCTTGGAACTGCCTTTGAAACTATCAGTCTGGAGTTCGAGAGAGGTGAGTGGAATTCCGAG	TACGGAGGGGGCTAGCGTTGTTCGGAATTACTGGGCGTAAAGCGCACGTAGGCGGACTGGAAAGTCAGAGGTGAAATCCCAGGGCTCAACCTTGGAACTGCCTTTGAAACTATCAGTCTGGAGTTCGAGAGAGGTGAGTGGAATTCCGAG	1.0
TACGGAGGGGGCTAGCGTTGTTCGGAATTACTGGGCGTAAAGCGCACGTAGGCGGCTTTGTAAGTTAGAGGTGAAAGCCCGGGGCTCAACTCCGGAACTGCCTTTAAGACTGCATCGCTTGAATCATGGAGAGGTCAGTGGAATTCCGAG	TACGGAGGGGGCTAGCGTTGTTCGGAATTACTGGGCGTAAAGCGCACGTAGGCGGCTTTGTAAGTTAGAGGTGAAAGCCCGGGGCTCAACTCCGGAACTGCCTTTAAGACTGCATCGCTTGAATCATGGAGAGGTCAGTGGAATTCCGAG	1.0
TACGGAGGGGGTTAGCGTTGTTCGGAATGACTGGGCGTAAAGCGCGCGTAGGCGGATCGCAAAGTCGGGGGTGAAATCCCGGGGCTCAACCCCGGAATGGCCTTCGAGACTCGCGGTCTGGAGTTCGAGAGAGGTGGGTGGAATTCCGAG	TACGGAGGGGGTTAGCGTTGTTCGGAATGACTGGGCGTAAAGCGCGCGTAGGCGGATCGCAAAGTCGGGGGTGAAATCCCGGGGCTCAACCCCGGAATGGCCTTCGAGACTCGCGGTCTGGAGTTCGAGAGAGGTGGGTGGAATTCCGAG	1.0
TACGGAGGGGGTTAGCGTTGTTCGGAATGACTGGGCGTAAAGCGCGCGTAGGCGGGCGGTCAAGTTGGGGGTGAAATCCCGGGGCTCAACCTCGGAATGGCCTCCAATACTAGCTGCCTTGAGTTCGAGAGAGGTGAGTGGAATTCCGAG	TACGGAGGGGGTTAGCGTTGTTCGGAATGACTGGGCGTAAAGCGCGCGTAGGCGGGCGGTCAAGTTGGGGGTGAAATCCCGGGGCTCAACCTCGGAATGGCCTCCAATACTAGCTGCCTTGAGTTCGAGAGAGGTGAGTGGAATTCCGAG	1.0
TACGGAGGGTGCAAGCGTTAATCGGAATTACTGGGCGTAAAGCGCACGTAGGTGGTTTGTTAAGCTAGCTGTGAAATCCCCGGGCTCAACCTGGGCACTGCAGTTAGAACTGGCAAGCTAGAGTAGGGTAGAGGGGTGTGGAATTCCAGG	TACGGAGGGTGCAAGCGTTAATCGGAATTACTGGGCGTAAAGCGCACGTAGGTGGTTTGTTAAGCTAGCTGTGAAATCCCCGGGCTCAACCTGGGCACTGCAGTTAGAACTGGCAAGCTAGAGTAGGGTAGAGGGGTGTGGAATTCCAGG	1.0
TACGGAGGGTGCAAGCGTTACCCGGAATCACTGGGCGTAAAGGGCGTGTAGGCGGGACGTTAAGTCTGGTTTTAAAGACCGTGGCTCAACCACGGGAGTGGACTGGATACTGGCGCTCTAGACCTCTGGAGAGAGAACCGGAATTCCTGG	TACGGAGGGTGCAAGCGTTACCCGGAATCACTGGGCGTAAAGGGCGTGTAGGCGGGACGTTAAGTCTGGTTTTAAAGACCGTGGCTCAACCACGGGAGTGGACTGGATACTGGCGCTCTAGACCTCTGGAGAGAGAACCGGAATTCCTGG	1.0
TACGGAGGGTGCAAGCGTTACTCGGAATCACTGGGCGTAAAGAGCGCGTAGGCGGGGTAGTAAGTCAGATGTGAAATCCTATGGCTTAACCATAGAACTGCATTTGAAACTACTACTCTAGAGTATGGGAGAGGTAGGTGGAATTCTTGG	TACGGAGGGTGCAAGCGTTACTCGGAATCACTGGGCGTAAAGAGCGCGTAGGCGGGGTAGTAAGTCAGATGTGAAATCCTATGGCTTAACCATAGAACTGCATTTGAAACTACTACTCTAGAGTATGGGAGAGGTAGGTGGAATTCTTGG	1.0
TACGGAGGGTGCAAGCGTTATCCGGATTCACTGGGTTTAAAGGGTGCGTAGGTGGAGTGGTAAGTCAGTGGTGAAATCTCCAAGCTTAACTTGGAAACTGCCGTTGATACTATCATTCTTGAATATCGTGGAGGTAAGCGGAATATGTCA	TACGGAGGGTGCAAGCGTTATCCGGATTCACTGGGTTTAAAGGGTGCGTAGGTGGAGTGGTAAGTCAGTGGTGAAATCTCCAAGCTTAACTTGGAAACTGCCGTTGATACTATCATTCTTGAATATCGTGGAGGTAAGCGGAATATGTCA	1.0
TACGGAGGGTGCAAGCGTTATCCGGATTTATTGGGTTTAAAGGGTCCGTAGGCGGATCTGTAAGTCAGTGGTGAAATCTCATAGCTTAACTATGAAACTGCCATTGATACTGCAGGTCTTGAGTAAAGTAGAAGTGGCTGGAATAAGTAG	TACGGAGGGTGCAAGCGTTATCCGGATTTATTGGGTTTAAAGGGTCCGTAGGCGGATCTGTAAGTCAGTGGTGAAATCTCATAGCTTAACTATGAAACTGCCATTGATACTGCAGGTCTTGAGTAAAGTAGAAGTGGCTGGAATAAGTAG	1.0
TACGGAGGGTGCAAGCGTTGTCCGGATTTATTGGGTTTAAAGGGTGCGTAGGCGGCCCCTTAAGTCAGTGGTGAAAGCCCGCGGCTCAACCGCGGAACTGCCATTGATACTGGGGGGCTTGAGTACAGACGAGGTAGGCGGAATTGAAGA	TACGGAGGGTGCAAGCGTTGTCCGGATTTATTGGGTTTAAAGGGTGCGTAGGCGGCCCCTTAAGTCAGTGGTGAAAGCCCGCGGCTCAACCGCGGAACTGCCATTGATACTGGGGGGCTTGAGTACAGACGAGGTAGGCGGAATTGAAGA	1.0
TACGGAGGGTGCAAGCGTTGTCCGGATTTATTGGGTTTAAAGGGTGCGTAGGCGGCCCGTTAAGTCCGGGGTGAAAGCCCACGGCTCAACCGTGGAACTGCCCTGGATACTGGCGGGCTTGAGTCCAGACGAGGTTGGCGGAATGGATGG	TACGGAGGGTGCAAGCGTTGTCCGGATTTATTGGGTTTAAAGGGTGCGTAGGCGGCCCGTTAAGTCCGGGGTGAAAGCCCACGGCTCAACCGTGGAACTGCCCTGGATACTGGCGGGCTTGAGTCCAGACGAGGTTGGCGGAATGGATGG	1.0
TACGGAGGGTGCAAGCGTTGTCCGGATTTATTGGGTTTAAAGGGTGCGTAGGCGGCCCGTTAAGTCCGGGGTGAAAGCCTCTTGCTCAACAAGAGAACTGCCCTGGATACTGGCGGGCTTGAGTCCAGACGAGGTTGGCGGAATGGATGG	TACGGAGGGTGCAAGCGTTGTCCGGATTTATTGGGTTTAAAGGGTGCGTAGGCGGCCCGTTAAGTCCGGGGTGAAAGCCTCTTGCTCAACAAGAGAACTGCCCTGGATACTGGCGGGCTTGAGTCCAGACGAGGTTGGCGGAATGGATGG	1.0
TACGGAGGGTGCAAGCGTTGTCCGGATTTATTGGGTTTAAAGGGTGCGTAGGCGGCTGATTAAGTCTGGGGTGAAAGCCCGTTGCTCAACAACGGAACTGCCCTGGAAACTGGTTAGCTTGAGTACAGACGAGGGTGGCGGAATGGATGC	TACGGAGGGTGCAAGCGTTGTCCGGATTTATTGGGTTTAAAGGGTGCGTAGGCGGCTGATTAAGTCTGGGGTGAAAGCCCGTTGCTCAACAACGGAACTGCCCTGGAAACTGGTTAGCTTGAGTACAGACGAGGGTGGCGGAATGGATGC	1.0
TACGGGAAGAGCGAGCATTATTCAAAATGATTAGGCGTAAAGGGTTTGTAGGTTGTTTTTTAAGTTGAAAAGAAAATAATAAAGCTCAACTTTATCTCTTTTTTCAAAACTAAAAAACTAGAGTATACATAGAGGATAATAGAATTTTTA	TACGGGAAGAGCGAGCATTATTCAAAATGATTAGGCGTAAAGGGTTTGTAGGTTGTTTTTTAAGTTGAAAAGAAAATAATAAAGCTCAACTTTATCTCTTTTTTCAAAACTAAAAAACTAGAGTATACATAGAGGATAATAGAATTTTTA	1.0
TACGGGAGGAGCGAGCATTATTCGGAATGATTAGGCGTAAAGGGTTTGTAGGTTGTTTTTTAAGTTgaaaaaaacaaattaaagcctaactttataaattttttcaaaactaaaaaaCTAGAGTATAAATAGAGGATAATGGAATTTTTA	TACGGGAGGAGCGAGCATTATTCGGAATGATTAGGCGTAAAGGGTTTGTAGGTTGTTTTTTAAGTTgaaaaaaacaaattaaagcctaactttataaattttttcaaaactaaaaaaCTAGAGTATAAATAGAGGATAATGGAATTTTTA	1.0
TACGGGAGGAGCGAGCATTATTCGGGATGATTAGGCGTAAAGAGTTTGTAGGTTGTTTTTTAAGTTGAAAGAAACAAATTAAAGCTTAACTTTATAAATTTTTTCAAAACTGATAAACTTGAGTATAAATAGAGGATAATGGAATTTCTA	TACGGGAGGAGCGAGCATTATTCGGGATGATTAGGCGTAAAGAGTTTGTAGGTTGTTTTTTAAGTTGAAAGAAACAAATTAAAGCTTAACTTTATAAATTTTTTCAAAACTGATAAACTTGAGTATAAATAGAGGATAATGGAATTTCTA	1.0
TACGTAAAAGACTAGTGTTAGTCATCTTTATTAGGTTTAAAGGGTACCTAGACGGTAAATTAAACTCTAAATGAGTACTTTTTTACTAGAGTTTTATAAGAGAAGGAAGAATTTCTGGAGTAGTGATAGAATATTTTAATACCAGAAGGA	TACGTAAAAGACTAGTGTTAGTCATCTTTATTAGGTTTAAAGGGTACCTAGACGGTAAATTAAACTCTAAATGAGTACTTTTTTACTAGAGTTTTATAAGAGAAGGAAGAATTTCTGGAGTAGTGATAGAATATTTTAATACCAGAAGGA	1.0
TACGTAAAAGACTAGTGTTAGTCATCTTTATTAGGTTTAAAGGGTACCTAGACGGTAAATTAAACTCTAAATGAGTATTTTTTTACTAGAGTTTTATGTAAGAAGGAAGAATTTCTGGAGTAGTGATAGAATACTTTAATACCAGAAGGA	TACGTAAAAGACTAGTGTTAGTCATCTTTATTAGGTTTAAAGGGTACCTAGACGGTAAATTAAACTCTAAATGAGTATTTTTTTACTAGAGTTTTATGTAAGAAGGAAGAATTTCTGGAGTAGTGATAGAATACTTTAATACCAGAAGGA	1.0
TACGTAAGAGACTAGTGTTATTCATCTTTAATAGGTTTAAAGGGTACTCAGGCGGTTGAATTTGCTTTATAAATGAGAACGATTCAACTAGAGTATTATATGAGAAGATCGTACTAAAGTAGTAGAGATAAAATTTATTGATAACTTTGG	TACGTAAGAGACTAGTGTTATTCATCTTTAATAGGTTTAAAGGGTACTCAGGCGGTTGAATTTGCTTTATAAATGAGAACGATTCAACTAGAGTATTATATGAGAAGATCGTACTAAAGTAGTAGAGATAAAATTTATTGATAACTTTGG	1.0
TACGTAAGAGGCTAGTGTTATTCATCTTTAATAGGTTTAAAGGGTACTTAGACGGTAAATATTTTCCTTTTAAAAGGTACATTTTTACTAGAGTTTTATGTGAGGAGGTAGTACTTAAGGTGTAGAGATAAAATTTGTTGATACCTCGGG	TACGTAAGAGGCTAGTGTTATTCATCTTTAATAGGTTTAAAGGGTACTTAGACGGTAAATATTTTCCTTTTAAAAGGTACATTTTTACTAGAGTTTTATGTGAGGAGGTAGTACTTAAGGTGTAGAGATAAAATTTGTTGATACCTCGGG	1.0
TACGTAAGGGGCAAGCGTTATCCGGATTTACTGGGTGTAAAGGGAGCGTAGACGGAGAGGCAAGTCTGATGTGAAAGGCATGGGCTCAACCTGTGGACTGCATTGGAAACTGTTTTTCTAGAGTGCCGGAGAGGCAGGCGGAATTCCTAG	TACGTAAGGGGCAAGCGTTATCCGGATTTACTGGGTGTAAAGGGAGCGTAGACGGAGAGGCAAGTCTGATGTGAAAGGCATGGGCTCAACCTGTGGACTGCATTGGAAACTGTTTTTCTAGAGTGCCGGAGAGGCAGGCGGAATTCCTAG	1.0
TACGTAGAAGACTAGTGTTAGTCATCTTTATTAGGTTTAAAGGGTACCTAGACGGTAAATAAAACTTGAATAGAGTACTTATTTTCTAGAGTTTTATAAGAGAAGGAAGAACTTCTGGAGTAGTGATAGAATACTTTGATACCAGAGGGA	TACGTAGAAGACTAGTGTTAGTCATCTTTATTAGGTTTAAAGGGTACCTAGACGGTAAATAAAACTTGAATAGAGTACTTATTTTCTAGAGTTTTATAAGAGAAGGAAGAACTTCTGGAGTAGTGATAGAATACTTTGATACCAGAGGGA	1.0
TACGTAGAAGACTAGTGTTATTCATCTTTAATAGGTTTAAAGGGTACCTAGACGGTAAAATTAGTCTAAAATATGATACGGTTTTACTAGAGTTATATATAAGGAGGTGAGTATTTAAGGAGTAGAGTTGAAATTCAGTCATACCTTAAG	TACGTAGAAGACTAGTGTTATTCATCTTTAATAGGTTTAAAGGGTACCTAGACGGTAAAATTAGTCTAAAATATGATACGGTTTTACTAGAGTTATATATAAGGAGGTGAGTATTTAAGGAGTAGAGTTGAAATTCAGTCATACCTTAAG	1.0
TACGTAGAAGACTAGTGTTATTCATCTTTAGTAGGTTTAAAGGGTACCTAGACGGTAAATTTAATCCCTAACAGCGATATGTTTTTACTAGAGTTATATCTGAGAAGGGGAGTATTTATGGAGTAGAGTTGAAATTTGTTGATCCCATAA	TACGTAGAAGACTAGTGTTATTCATCTTTAGTAGGTTTAAAGGGTACCTAGACGGTAAATTTAATCCCTAACAGCGATATGTTTTTACTAGAGTTATATCTGAGAAGGGGAGTATTTATGGAGTAGAGTTGAAATTTGTTGATCCCATAA	1.0
TACGTAGAAGACTAGTGTTATTCATCTTTAGTAGGTTTAAAGGGTACCTAGACGGTATAATTAGTCTTAAACACGATACGGTTATACTAGAGTTATATATGAGGAGGTAGTATTTATGGAGTAGAGTCGACATTCATTGATACCATAGAG	TACGTAGAAGACTAGTGTTATTCATCTTTAGTAGGTTTAAAGGGTACCTAGACGGTATAATTAGTCTTAAACACGATACGGTTATACTAGAGTTATATATGAGGAGGTAGTATTTATGGAGTAGAGTCGACATTCATTGATACCATAGAG	1.0
TACGTAGAAGACTAGTGTTATTCATCTTTAGTAGGTTTAAAGGGTACCTAGACGGTATAATTAGTCTTAAATAGGATACGGTTATACTAGAGTTATATATGAGAAGGGGAGTATTTGTGGAGTAGAGTTGAAATTTGTTGATACCATGAG	TACGTAGAAGACTAGTGTTATTCATCTTTAGTAGGTTTAAAGGGTACCTAGACGGTATAATTAGTCTTAAATAGGATACGGTTATACTAGAGTTATATATGAGAAGGGGAGTATTTGTGGAGTAGAGTTGAAATTTGTTGATACCATGAG	1.0
TACGTAGAAGACTAGTGTTATTCATCTTTAGTAGGTTTAAAGGGTACCTAGACGGTATAATTAGTCTTAAATAGGATACGGTTATACTAGAGTTTTATATAAGGAGGCGAGTATTTAAGGAGTAGAGTTGAAATTCTTTGATACCTTAAC	TACGTAGAAGACTAGTGTTATTCATCTTTAGTAGGTTTAAAGGGTACCTAGACGGTATAATTAGTCTTAAATAGGATACGGTTATACTAGAGTTTTATATAAGGAGGCGAGTATTTAAGGAGTAGAGTTGAAATTCTTTGATACCTTAAC	1.0
TACGTAGAAGACTAGTGTTATTCATCTTTAGTAGGTTTAAAGGGTACCTAGACGGTATAATTAGTCTTTAATAGGAAACGGTTATACTAGAGTTATATATGAGGAGGAGAGTATTTGTGGAGTAGAGTTGAAATTCTTTGATACCATGAC	TACGTAGAAGACTAGTGTTATTCATCTTTAGTAGGTTTAAAGGGTACCTAGACGGTATAATTAGTCTTTAATAGGAAACGGTTATACTAGAGTTATATATGAGGAGGAGAGTATTTGTGGAGTAGAGTTGAAATTCTTTGATACCATGAC	1.0
TACGTAGAAGACTAGTGTTATTCATCTTTAGTAGGTTTAAAGGGTACCTAGACGGTATAATTAGTCTTTAATAGGAAACGTTTATACTAGAGTTATATATGAGGAGGGGAGTATTCATGGAGTAGAGTTGAAATTCTTTGATACCATGAC	TACGTAGAAGACTAGTGTTATTCATCTTTAGTAGGTTTAAAGGGTACCTAGACGGTATAATTAGTCTTTAATAGGAAACGTTTATACTAGAGTTATATATGAGGAGGGGAGTATTCATGGAGTAGAGTTGAAATTCTTTGATACCATGAC	1.0
TACGTAGGAGGCAAGCGTTATCCGGAATGACTGGGCGTAAAGGGTGCGTAGGTGGTTTGGCAAGTTGGTAGCGTAATCCCGGGGCTTAACTTCGGTGCTACTACCAAAACTGCTGGGCTTGAGTGCAGGAGGGGTGAATGGAATTCCTAG	TACGTAGGAGGCAAGCGTTATCCGGAATGACTGGGCGTAAAGGGTGCGTAGGTGGTTTGGCAAGTTGGTAGCGTAATCCCGGGGCTTAACTTCGGTGCTACTACCAAAACTGCTGGGCTTGAGTGCAGGAGGGGTGAATGGAATTCCTAG	1.0
TACGTAGGAGGCTAGTGTTAGTTATCTTTATTGGGTTTAAAGGGTAAGTAGGCGGTaaaaaaaaCTCTAAAAGAGTACTTTTTTACTAGAGTTATATATGAGAAGGAAGAATAACTGGAGTAGAGATAGAATTTGTTGATACCAGGGGGA	TACGTAGGAGGCTAGTGTTAGTTATCTTTATTGGGTTTAAAGGGTAAGTAGGCGGTaaaaaaaaCTCTAAAAGAGTACTTTTTTACTAGAGTTATATATGAGAAGGAAGAATAACTGGAGTAGAGATAGAATTTGTTGATACCAGGGGGA	1.0
TACGTAGGCGGCAAGCGTTGTCCGGAATTATTGGGCGTAAAGGGAGCGCAGGCGGGAAACTAAGCGGATCTTAAAAGTGCGGGGCTCAACCCCGTGATGGGGTCCGAACTGGTTTTCTTGAGTGCAGGAGAGGAAAGCGGAATTCCCAGT	TACGTAGGCGGCAAGCGTTGTCCGGAATTATTGGGCGTAAAGGGAGCGCAGGCGGGAAACTAAGCGGATCTTAAAAGTGCGGGGCTCAACCCCGTGATGGGGTCCGAACTGGTTTTCTTGAGTGCAGGAGAGGAAAGCGGAATTCCCAGT	1.0
TACGTAGGGAGCAAGCGTTATCCGGATTTACTGGGTGTAAAGGGCGTGTAGGCGGGAGTGCAAGTCAGATGTGAAAACTATGGGCTCAACCCATAGCCTGCATTTGAAACTGTACTTCTTGAGTACTGGAGAGGCAGGCGGAATTCCGTG	TACGTAGGGAGCAAGCGTTATCCGGATTTACTGGGTGTAAAGGGCGTGTAGGCGGGAGTGCAAGTCAGATGTGAAAACTATGGGCTCAACCCATAGCCTGCATTTGAAACTGTACTTCTTGAGTACTGGAGAGGCAGGCGGAATTCCGTG	1.0
TACGTAGGGCGCAAGCGTTATCCGGATTTATTGGGCGTAAAGAGCTCGTAGGCGGTTTGTCGCGTCTGCCGTGAAAGTCCGAGGCTCAACCTCGGATCTGCGGTGGGTACGGGCAGACTAGAGTGATGTAGGGGAGACTGGAATTCCTGG	TACGTAGGGCGCAAGCGTTATCCGGATTTATTGGGCGTAAAGAGCTCGTAGGCGGTTTGTCGCGTCTGCCGTGAAAGTCCGAGGCTCAACCTCGGATCTGCGGTGGGTACGGGCAGACTAGAGTGATGTAGGGGAGACTGGAATTCCTGG	1.0
TACGTAGGGCGCAAGCGTTGTCCGGAATTATTGGGCGTAAAGAGCTCGTAGGCGGTGTGTCGCGTCTGCTGTGAAAACCTTAGGCTCAACCTGGGGCTTGCAGTGGGTACGGGCACACTAGAGTGCGGTAGGGGTGACTGGAATTCCTGG	TACGTAGGGCGCAAGCGTTGTCCGGAATTATTGGGCGTAAAGAGCTCGTAGGCGGTGTGTCGCGTCTGCTGTGAAAACCTTAGGCTCAACCTGGGGCTTGCAGTGGGTACGGGCACACTAGAGTGCGGTAGGGGTGACTGGAATTCCTGG	1.0
TACGTAGGGCGCAAGCGTTGTCCGGAATTATTGGGCGTAAAGAGCTCGTAGGCGGTTTGTCGCGTCTGGTGTGAAAACTCAAGGCTCAACCTTGAGCTTGCATCGGGTACGGGCAGACTAGAGTGTGGTAGGGGTGACTGGAATTCCTGG	TACGTAGGGCGCAAGCGTTGTCCGGAATTATTGGGCGTAAAGAGCTCGTAGGCGGTTTGTCGCGTCTGGTGTGAAAACTCAAGGCTCAACCTTGAGCTTGCATCGGGTACGGGCAGACTAGAGTGTGGTAGGGGTGACTGGAATTCCTGG	1.0
TACGTAGGGCGCAAGCGTTGTCCGGAATTATTGGGCGTAAAGAGCTCGTAGGCGGTTTGTCGCGTCTGGTGTGAAAACTCGAGGCTCAACCTCGAGCTTGCATCGGGTACGGGCAGACTAGAGTGCGGTAGGGGAGACTGGAATTCCTGG	TACGTAGGGCGCAAGCGTTGTCCGGAATTATTGGGCGTAAAGAGCTCGTAGGCGGTTTGTCGCGTCTGGTGTGAAAACTCGAGGCTCAACCTCGAGCTTGCATCGGGTACGGGCAGACTAGAGTGCGGTAGGGGAGACTGGAATTCCTGG	1.0
TACGTAGGGCGCGAGCGTTATCCGGAATTATTGGGCGTAAAGAGCTTGTAGGCGGTTTGCCGCGTCTGCTGTGAAAGCCCGGGGCTTAACTCCGGGTGTGCAGTGGGTACGGGCAGGCTAGAGTGCAGTAGGGGAGACTGGAATTCCTGG	TACGTAGGGCGCGAGCGTTATCCGGAATTATTGGGCGTAAAGAGCTTGTAGGCGGTTTGCCGCGTCTGCTGTGAAAGCCCGGGGCTTAACTCCGGGTGTGCAGTGGGTACGGGCAGGCTAGAGTGCAGTAGGGGAGACTGGAATTCCTGG	1.0
TACGTAGGGCGCGAGCGTTGTCCGGAATTATTGGGCGTAAAGAGCTCGTAGGCGGCCTGCCGCGTCCGCTGTGAAAGCCCGGGGCTCAACCCCGGGTCGGCAGTGGGTACGGGCAGGCTGGAGTGCAGTAGGGGAGACCGGAATTCCTGG	TACGTAGGGCGCGAGCGTTGTCCGGAATTATTGGGCGTAAAGAGCTCGTAGGCGGCCTGCCGCGTCCGCTGTGAAAGCCCGGGGCTCAACCCCGGGTCGGCAGTGGGTACGGGCAGGCTGGAGTGCAGTAGGGGAGACCGGAATTCCTGG	1.0
TACGTAGGGCGCGAGCGTTGTCCGGATTTACTGGGCGTAAAGGGCTCGTAGGCGGTCCGTCGCGTCGGCTGTGAAAGACCGCAGCTCAACTGCGGAAACGCAGTCGATACGGGCGGACTAGAGGACGGTAGAGGCAAGCGGAATTCCTGG	TACGTAGGGCGCGAGCGTTGTCCGGATTTACTGGGCGTAAAGGGCTCGTAGGCGGTCCGTCGCGTCGGCTGTGAAAGACCGCAGCTCAACTGCGGAAACGCAGTCGATACGGGCGGACTAGAGGACGGTAGAGGCAAGCGGAATTCCTGG	1.0
TACGTAGGGGGCAAGCGTTATCCGGATTTACTGGGTGTAAAGGGAGCGCAGACGGCATGGCAAGTCTGAAGTGAAAGGCATGGGCTCAACCCGTGGACTGCTTTGGAAACTGTCAGGCTAGAGTGTCGGAGAGGCAAGTGGAATTCCTAG	TACGTAGGGGGCAAGCGTTATCCGGATTTACTGGGTGTAAAGGGAGCGCAGACGGCATGGCAAGTCTGAAGTGAAAGGCATGGGCTCAACCCGTGGACTGCTTTGGAAACTGTCAGGCTAGAGTGTCGGAGAGGCAAGTGGAATTCCTAG	1.0
TACGTAGGGGGCAAGCGTTATCCGGATTTACTGGGTGTAAAGGGAGCGTAGACGGAACGGCAAGTCTGAAGTGAAAGCCCGGGGCTCAACCCCGGGACTGCTTTGGAAACTGTTGATCTAGAGTGCTGGAGAGGCAAGTGGAATTCCTAG	TACGTAGGGGGCAAGCGTTATCCGGATTTACTGGGTGTAAAGGGAGCGTAGACGGAACGGCAAGTCTGAAGTGAAAGCCCGGGGCTCAACCCCGGGACTGCTTTGGAAACTGTTGATCTAGAGTGCTGGAGAGGCAAGTGGAATTCCTAG	1.0
TACGTAGGGGGCAAGCGTTATCCGGATTTACTGGGTGTAAAGGGAGCGTAGACGGAAGAGCAAGTCTGATGTGAAAGGCTGGGGCTTAACCCCAGGACTGCATTGGAAACTGTTTTTCTAGAGTGCCGGAGAGGTAAGCGGAATTCCTAG	TACGTAGGGGGCAAGCGTTATCCGGATTTACTGGGTGTAAAGGGAGCGTAGACGGAAGAGCAAGTCTGATGTGAAAGGCTGGGGCTTAACCCCAGGACTGCATTGGAAACTGTTTTTCTAGAGTGCCGGAGAGGTAAGCGGAATTCCTAG	1.0
TACGTAGGGGGCAAGCGTTATCCGGATTTACTGGGTGTAAAGGGAGCGTAGACGGAATGGCAAGTCTGATGTGAAAGGCAGGGGCTCAACCCCTGGACTGCATTGGAAACTGTCAGTCTTGAGTACCGGAGGGGTAAGCGGAATTCCTAG	TACGTAGGGGGCAAGCGTTATCCGGATTTACTGGGTGTAAAGGGAGCGTAGACGGAATGGCAAGTCTGATGTGAAAGGCAGGGGCTCAACCCCTGGACTGCATTGGAAACTGTCAGTCTTGAGTACCGGAGGGGTAAGCGGAATTCCTAG	1.0
TACGTAGGGGGCAAGCGTTATCCGGATTTACTGGGTGTAAAGGGAGCGTAGACGGAATGGCAAGTCTGATGTGAAAGGCGGGGGCTCAACCCCTGGACTGCATTGGAAACTGCCAGTCTTGAGTACCGGAGGGGTAAGCGGAATTCCTAG	TACGTAGGGGGCAAGCGTTATCCGGATTTACTGGGTGTAAAGGGAGCGTAGACGGAATGGCAAGTCTGATGTGAAAGGCGGGGGCTCAACCCCTGGACTGCATTGGAAACTGCCAGTCTTGAGTACCGGAGGGGTAAGCGGAATTCCTAG	1.0
TACGTAGGGGGCAAGCGTTATCCGGATTTACTGGGTGTAAAGGGAGCGTAGACGGAGCAGCAAGTCTGATGTGAAAGACCGGGGCTTAACCCCGGGCCTGCATTGGAAACTGTTGATCTTGAGTGCCGGAGGGGTAAGCGGAATTCCTGG	TACGTAGGGGGCAAGCGTTATCCGGATTTACTGGGTGTAAAGGGAGCGTAGACGGAGCAGCAAGTCTGATGTGAAAGACCGGGGCTTAACCCCGGGCCTGCATTGGAAACTGTTGATCTTGAGTGCCGGAGGGGTAAGCGGAATTCCTGG	1.0
TACGTAGGGGGCAAGCGTTATCCGGATTTACTGGGTGTAAAGGGAGCGTAGACGGAGCAGCAAGTCTGATGTGAAAGGCAGGGGCTCAACCCCTGGACTGCATTGGAAACTGTTGATCTTGAGTACCGGAGGGGTAAGCGGAATTCCTAG	TACGTAGGGGGCAAGCGTTATCCGGATTTACTGGGTGTAAAGGGAGCGTAGACGGAGCAGCAAGTCTGATGTGAAAGGCAGGGGCTCAACCCCTGGACTGCATTGGAAACTGTTGATCTTGAGTACCGGAGGGGTAAGCGGAATTCCTAG	1.0
TACGTAGGGGGCAAGCGTTATCCGGATTTACTGGGTGTAAAGGGAGCGTAGACGGCGAAGCAAGTCTGGTGTGAAAACCCGGGGCTCAACCCCGGGCCTGCATTGGAAACTGTTTTGCTTGAGTGCCGGAGAGGTAAGCGGAATTCCTAG	TACGTAGGGGGCAAGCGTTATCCGGATTTACTGGGTGTAAAGGGAGCGTAGACGGCGAAGCAAGTCTGGTGTGAAAACCCGGGGCTCAACCCCGGGCCTGCATTGGAAACTGTTTTGCTTGAGTGCCGGAGAGGTAAGCGGAATTCCTAG	1.0
TACGTAGGGGGCAAGCGTTATCCGGATTTACTGGGTGTAAAGGGAGCGTAGACGGGACAGCAAGTCTGATGTGAAAGGCGGGGGCTCAACCCCCGGACTGCATTGGAAACTGCTGGCCTGGAGTACCGGAGGGGTAAGCGGAATTCCTAG	TACGTAGGGGGCAAGCGTTATCCGGATTTACTGGGTGTAAAGGGAGCGTAGACGGGACAGCAAGTCTGATGTGAAAGGCGGGGGCTCAACCCCCGGACTGCATTGGAAACTGCTGGCCTGGAGTACCGGAGGGGTAAGCGGAATTCCTAG	1.0
TACGTAGGGGGCAAGCGTTATCCGGATTTACTGGGTGTAAAGGGAGCGTAGACGGGATAGCAAGTCTGAAGTGAAAGCCCGGGGCTCAACCCCGGGACTGCTTTGGAAACTGTTGACCTGGAGTGCTGGAGAGGCAAGTGGAATTCCTAG	TACGTAGGGGGCAAGCGTTATCCGGATTTACTGGGTGTAAAGGGAGCGTAGACGGGATAGCAAGTCTGAAGTGAAAGCCCGGGGCTCAACCCCGGGACTGCTTTGGAAACTGTTGACCTGGAGTGCTGGAGAGGCAAGTGGAATTCCTAG	1.0
TACGTAGGGGGCAAGCGTTATCCGGATTTACTGGGTGTAAAGGGAGCGTAGACGGTGAAGCAAGTCTGGAGTGAAAACCCGGGGCTTAACCCCGGGATTGCTTTGGAAACTGTTTAACTGGAGTGCAGGAGAGGTAAGCGGAATTCCTAG	TACGTAGGGGGCAAGCGTTATCCGGATTTACTGGGTGTAAAGGGAGCGTAGACGGTGAAGCAAGTCTGGAGTGAAAACCCGGGGCTTAACCCCGGGATTGCTTTGGAAACTGTTTAACTGGAGTGCAGGAGAGGTAAGCGGAATTCCTAG	1.0
TACGTAGGGGGCAAGCGTTATCCGGATTTACTGGGTGTAAAGGGAGCGTAGGTGGTAAGGCAAGCCAGAAGTGAAAGCCCGGGGCTCAACCCCGAGGATTGCTTTTGGAACTGTCGAACTAGAGTGCAGGAGGGGCAAGCGGAATTCCTA	TACGTAGGGGGCAAGCGTTATCCGGATTTACTGGGTGTAAAGGGAGCGTAGGTGGTAAGGCAAGCCAGAAGTGAAAGCCCGGGGCTCAACCCCGAGGATTGCTTTTGGAACTGTCGAACTAGAGTGCAGGAGGGGCAAGCGGAATTCCTA	1.0
TACGTAGGGGGCAAGCGTTGTCCGGAATTATTGGGCGTAAAGCGCGCGCAGGCGGCTTTTTAAGTCCGGTGTCACAGCCCAAGGCTCAACCTTGGGTCGCACTGGAAACTGGAGAGCTTGAGTACAGAAGAGGAAAGTGGAATTCCACGT	TACGTAGGGGGCAAGCGTTGTCCGGAATTATTGGGCGTAAAGCGCGCGCAGGCGGCTTTTTAAGTCCGGTGTCACAGCCCAAGGCTCAACCTTGGGTCGCACTGGAAACTGGAGAGCTTGAGTACAGAAGAGGAAAGTGGAATTCCACGT	1.0
TACGTAGGGGGCAAGCGTTGTCCGGAATTATTGGGCGTAAAGCGCGCGCAGGCGGTCCTTTAAGTCTGATGTGAAAGCCCACGGCTTAACCGTGGAGGGTCATTGGAAACTGAGGGACTTGAGTACAGAAGAGGAGAGTGGAATTCCACG	TACGTAGGGGGCAAGCGTTGTCCGGAATTATTGGGCGTAAAGCGCGCGCAGGCGGTCCTTTAAGTCTGATGTGAAAGCCCACGGCTTAACCGTGGAGGGTCATTGGAAACTGAGGGACTTGAGTACAGAAGAGGAGAGTGGAATTCCACG	1.0
TACGTAGGGGGCAAGCGTTGTCCGGAATTATTGGGCGTAAAGCGCGCGCAGGCGGTCCTTTAAGTCTGATGTGAAAGCCCACGGCTTAACCGTGGCGTGTCATTGGAAACTGAGGGACTTGAGTACAGAAGAGGAGAGTGGAATTCCACG	TACGTAGGGGGCAAGCGTTGTCCGGAATTATTGGGCGTAAAGCGCGCGCAGGCGGTCCTTTAAGTCTGATGTGAAAGCCCACGGCTTAACCGTGGCGTGTCATTGGAAACTGAGGGACTTGAGTACAGAAGAGGAGAGTGGAATTCCACG	1.0
TACGTAGGGGGCAAGCGTTGTCCGGAATTATTGGGCGTAAAGGGTACGCAGGCGGTTTTTTAAGTCTGATGTGAAATCTCATAGCTTAACTGTGAGCGGTCATTGGAAACTGAAGAACTTGAGTATAGAAGAGAAGAGTGGAATTCCAAG	TACGTAGGGGGCAAGCGTTGTCCGGAATTATTGGGCGTAAAGGGTACGCAGGCGGTTTTTTAAGTCTGATGTGAAATCTCATAGCTTAACTGTGAGCGGTCATTGGAAACTGAAGAACTTGAGTATAGAAGAGAAGAGTGGAATTCCAAG	1.0
TACGTAGGGGGCGAGCGTTATCCGGATTCATTGGGCGTAAAGCGCTCGTAGGCGGTCCGTTAGGTCGGGAGTCAAATCCGGGGGCTCAACCCCCGCCCGCTCCCGATACCGGCGGACTTGAGTTTGGTAGGGGAAGGCGGAATTCCAAGT	TACGTAGGGGGCGAGCGTTATCCGGATTCATTGGGCGTAAAGCGCTCGTAGGCGGTCCGTTAGGTCGGGAGTCAAATCCGGGGGCTCAACCCCCGCCCGCTCCCGATACCGGCGGACTTGAGTTTGGTAGGGGAAGGCGGAATTCCAAGT	1.0
TACGTAGGGTACGAGCGTTGTCCGGAATTATTGGGCGTAAAGAGCTCGTAGGTGGTTGGTCACGTCTGCTGTGGAAACGCAACGCTTAACGTTGCGCGGGCAGTGGGTACGGGCTGACTAGAGTGCAGTAGGGGAGTCTGGAATTCCTGG	TACGTAGGGTACGAGCGTTGTCCGGAATTATTGGGCGTAAAGAGCTCGTAGGTGGTTGGTCACGTCTGCTGTGGAAACGCAACGCTTAACGTTGCGCGGGCAGTGGGTACGGGCTGACTAGAGTGCAGTAGGGGAGTCTGGAATTCCTGG	1.0
TACGTAGGGTCCGAGCGTTGTCCGGAATTATTGGGCGTAAAGAGCTCGTAGGCGGTATGTCGCGTCTGCTGTGAAAGACCGGGGCTTAACTTCGGTTTTGCAGTGGATACGGGCATGCTGGAGGTAGGTAGGGGAGACTGGAATTCCTGG	TACGTAGGGTCCGAGCGTTGTCCGGAATTATTGGGCGTAAAGAGCTCGTAGGCGGTATGTCGCGTCTGCTGTGAAAGACCGGGGCTTAACTTCGGTTTTGCAGTGGATACGGGCATGCTGGAGGTAGGTAGGGGAGACTGGAATTCCTGG	1.0
TACGTAGGGTGCAAGCGTTAATCGGAATTACTGGGCGTAAAGCGTGCGCAGGCGGTTATGTAAGACAGTTGTGAAATCCCCGGGCTCAACCTGGGAATTGCATCTGTGACTGCATAGCTAGAGTACGGTAGAGGGGGATGGAATTCCGCG	TACGTAGGGTGCAAGCGTTAATCGGAATTACTGGGCGTAAAGCGTGCGCAGGCGGTTATGTAAGACAGTTGTGAAATCCCCGGGCTCAACCTGGGAATTGCATCTGTGACTGCATAGCTAGAGTACGGTAGAGGGGGATGGAATTCCGCG	1.0
TACGTAGGGTGCAAGCGTTAATCGGAATTACTGGGCGTAAAGCGTGCGCAGGCGGTTGTGCAAGACAGATGTGAAATCCCCGGGCTCAACCTGGGAACTGCATTTGTGACTGCACGGCTGGAGTGCGGCAGAGGGGGATGGAATTCCGCG	TACGTAGGGTGCAAGCGTTAATCGGAATTACTGGGCGTAAAGCGTGCGCAGGCGGTTGTGCAAGACAGATGTGAAATCCCCGGGCTCAACCTGGGAACTGCATTTGTGACTGCACGGCTGGAGTGCGGCAGAGGGGGATGGAATTCCGCG	1.0
TACGTAGGGTGCAAGCGTTAATCGGAATTACTGGGCGTAAAGCGTGCGCAGGCGGTTGTGCAAGACCGATGTGAAATCCCCGGGCTCAACCTGGGAATGGCATTGGTGACTGCACGGCTAGAGTGTGTCAGAGGGGGGTAGAATTCCACG	TACGTAGGGTGCAAGCGTTAATCGGAATTACTGGGCGTAAAGCGTGCGCAGGCGGTTGTGCAAGACCGATGTGAAATCCCCGGGCTCAACCTGGGAATGGCATTGGTGACTGCACGGCTAGAGTGTGTCAGAGGGGGGTAGAATTCCACG	1.0
TACGTAGGGTGCAAGCGTTAATCGGAATTACTGGGCGTAAAGCGTGCGCAGGCGGTTTTGTAAGTCTGACGTGAAATCCCCGGGCTCAACCTGGGAATTGCGTTGGAGACTGCAAGGCTAGAATCTGGCAGAGGGGGGTAGAATTCCACG	TACGTAGGGTGCAAGCGTTAATCGGAATTACTGGGCGTAAAGCGTGCGCAGGCGGTTTTGTAAGTCTGACGTGAAATCCCCGGGCTCAACCTGGGAATTGCGTTGGAGACTGCAAGGCTAGAATCTGGCAGAGGGGGGTAGAATTCCACG	1.0
TACGTAGGGTGCAAGCGTTGTCCGGAATTACTGGGCGTAAAGAGCTCGTAGGCGGTTTGTCGCGTCGTCTGTGAAAACCAGCAGCTCAACTGTTGGCTTGCAGGCGATACGGGCAGACTTGAGTATTTCAGGGGAGACTGGAATTCCTGG	TACGTAGGGTGCAAGCGTTGTCCGGAATTACTGGGCGTAAAGAGCTCGTAGGCGGTTTGTCGCGTCGTCTGTGAAAACCAGCAGCTCAACTGTTGGCTTGCAGGCGATACGGGCAGACTTGAGTATTTCAGGGGAGACTGGAATTCCTGG	1.0
TACGTAGGGTGCAAGCGTTGTCCGGAATTACTGGGCGTAAAGAGCTCGTAGGTGGTTTGTCGCGTCGTCTGTGAAATCCCGGGGCTTAACTTCGGGCGTGCAGGCGATACGGGCATAACTTGAGTGCTGTAGGGGAGACTGGAATTCCTG	TACGTAGGGTGCAAGCGTTGTCCGGAATTACTGGGCGTAAAGAGCTCGTAGGTGGTTTGTCGCGTCGTCTGTGAAATCCCGGGGCTTAACTTCGGGCGTGCAGGCGATACGGGCATAACTTGAGTGCTGTAGGGGAGACTGGAATTCCTG	1.0
TACGTAGGGTGCAAGCGTTGTCCGGAATTACTGGGCGTAAAGAGCTCGTAGGTGGTTTGTCGCGTCGTCTGTGAAATTCCGGGGCTTAACTCCGGGCGTGCAGGCGATACGGGCAAACTGGAGTGCTGTAGGGGAGACTGGAATTCCTGG	TACGTAGGGTGCAAGCGTTGTCCGGAATTACTGGGCGTAAAGAGCTCGTAGGTGGTTTGTCGCGTCGTCTGTGAAATTCCGGGGCTTAACTCCGGGCGTGCAGGCGATACGGGCAAACTGGAGTGCTGTAGGGGAGACTGGAATTCCTGG	1.0
TACGTAGGGTGCAAGCGTTGTCCGGAATTATTGGGCGTAAAGAGCTCGTAGGCGGTGTGTCGCGTCTGCTGTGAAAACTCCGGGCTCAACCCGGAGCTTGCAGTGGGTACGGGCGCACTAGAGTGCAGTAGGGGAGACTGGAATTCCTGG	TACGTAGGGTGCAAGCGTTGTCCGGAATTATTGGGCGTAAAGAGCTCGTAGGCGGTGTGTCGCGTCTGCTGTGAAAACTCCGGGCTCAACCCGGAGCTTGCAGTGGGTACGGGCGCACTAGAGTGCAGTAGGGGAGACTGGAATTCCTGG	1.0
TACGTAGGGTGCAAGCGTTGTCCGGAATTATTGGGCGTAAAGAGCTCGTAGGCGGTTTGTCGCGTCGGCTGTGAAAGCCCGGAGCTCAACTCCGGGTCTGCAGTCGATACGGGCAGACTTGAGTGTTGCAGGGGAGACTGGAATTCCTGG	TACGTAGGGTGCAAGCGTTGTCCGGAATTATTGGGCGTAAAGAGCTCGTAGGCGGTTTGTCGCGTCGGCTGTGAAAGCCCGGAGCTCAACTCCGGGTCTGCAGTCGATACGGGCAGACTTGAGTGTTGCAGGGGAGACTGGAATTCCTGG	1.0
TACGTAGGGTGCAAGCGTTGTCCGGAATTATTGGGCGTAAAGAGCTCGTAGGCGGTTTGTCGCGTCTGCTGTGAAAACCCGAGGCTCAACCTCGGGCCTGCAGTGGGTACGGGCAGACTAGAGTGCGGTAGGGGAGAATGGAATTCCTGG	TACGTAGGGTGCAAGCGTTGTCCGGAATTATTGGGCGTAAAGAGCTCGTAGGCGGTTTGTCGCGTCTGCTGTGAAAACCCGAGGCTCAACCTCGGGCCTGCAGTGGGTACGGGCAGACTAGAGTGCGGTAGGGGAGAATGGAATTCCTGG	1.0
TACGTAGGGTGCAAGCGTTGTCCGGAATTATTGGGCGTAAAGAGCTCGTAGGCGGTTTGTCGCGTCTGCTGTGAAATCCCGAGGCTCAACCTCGGGCTTGCAGTGGGTACGGGCAGACTAGAGTGCGGTAGGGGAGATTGGAATTCCTGG	TACGTAGGGTGCAAGCGTTGTCCGGAATTATTGGGCGTAAAGAGCTCGTAGGCGGTTTGTCGCGTCTGCTGTGAAATCCCGAGGCTCAACCTCGGGCTTGCAGTGGGTACGGGCAGACTAGAGTGCGGTAGGGGAGATTGGAATTCCTGG	1.0
TACGTAGGGTGCGAGCGTTAATCGGAATTACTGGGCGTAAAGCGTGCGCAGGCGGTTGGGTAAGACAGGTGTGAAATCCCCGAGCTTAACTTGGGAACTGCACTTGTGACTGCTCAACTAGAGTATGTCAGAGGGAGGTGGAATTCCAAG	TACGTAGGGTGCGAGCGTTAATCGGAATTACTGGGCGTAAAGCGTGCGCAGGCGGTTGGGTAAGACAGGTGTGAAATCCCCGAGCTTAACTTGGGAACTGCACTTGTGACTGCTCAACTAGAGTATGTCAGAGGGAGGTGGAATTCCAAG	1.0
TACGTAGGGTGCGAGCGTTATCCGGAATTATTGGGCGTAAAGAGCTCGTAGGCGGTTTGTCACGTCTGCTGTGAAAGCTGGGGGCTTAACTCCTAGTGTGCAGTGGGTACGGGCAGGCTGGAGTGCAGTAGGGGAGACTGGAATTCCTGG	TACGTAGGGTGCGAGCGTTATCCGGAATTATTGGGCGTAAAGAGCTCGTAGGCGGTTTGTCACGTCTGCTGTGAAAGCTGGGGGCTTAACTCCTAGTGTGCAGTGGGTACGGGCAGGCTGGAGTGCAGTAGGGGAGACTGGAATTCCTGG	1.0
TACGTAGGGTGCGAGCGTTATCCGGAATTATTGGGCGTAAAGAGCTCGTAGGCGGTTTGTCGCGTCTGTCGTGAAAGTCCGGGGCTTAACCCCGGATCTGCGGTGGGTACGGGCAGACTAGAGTGCAGTAGGGGAGACTGGAATTCCTGG	TACGTAGGGTGCGAGCGTTATCCGGAATTATTGGGCGTAAAGAGCTCGTAGGCGGTTTGTCGCGTCTGTCGTGAAAGTCCGGGGCTTAACCCCGGATCTGCGGTGGGTACGGGCAGACTAGAGTGCAGTAGGGGAGACTGGAATTCCTGG	1.0
TACGTAGGGTGCGAGCGTTGTCCGGAATTACTGGGCGTAAAGAGCTCGTAGGCGGTTTGTCGCGTCGTCTGTGAAAACTCGGAGCTTAACTCCGGGCGTGCAGGCGATACGGGCAGACTTGAGTACTACAGGGGAGACTGGAATTCCTGG	TACGTAGGGTGCGAGCGTTGTCCGGAATTACTGGGCGTAAAGAGCTCGTAGGCGGTTTGTCGCGTCGTCTGTGAAAACTCGGAGCTTAACTCCGGGCGTGCAGGCGATACGGGCAGACTTGAGTACTACAGGGGAGACTGGAATTCCTGG	1.0
TACGTAGGGTGCGAGCGTTGTCCGGAATTACTGGGCGTAAAGAGCTCGTAGGCGGTTTGTCGCGTCGTCTGTGAAATCCTCCAGCTTAACTGGGGGCGTGCAGGCGATACGGGCAGACTTGAGTACTACAGGGGAGACTGGAATTCCTGG	TACGTAGGGTGCGAGCGTTGTCCGGAATTACTGGGCGTAAAGAGCTCGTAGGCGGTTTGTCGCGTCGTCTGTGAAATCCTCCAGCTTAACTGGGGGCGTGCAGGCGATACGGGCAGACTTGAGTACTACAGGGGAGACTGGAATTCCTGG	1.0
TACGTAGGGTGCGAGCGTTGTCCGGAATTACTGGGCGTAAAGAGCTCGTAGGTGGTTTGTCGCGTCGTCTGTGAAATCCCGGGGCTTAACTTCGGGCGTGCAGGCGATACGGGCATAACTTGAGTGCTGTAGGGGAGACTGGAATTCCTG	TACGTAGGGTGCGAGCGTTGTCCGGAATTACTGGGCGTAAAGAGCTCGTAGGTGGTTTGTCGCGTCGTCTGTGAAATCCCGGGGCTTAACTTCGGGCGTGCAGGCGATACGGGCATAACTTGAGTGCTGTAGGGGAGACTGGAATTCCTG	1.0
TACGTAGGGTGCGAGCGTTGTCCGGAATTACTGGGCGTAAAGAGCTCGTAGGTGGTTTGTCGCGTCGTCTGTGAAATTCCGGGGCTTAACTCCGGGCGTGCAGGCGATACGGGCATAACTTGAGTACTGTAGGGGAGACTGGAATTCCTG	TACGTAGGGTGCGAGCGTTGTCCGGAATTACTGGGCGTAAAGAGCTCGTAGGTGGTTTGTCGCGTCGTCTGTGAAATTCCGGGGCTTAACTCCGGGCGTGCAGGCGATACGGGCATAACTTGAGTACTGTAGGGGAGACTGGAATTCCTG	1.0
TACGTAGGGTGCGAGCGTTGTCCGGAATTACTGGGCGTAAAGAGCTCGTAGGTGGTTTGTCGCGTCGTTTGTGTAAGCCCGCAGCTTAACTGCGGGACTGCAGGCGATACGGGCATAACTTGAGTGCTGTAGGGGAGACTGGAATTCCTG	TACGTAGGGTGCGAGCGTTGTCCGGAATTACTGGGCGTAAAGAGCTCGTAGGTGGTTTGTCGCGTCGTTTGTGTAAGCCCGCAGCTTAACTGCGGGACTGCAGGCGATACGGGCATAACTTGAGTGCTGTAGGGGAGACTGGAATTCCTG	1.0
TACGTAGGGTGCGAGCGTTGTCCGGAATTATTGGGCGTAAAGAGCTTGTAGGCGGTTTGTCGCGTCTGCCGTGAAAACCTAGGGCTTAACTCTGGGCGTGCGGTGGGTACGGGCAGGCTAGAGTGTGGTAGGGGAGACTGGAATTCCTGG	TACGTAGGGTGCGAGCGTTGTCCGGAATTATTGGGCGTAAAGAGCTTGTAGGCGGTTTGTCGCGTCTGCCGTGAAAACCTAGGGCTTAACTCTGGGCGTGCGGTGGGTACGGGCAGGCTAGAGTGTGGTAGGGGAGACTGGAATTCCTGG	1.0
TACGTAGGGTGCGAGCGTTGTCCGGAGTTACTGGGCGTAAAGAGCTCGTAGGCGGTTTGTCGCGTCGGCCGTGAAATCCTGCTGCTTAACGGTGGGCTTGCGGTCGATACGGGCAGACTAGAGTTCGGTAGGGGAGACTGGAATTCCTGG	TACGTAGGGTGCGAGCGTTGTCCGGAGTTACTGGGCGTAAAGAGCTCGTAGGCGGTTTGTCGCGTCGGCCGTGAAATCCTGCTGCTTAACGGTGGGCTTGCGGTCGATACGGGCAGACTAGAGTTCGGTAGGGGAGACTGGAATTCCTGG	1.0
TACGTAGGGTGCGAGCGTTGTCCGGATTTATTGGGCGTAAAGAGCTCGTAGGCGGTTTGTCGCGTCGGCCGTGAAAACCTACAGCTTAACTGTGGGCTTGCGGTCGATACGGGCAGACTTGAGTTCGGCAGGGGAGACTGGAATTCCTGG	TACGTAGGGTGCGAGCGTTGTCCGGATTTATTGGGCGTAAAGAGCTCGTAGGCGGTTTGTCGCGTCGGCCGTGAAAACCTACAGCTTAACTGTGGGCTTGCGGTCGATACGGGCAGACTTGAGTTCGGCAGGGGAGACTGGAATTCCTGG	1.0
TACGTAGGGTGCGAGCGTTGTCCGGATTTATTGGGCGTAAAGAGCTCGTAGGCGGTTTGTCGCGTCTATCGTGAAAACCGGGAGCTTAACTCCTGGCTTGCGGTGGATACGGGCAGACTTGAGTTCGGTAGGGGAGACTGGAATTCCTGG	TACGTAGGGTGCGAGCGTTGTCCGGATTTATTGGGCGTAAAGAGCTCGTAGGCGGTTTGTCGCGTCTATCGTGAAAACCGGGAGCTTAACTCCTGGCTTGCGGTGGATACGGGCAGACTTGAGTTCGGTAGGGGAGACTGGAATTCCTGG	1.0
TACGTAGGTCACAAGCGTTGTCCGGATTTATTGGGCGTAAAGGGAGCGCAGGCGGTTTGTTAAGTCTGATGTGAAAGCCCACGGCTCAACCGTGGAACGGCATTGGAAACTGGCAAACTTGAGTATAGAAGAGGAAAGTGGAATTCCATG	TACGTAGGTCACAAGCGTTGTCCGGATTTATTGGGCGTAAAGGGAGCGCAGGCGGTTTGTTAAGTCTGATGTGAAAGCCCACGGCTCAACCGTGGAACGGCATTGGAAACTGGCAAACTTGAGTATAGAAGAGGAAAGTGGAATTCCATG	1.0
TACGTAGGTCCCGAGCGTTGTCCGGATTTATTGGGCGTAAAGCGAGCGCAGGCGGTTTAATAAGTCTGAAGTTAAAGGCAGTGGCTTAACCATTGTTCGCTTTGGAAACTGTTAAACTTGAGTGCAGAAGGGGAGAGTGGAATTCCATGT	TACGTAGGTCCCGAGCGTTGTCCGGATTTATTGGGCGTAAAGCGAGCGCAGGCGGTTTAATAAGTCTGAAGTTAAAGGCAGTGGCTTAACCATTGTTCGCTTTGGAAACTGTTAAACTTGAGTGCAGAAGGGGAGAGTGGAATTCCATGT	1.0
TACGTAGGTCCCGAGCGTTGTCCGGATTTATTGGGCGTAAAGCGAGCGCAGGCGGTTTAATAAGTCTGAAGTTAAAGGCAGTGGCTTAACCATTGTTCGCTTTGGAAACTGTTAGACTTGAGTGCAGAAGGGGAGAGTGGAATTCCATGT	TACGTAGGTCCCGAGCGTTGTCCGGATTTATTGGGCGTAAAGCGAGCGCAGGCGGTTTAATAAGTCTGAAGTTAAAGGCAGTGGCTTAACCATTGTTCGCTTTGGAAACTGTTAGACTTGAGTGCAGAAGGGGAGAGTGGAATTCCATGT	1.0
TACGTAGGTGACAAGCGTTGTCCGGAATTATTGGGCGTAAAGGGAGCGCAGGCGGTTGGAATAGTCTGATGTGAAAGCCCACGGCTTAACCGTGGAAGGTCATTGGAAACTGTCCAACTTGAATACAGAAGAGGTAAGTGGAATTCCAAG	TACGTAGGTGACAAGCGTTGTCCGGAATTATTGGGCGTAAAGGGAGCGCAGGCGGTTGGAATAGTCTGATGTGAAAGCCCACGGCTTAACCGTGGAAGGTCATTGGAAACTGTCCAACTTGAATACAGAAGAGGTAAGTGGAATTCCAAG	1.0
TACGTAGGTGGCAAGCGTTATCCGGAATTATTGGGCGTAAAGCGCGCGTAGGCGGCGAGATTAGTCTGATGTGAAAGCCCCCGGCTCAACCGGGGAAGGTCATTGGAAACTGTTTCGCTTGAGTGCAGAAGAGGAGAGTGGAATTCCATG	TACGTAGGTGGCAAGCGTTATCCGGAATTATTGGGCGTAAAGCGCGCGTAGGCGGCGAGATTAGTCTGATGTGAAAGCCCCCGGCTCAACCGGGGAAGGTCATTGGAAACTGTTTCGCTTGAGTGCAGAAGAGGAGAGTGGAATTCCATG	1.0
TACGTAGGTGGCAAGCGTTATCCGGAATTATTGGGCGTAAAGCGCGCGTAGGCGGTAAAATAAGTCTGATGTGAAAGCCCCCGGCTCAACCGGGGAGGGTCATTGGAAACTGTTTTACTTGAGTACAGAAGAGGAGAGTGGAATTCCATG	TACGTAGGTGGCAAGCGTTATCCGGAATTATTGGGCGTAAAGCGCGCGTAGGCGGTAAAATAAGTCTGATGTGAAAGCCCCCGGCTCAACCGGGGAGGGTCATTGGAAACTGTTTTACTTGAGTACAGAAGAGGAGAGTGGAATTCCATG	1.0
TACGTAGGTGGCAAGCGTTATCCGGAATTATTGGGCGTAAAGCGCGCGTAGGCGGTTTCTTAAGTCTGATGTGAAAGCCCACGGCTCAACCGTGGAGGGTCATTGGAAACTGGGAAACTTGAGTACAGAAGAGGAAAGTGGAATTCCATG	TACGTAGGTGGCAAGCGTTATCCGGAATTATTGGGCGTAAAGCGCGCGTAGGCGGTTTCTTAAGTCTGATGTGAAAGCCCACGGCTCAACCGTGGAGGGTCATTGGAAACTGGGAAACTTGAGTACAGAAGAGGAAAGTGGAATTCCATG	1.0
TACGTAGGTGGCAAGCGTTATCCGGAATTATTGGGCGTAAAGCGCGCGTAGGCGGTTTCTTAAGTCTGATGTGAAAGCCCACGGCTCAACCGTGGAGGGTCATTGGAAACTGGGAAACTTGAGTGCAGAAGAGGAAAGTGGAATTCCATG	TACGTAGGTGGCAAGCGTTATCCGGAATTATTGGGCGTAAAGCGCGCGTAGGCGGTTTCTTAAGTCTGATGTGAAAGCCCACGGCTCAACCGTGGAGGGTCATTGGAAACTGGGAAACTTGAGTGCAGAAGAGGAAAGTGGAATTCCATG	1.0
TACGTAGGTGGCAAGCGTTATCCGGAATTATTGGGCGTAAAGCGCGCGTAGGCGGTTTCTTAAGTCTGATGTGAAAGCCCCCGGCTCAACCGGGGAGGGTCATTGGAAACTGGGGGACTTGAGTGCAGAAGAGGAGAGTGGAATTCCATG	TACGTAGGTGGCAAGCGTTATCCGGAATTATTGGGCGTAAAGCGCGCGTAGGCGGTTTCTTAAGTCTGATGTGAAAGCCCCCGGCTCAACCGGGGAGGGTCATTGGAAACTGGGGGACTTGAGTGCAGAAGAGGAGAGTGGAATTCCATG	1.0
TACGTAGGTGGCAAGCGTTATCCGGATTTACTGGGTGTAAAGGGCGTGTAGGCGGGATTGCAAGTCAGATGTGAAAACCACGGGCTCAACCTGTGGCCTGCATTTGAAACTGCAGTTCTTGAGTACTGGAGAGGCAGACGGAATTCCTAG	TACGTAGGTGGCAAGCGTTATCCGGATTTACTGGGTGTAAAGGGCGTGTAGGCGGGATTGCAAGTCAGATGTGAAAACCACGGGCTCAACCTGTGGCCTGCATTTGAAACTGCAGTTCTTGAGTACTGGAGAGGCAGACGGAATTCCTAG	1.0
TACGTAGGTGGCAAGCGTTATCCGGATTTACTGGGTGTAAAGGGCGTGTAGGCGGGCTGGCAAGTCAGATGTGAAAACCATGGGCTCAACCCATGGCCTGCATTTGAAACTGTTGGTCTTGAGTGCTGGAGAGGCAATCGGAATTCCGTG	TACGTAGGTGGCAAGCGTTATCCGGATTTACTGGGTGTAAAGGGCGTGTAGGCGGGCTGGCAAGTCAGATGTGAAAACCATGGGCTCAACCCATGGCCTGCATTTGAAACTGTTGGTCTTGAGTGCTGGAGAGGCAATCGGAATTCCGTG	1.0
TACGTAGGTGGCAAGCGTTATCCGGATTTATTGGGCGTAAAGCGAGCGCAGGCGGTTACTTAAGTCTGATGTGAAAGCCTTCGGCTTAACCGAAGAAGTGCATCGGAAACTGGGTGACTTGAGTGCAGAAGAGGACAGTGGAACTCCATG	TACGTAGGTGGCAAGCGTTATCCGGATTTATTGGGCGTAAAGCGAGCGCAGGCGGTTACTTAAGTCTGATGTGAAAGCCTTCGGCTTAACCGAAGAAGTGCATCGGAAACTGGGTGACTTGAGTGCAGAAGAGGACAGTGGAACTCCATG	1.0
TACGTAGGTGGCAAGCGTTATCCGGATTTATTGGGCGTAAAGCGAGCGCAGGCGGTTGCTTAGGTCTGATGTGAAAGCCTTCGGCTTAACCGAAGAAGGGCATCGGAAACCGGGCGACTTGAGTGCAGAAGAGGACAGTGGAACTCCATG	TACGTAGGTGGCAAGCGTTATCCGGATTTATTGGGCGTAAAGCGAGCGCAGGCGGTTGCTTAGGTCTGATGTGAAAGCCTTCGGCTTAACCGAAGAAGGGCATCGGAAACCGGGCGACTTGAGTGCAGAAGAGGACAGTGGAACTCCATG	1.0
TACGTAGGTGGCAAGCGTTATCCGGATTTATTGGGCGTAAAGCGAGCGCAGGCGGTTGCTTAGGTCTGATGTGAAAGCCTTCGGCTTAACCGAAGAAGTGCATCGGAAACCGGGCGACTTGAGTGCAGAAGAGGACAGTGGAACTCCATG	TACGTAGGTGGCAAGCGTTATCCGGATTTATTGGGCGTAAAGCGAGCGCAGGCGGTTGCTTAGGTCTGATGTGAAAGCCTTCGGCTTAACCGAAGAAGTGCATCGGAAACCGGGCGACTTGAGTGCAGAAGAGGACAGTGGAACTCCATG	1.0
TACGTAGGTGGCAAGCGTTATCCGGATTTATTGGGCGTAAAGCGAGCGCAGGCGGTTTTCTAAGTCTGATGTGAAAGCCTTCGGCTTAACCGAAGAAGTGCATCGGAAACTGGATGACTTGAGTGCAGAAGAGGGCAGTGGAACTCCATG	TACGTAGGTGGCAAGCGTTATCCGGATTTATTGGGCGTAAAGCGAGCGCAGGCGGTTTTCTAAGTCTGATGTGAAAGCCTTCGGCTTAACCGAAGAAGTGCATCGGAAACTGGATGACTTGAGTGCAGAAGAGGGCAGTGGAACTCCATG	1.0
TACGTAGGTGGCAAGCGTTATCCGGATTTATTGGGTGTAAAGGGCGTGTAGGCGGGACTGCAAGTCAGATGTGAAAACCACGGGCTCAACCTGTGGCCTGCATTTGAAACTGTAGTTCTTGAGTGTCGGAGAGGCAATCGGAATTCCGTG	TACGTAGGTGGCAAGCGTTATCCGGATTTATTGGGTGTAAAGGGCGTGTAGGCGGGACTGCAAGTCAGATGTGAAAACCACGGGCTCAACCTGTGGCCTGCATTTGAAACTGTAGTTCTTGAGTGTCGGAGAGGCAATCGGAATTCCGTG	1.0
TACGTAGGTGGCAAGCGTTGTCCGGAATCATTGGGCGTAAAGCGCGCGCAGGCGGTCCCTTAAGTCTGATGTGAAAGCCCACGGCTCAACCGTGGAGGGTCATTGGAAACTGGGGGACTTGAGTGCAGAAGAGGAAAGCGGAATTCCAAG	TACGTAGGTGGCAAGCGTTGTCCGGAATCATTGGGCGTAAAGCGCGCGCAGGCGGTCCCTTAAGTCTGATGTGAAAGCCCACGGCTCAACCGTGGAGGGTCATTGGAAACTGGGGGACTTGAGTGCAGAAGAGGAAAGCGGAATTCCAAG	1.0
TACGTAGGTGGCAAGCGTTGTCCGGAATTACTGGGTGTAAAGGGAGCGTAGGCGGGGAGACAAGTTGAATGTTTAAACTATCGGCTCAACTGATAGTCGCGTTCAAAACTATCACTCTTGAGTGCAGTAGAGGTAGGCGGAATTCCTAGT	TACGTAGGTGGCAAGCGTTGTCCGGAATTACTGGGTGTAAAGGGAGCGTAGGCGGGGAGACAAGTTGAATGTTTAAACTATCGGCTCAACTGATAGTCGCGTTCAAAACTATCACTCTTGAGTGCAGTAGAGGTAGGCGGAATTCCTAGT	1.0
TACGTAGGTGGCAAGCGTTGTCCGGAATTATTGGGCGTAAAGCGCGCGCAGGCGGCCTTTTAAGTCTGATGTGAAAGCCCCCGGCTCAACCGGGGAGGGTCATTGGAAACTGGAAGGCTTGAGTACAGAAGAGAAGAGTGGAATTCCATG	TACGTAGGTGGCAAGCGTTGTCCGGAATTATTGGGCGTAAAGCGCGCGCAGGCGGCCTTTTAAGTCTGATGTGAAAGCCCCCGGCTCAACCGGGGAGGGTCATTGGAAACTGGAAGGCTTGAGTACAGAAGAGAAGAGTGGAATTCCATG	1.0
TACGTAGGTGGCAAGCGTTGTCCGGAATTATTGGGCGTAAAGGGCGCGCAGGCGGTTTCATAAGTCTGTCTTAAAAGTGCGGGGCTTAACCCCGTGAGGGGACGGAAACTGTGAGACTGGAGTGTCGGAGAGGAAAGCGGAATTCCTAGT	TACGTAGGTGGCAAGCGTTGTCCGGAATTATTGGGCGTAAAGGGCGCGCAGGCGGTTTCATAAGTCTGTCTTAAAAGTGCGGGGCTTAACCCCGTGAGGGGACGGAAACTGTGAGACTGGAGTGTCGGAGAGGAAAGCGGAATTCCTAGT	1.0
TACGTAGGTGGCAAGCGTTGTCCGGATTTACTGGGCGTAAAGGGAGCGTAGGTGGATATTTAAGTGGGATGTGAAATACTCGGGCTTAACTTGAGTGCTGCATTCCAAACTGGATATCTAGAGTGCAGGAGAGGAAAGTAGAATTCCTAG	TACGTAGGTGGCAAGCGTTGTCCGGATTTACTGGGCGTAAAGGGAGCGTAGGTGGATATTTAAGTGGGATGTGAAATACTCGGGCTTAACTTGAGTGCTGCATTCCAAACTGGATATCTAGAGTGCAGGAGAGGAAAGTAGAATTCCTAG	1.0
TACGTAGGTGGCAAGCGTTGTCCGGATTTACTGGGTGTAAAGGGCGTGTAGGCGGGAGAGCAAGTCAGATGTGAAATCTATGGGCTTAACCCATAAACTGCATTTGAAACTGTTCTTCTTGAGTATCGGAGAGGCAGGCGGAATTCCTAG	TACGTAGGTGGCAAGCGTTGTCCGGATTTACTGGGTGTAAAGGGCGTGTAGGCGGGAGAGCAAGTCAGATGTGAAATCTATGGGCTTAACCCATAAACTGCATTTGAAACTGTTCTTCTTGAGTATCGGAGAGGCAGGCGGAATTCCTAG	1.0
TACGTAGGTGGCAAGCGTTGTCCGGATTTATTGGGCGTAAAGCGAGCGCAGGCGGAAAAATAAGTCTGATGTGAAAGCCCTCGGCTTAACCGAGGAACTGCATCGGAAACTGTTTTTCTTGAGTGCAGAAGAGGAGAGTGGAACTCCATG	TACGTAGGTGGCAAGCGTTGTCCGGATTTATTGGGCGTAAAGCGAGCGCAGGCGGAAAAATAAGTCTGATGTGAAAGCCCTCGGCTTAACCGAGGAACTGCATCGGAAACTGTTTTTCTTGAGTGCAGAAGAGGAGAGTGGAACTCCATG	1.0
TACGTAGGTGGCAAGCGTTGTCCGGATTTATTGGGCGTAAAGCGAGCGCAGGCGGAAGAATAAGTCTGATGTGAAAGCCCTCGGCTTAACCGAGGAACTGCATCGGAAACTGTTTTTCTTGAGTGCAGAAGAGGAGAGTGGAACTCCATG	TACGTAGGTGGCAAGCGTTGTCCGGATTTATTGGGCGTAAAGCGAGCGCAGGCGGAAGAATAAGTCTGATGTGAAAGCCCTCGGCTTAACCGAGGAACTGCATCGGAAACTGTTTTTCTTGAGTGCAGAAGAGGAGAGTGGAACTCCATG	1.0
TACGTAGGTGGCAAGCGTTGTCCGGATTTATTGGGCGTAAAGCGAGCGCAGGCGGTCTTTTAAGTCTGATGTGAAAGCCCCCGGCTTAACCGGGGAGGGTCATTGGAAACTGGGAGACTTGAGTGCAGAAGAGGAAAGCGGAATTCCATG	TACGTAGGTGGCAAGCGTTGTCCGGATTTATTGGGCGTAAAGCGAGCGCAGGCGGTCTTTTAAGTCTGATGTGAAAGCCCCCGGCTTAACCGGGGAGGGTCATTGGAAACTGGGAGACTTGAGTGCAGAAGAGGAAAGCGGAATTCCATG	1.0
TACGTAGGTGGCAAGCGTTGTCCGGATTTATTGGGCGTAAAGCGAGCGCAGGCGGTTCTTTAAGTCTGATGTGAAAGCCCCCGGCTCAACCGGGGAGGGTCATTGGAAACTGGAGAACTTGAGTGCAGAAGAGGAGAGTGGAATTCCACG	TACGTAGGTGGCAAGCGTTGTCCGGATTTATTGGGCGTAAAGCGAGCGCAGGCGGTTCTTTAAGTCTGATGTGAAAGCCCCCGGCTCAACCGGGGAGGGTCATTGGAAACTGGAGAACTTGAGTGCAGAAGAGGAGAGTGGAATTCCACG	1.0
TACGTAGGTGGCAAGCGTTGTCCGGATTTATTGGGCGTAAAGCGAGCGCAGGCGGTTTCTTAAGTCTGATGTGAAAGCCTTCGGCTTAACCGGAGAAGTGCATCGGAAACTGGGAGACTTGAGTGCAGAAGAGGACAGTGGAACTCCATG	TACGTAGGTGGCAAGCGTTGTCCGGATTTATTGGGCGTAAAGCGAGCGCAGGCGGTTTCTTAAGTCTGATGTGAAAGCCTTCGGCTTAACCGGAGAAGTGCATCGGAAACTGGGAGACTTGAGTGCAGAAGAGGACAGTGGAACTCCATG	1.0
TACGTAGGTGGCAAGCGTTGTCCGGATTTATTGGGCGTAAAGCGAGTGCAGGCGGTTCAATAAGTCTGATGTGAAAGCCTTCGGCTCAACCGGAGAATTGCATCAGAAACTGTTGAACTTGAGTGCAGAAGAGGAGAGTGGAACTCCATG	TACGTAGGTGGCAAGCGTTGTCCGGATTTATTGGGCGTAAAGCGAGTGCAGGCGGTTCAATAAGTCTGATGTGAAAGCCTTCGGCTCAACCGGAGAATTGCATCAGAAACTGTTGAACTTGAGTGCAGAAGAGGAGAGTGGAACTCCATG	1.0
TACGTAGGTGGCAAGCGTTGTCCGGATTTATTGGGCGTAAAGGGAACGCAGGCGGTCCTTTAAGTCTGATGTGAAAGCCTTCGGCTTAACCGAAGAATTGCATTGGAAACTGGAGGACTTGAGTGCAGAAGAGGAGAGTGGAACTCCATG	TACGTAGGTGGCAAGCGTTGTCCGGATTTATTGGGCGTAAAGGGAACGCAGGCGGTCCTTTAAGTCTGATGTGAAAGCCTTCGGCTTAACCGAAGAATTGCATTGGAAACTGGAGGACTTGAGTGCAGAAGAGGAGAGTGGAACTCCATG	1.0
TACGTAGGTGGCAAGCGTTGTCCGGATTTATTGGGCGTAAAGGGAACGCAGGCGGTCTTTTAAGTCTGATGTGAAAGCCTTCGGCTTAACCGGAGTAGTGCATTGGAAACTGGAAGACTTGAGTGCAGAAGAGGAGAGTGGAACTCCATG	TACGTAGGTGGCAAGCGTTGTCCGGATTTATTGGGCGTAAAGGGAACGCAGGCGGTCTTTTAAGTCTGATGTGAAAGCCTTCGGCTTAACCGGAGTAGTGCATTGGAAACTGGAAGACTTGAGTGCAGAAGAGGAGAGTGGAACTCCATG	1.0
TACGTAGGTGGCAAGCGTTGTCCGGATTTATTGGGCGTAAAGGGAACGCAGGCGGTTTTTTAAGTCTGATGTGAAAGCCTTCGGCTTAACCGGAGATGTGCATTGGAAACTGGAAGACTTGAGTGCAGAAGAGGAGAGTGGAACTCCATG	TACGTAGGTGGCAAGCGTTGTCCGGATTTATTGGGCGTAAAGGGAACGCAGGCGGTTTTTTAAGTCTGATGTGAAAGCCTTCGGCTTAACCGGAGATGTGCATTGGAAACTGGAAGACTTGAGTGCAGAAGAGGAGAGTGGAACTCCATG	1.0
TACGTAGGTGGCAAGCGTTGTCCGGATTTATTGGGCGTAAAGGGAGCGCAGGTGGTGATTTAAGTCTGATGTGAAAGCCCACGGCTCAACCGTGGAAGGTCATTGGAAACTGGATCACTTGAGTGCAGAAGAGGAAAGTGGAATTCCATG	TACGTAGGTGGCAAGCGTTGTCCGGATTTATTGGGCGTAAAGGGAGCGCAGGTGGTGATTTAAGTCTGATGTGAAAGCCCACGGCTCAACCGTGGAAGGTCATTGGAAACTGGATCACTTGAGTGCAGAAGAGGAAAGTGGAATTCCATG	1.0
TACGTAGGTGGCAAGCGTTGTCCGGATTTATTGGGCGTAAAGGGAGCGCAGGTGGTTTCTTAAGTCTGATGTGAAAGCCCACGGCTTAACCGTGGAGGGTCATTGGAAACTGGGAAACTTGAGTACAGAAGAGGAATGTGGAACTCCATG	TACGTAGGTGGCAAGCGTTGTCCGGATTTATTGGGCGTAAAGGGAGCGCAGGTGGTTTCTTAAGTCTGATGTGAAAGCCCACGGCTTAACCGTGGAGGGTCATTGGAAACTGGGAAACTTGAGTACAGAAGAGGAATGTGGAACTCCATG	1.0
TACGTAGGTGGCGAGCGTTATCCGGAATCATTGGGCGTAAAGGGTGCGTAGGTGGCACGATAAGTCTGTAGTAAAAGGCAGCGGCTCAACCGCTGTTGGCTATGGAAACTGTCGAGCTGGAGTGCAGAAGAGGGCGATGGAATTCCATGT	TACGTAGGTGGCGAGCGTTATCCGGAATCATTGGGCGTAAAGGGTGCGTAGGTGGCACGATAAGTCTGTAGTAAAAGGCAGCGGCTCAACCGCTGTTGGCTATGGAAACTGTCGAGCTGGAGTGCAGAAGAGGGCGATGGAATTCCATGT	1.0
TACGTAGGTGGCGAGCGTTATCCGGAATTATTGGGCGTAAAGAGGGAGCAGGCGGCGGCAGAGGTCTGTGGTGAAAGACTGAAGCTTAACTTCAGTAAGCCATAGAAACCGGGCTGCTAGAGTGCAGGAGAGGATCGTGGAATTCCATGT	TACGTAGGTGGCGAGCGTTATCCGGAATTATTGGGCGTAAAGAGGGAGCAGGCGGCGGCAGAGGTCTGTGGTGAAAGACTGAAGCTTAACTTCAGTAAGCCATAGAAACCGGGCTGCTAGAGTGCAGGAGAGGATCGTGGAATTCCATGT	1.0
TACGTAGGTTGCAAGCGTTGTCCGGATTTACTGGGTGTAAAGGGCGTGTAGGCGGAGCTGCAAGTCAGATGTGAAATCCCGGGGCTCAACCCCGGAACTGCATTTGAAACTGTAGCCCTTGAGTATCGGAGAGGCAAGCGGAATTCCTAG	TACGTAGGTTGCAAGCGTTGTCCGGATTTACTGGGTGTAAAGGGCGTGTAGGCGGAGCTGCAAGTCAGATGTGAAATCCCGGGGCTCAACCCCGGAACTGCATTTGAAACTGTAGCCCTTGAGTATCGGAGAGGCAAGCGGAATTCCTAG	1.0
TACGTATGGAGCAAGCGTTATCCGGATTTACTGGGTGTAAAGGGAGCGTAGGCGGTGCTATAAGTCTGATGTGAAAGCCCGGGGCTCAACCGCGGGACTGCATTGGAAACTGTAGGACTGGAGTGTCGGAGGGGTAAGTGGAATTCCTAG	TACGTATGGAGCAAGCGTTATCCGGATTTACTGGGTGTAAAGGGAGCGTAGGCGGTGCTATAAGTCTGATGTGAAAGCCCGGGGCTCAACCGCGGGACTGCATTGGAAACTGTAGGACTGGAGTGTCGGAGGGGTAAGTGGAATTCCTAG	1.0
TACGTATGGAGCAAGCGTTATCCGGATTTACTGGGTGTAAAGGGTGCGTAGGCGGCAGGGCAAGTCAGATGTGAAAGACCGGGGCTTAACTCCGGGGCTGCATTTGAAACTGCTTTGCTTGAGTCCGGGAGAGGCAGGCGGAATTCCTAG	TACGTATGGAGCAAGCGTTATCCGGATTTACTGGGTGTAAAGGGTGCGTAGGCGGCAGGGCAAGTCAGATGTGAAAGACCGGGGCTTAACTCCGGGGCTGCATTTGAAACTGCTTTGCTTGAGTCCGGGAGAGGCAGGCGGAATTCCTAG	1.0
TACGTATGGAGCAAGCGTTATCCGGATTTACTGGGTGTAAAGGGTGCGTAGGCGGCGCGGCAAGTCAGATGTGAAAGACCGGGGCTCAACCCCGGGGCTGCATTTGAAACTGCGGTGCTCGAGTCCAGGAGAGGCAGGCGGAATTCCTAG	TACGTATGGAGCAAGCGTTATCCGGATTTACTGGGTGTAAAGGGTGCGTAGGCGGCGCGGCAAGTCAGATGTGAAAGACCGGGGCTCAACCCCGGGGCTGCATTTGAAACTGCGGTGCTCGAGTCCAGGAGAGGCAGGCGGAATTCCTAG	1.0
TACGTATGGTGCAAGCGTTATCCGGATTTACTGGGTGTAAAGGGAGCGTAGACGGACTTGCAAGTCTGAAGTGAAAGCCCGGGGCTCAACCCCGGGACTGCTTTGGAAACTGTAGGTCTAGAGTGCTGGAGAGGTAAGTGGAATTCCTAG	TACGTATGGTGCAAGCGTTATCCGGATTTACTGGGTGTAAAGGGAGCGTAGACGGACTTGCAAGTCTGAAGTGAAAGCCCGGGGCTCAACCCCGGGACTGCTTTGGAAACTGTAGGTCTAGAGTGCTGGAGAGGTAAGTGGAATTCCTAG	1.0
TACGTATGGTGCAAGCGTTATCCGGATTTACTGGGTGTAAAGGGAGCGTAGACGGAGAAGCAAGTCTGGAGTGAAAGCCCGGGGCTCAACCCCGGGACTGCTTTGGAAACTGTTATTCTTGAGTGCCGGAGAGGTAAGCGGAATTCCTAG	TACGTATGGTGCAAGCGTTATCCGGATTTACTGGGTGTAAAGGGAGCGTAGACGGAGAAGCAAGTCTGGAGTGAAAGCCCGGGGCTCAACCCCGGGACTGCTTTGGAAACTGTTATTCTTGAGTGCCGGAGAGGTAAGCGGAATTCCTAG	1.0
TACGTATGGTGCAAGCGTTATCCGGATTTACTGGGTGTAAAGGGAGCGTAGACGGAGAGGCAAGTCTGAAGTGAAAGCCCGGGGCTCAACCCCGGGACTGCTTTGGAAACTGCAGTTCTAGAGTGCCGGAGAGGTAAGCGGAATTCCTAG	TACGTATGGTGCAAGCGTTATCCGGATTTACTGGGTGTAAAGGGAGCGTAGACGGAGAGGCAAGTCTGAAGTGAAAGCCCGGGGCTCAACCCCGGGACTGCTTTGGAAACTGCAGTTCTAGAGTGCCGGAGAGGTAAGCGGAATTCCTAG	1.0
TACGTATGGTGCAAGCGTTATCCGGATTTACTGGGTGTAAAGGGAGCGTAGACGGATAGGCAAGTCTGAAGTGAAAGCCCGGGGCTCAACCCCGGGACTGCTTTGGAAACTGTTTATCTAGAGTGCTGGAGAGGTAAGTGGAATTCCTAG	TACGTATGGTGCAAGCGTTATCCGGATTTACTGGGTGTAAAGGGAGCGTAGACGGATAGGCAAGTCTGAAGTGAAAGCCCGGGGCTCAACCCCGGGACTGCTTTGGAAACTGTTTATCTAGAGTGCTGGAGAGGTAAGTGGAATTCCTAG	1.0
TACGTATGGTGCAAGCGTTATCCGGATTTACTGGGTGTAAAGGGAGCGTAGACGGATAGGCAAGTCTGGAGTGAAAACCCGGGGCTCAACCCCGGGACTGCTTTGGAAACTGTTTATCTAGAGTGCTGGAGAGGTAAGTGGAATTCCTAG	TACGTATGGTGCAAGCGTTATCCGGATTTACTGGGTGTAAAGGGAGCGTAGACGGATAGGCAAGTCTGGAGTGAAAACCCGGGGCTCAACCCCGGGACTGCTTTGGAAACTGTTTATCTAGAGTGCTGGAGAGGTAAGTGGAATTCCTAG	1.0
TACGTATGGTGCAAGCGTTATCCGGATTTACTGGGTGTAAAGGGAGCGTAGACGGATAGGCAAGTCTGGAGTGAAAGCCCGGGGCTCAACCCCGGGACTGCTTTGGAAACTGTTTATCTAGAGTGCTGGAGAGGTAAGTGGAATTCCTAG	TACGTATGGTGCAAGCGTTATCCGGATTTACTGGGTGTAAAGGGAGCGTAGACGGATAGGCAAGTCTGGAGTGAAAGCCCGGGGCTCAACCCCGGGACTGCTTTGGAAACTGTTTATCTAGAGTGCTGGAGAGGTAAGTGGAATTCCTAG	1.0
TACGTATGTCGCAAGCGTTATCCGGATTTATTGGGCGTAAAGCGCGTCTAGGCGGTTTGGTAAGTCTGATGTGAAAATGCGGGGCTCAACTCCGTATTGCGTTGGAAACTGCCAAACTAGAGTACTGGAGAGGTGGGCGGAACTACAAGT	TACGTATGTCGCAAGCGTTATCCGGATTTATTGGGCGTAAAGCGCGTCTAGGCGGTTTGGTAAGTCTGATGTGAAAATGCGGGGCTCAACTCCGTATTGCGTTGGAAACTGCCAAACTAGAGTACTGGAGAGGTGGGCGGAACTACAAGT	1.0
TACGTATGTCGCAAGCGTTATCCGGATTTATTGGGCGTAAAGCGCGTCTAGGCGGTTTGGTAAGTCTGATGTGAAAATGCGGGGCTCAACTCCGTATTGCGTTGGAAACTGTCAAACTAGAGTACTGGAGAGGTGGGCGGAACTACAAGT	TACGTATGTCGCAAGCGTTATCCGGATTTATTGGGCGTAAAGCGCGTCTAGGCGGTTTGGTAAGTCTGATGTGAAAATGCGGGGCTCAACTCCGTATTGCGTTGGAAACTGTCAAACTAGAGTACTGGAGAGGTGGGCGGAACTACAAGT	1.0
TACGTATGTTCCAAGCGTTATCCGGATTTATTGGGCGTAAAGCGAGCGCAGACGGTTATTTAAGTCTGAAGTGAAAGCCCTCAGCTCAACTGAGGAAGGGCTTTGGAAACTGGATAACTTGAGTGCAGTAGAGGAAAGTGGAACTCCATG	TACGTATGTTCCAAGCGTTATCCGGATTTATTGGGCGTAAAGCGAGCGCAGACGGTTATTTAAGTCTGAAGTGAAAGCCCTCAGCTCAACTGAGGAAGGGCTTTGGAAACTGGATAACTTGAGTGCAGTAGAGGAAAGTGGAACTCCATG	1.0
TACGTATGTTCCAAGCGTTATCCGGATTTATTGGGCGTAAAGCGAGCGCAGACGGTTATTTAAGTCTGAAGTGAAAGCCCTCAGCTCAACTGAGGAATGGCTTTGGAAACTGGATGACTTGAGTGCAGTAGAGGAAAGTGGAACTCCATG	TACGTATGTTCCAAGCGTTATCCGGATTTATTGGGCGTAAAGCGAGCGCAGACGGTTATTTAAGTCTGAAGTGAAAGCCCTCAGCTCAACTGAGGAATGGCTTTGGAAACTGGATGACTTGAGTGCAGTAGAGGAAAGTGGAACTCCATG	1.0
TACGTATGTTCCAAGCGTTATCCGGATTTATTGGGCGTAAAGCGAGCGCAGACGGTTATTTAAGTCTGAAGTGAAAGCCCTCAGCTCAACTGAGGAATTGCTTTGGAAACTGGATGACTTGAGTGCAGTAGAGGAAAGTGGAACTCCATG	TACGTATGTTCCAAGCGTTATCCGGATTTATTGGGCGTAAAGCGAGCGCAGACGGTTATTTAAGTCTGAAGTGAAAGCCCTCAGCTCAACTGAGGAATTGCTTTGGAAACTGGATGACTTGAGTGCAGTAGAGGAAAGTGGAACTCCATG	1.0
TTCCAGCTCCAATAGCGTATATTAAAGTTGTTGCTATTAAAAAGCCCGTAGTTGAATTTGAGGAGTAAAGTTTAGGTCCATTGAAAGATGAGTACTTTAACTTTATTCCTTCCCTTGTAGTGAACTATATTGAAGAAATTTGGTATAGGG	TTCCAGCTCCAATAGCGTATATTAAAGTTGTTGCTATTAAAAAGCCCGTAGTTGAATTTGAGGAGTAAAGTTTAGGTCCATTGAAAGATGAGTACTTTAACTTTATTCCTTCCCTTGTAGTGAACTATATTGAAGAAATTTGGTATAGGG	1.0
CACAAGTAAGACAAGTGTTATTCATCATTATTAGGTTTAAAGCGTACCTAGACGGCATTTTATACCGATAAAAAGGTCACTTTTTTGCTAGAGTTTGATATGGGAGGAAAATATTAGGACTATTGGTGTAGAGATGAAATTCTTTGATAC	CACAAGTAAGACAAGTGTTATTCATCATTATTAGGTTTAAAGCGTACCTAGACGGCATTTTATACCGATAAAAAGGTCACTTTTTTGCTAGAGTTTGATATGGGAGGAAAATATTAGGACTATTGGTGTAGAGATGAAATTCTTTGATAC	0.0
CACGTAGGGCCCGAGCGTTGTCCGGAGTTACTGGGCGTAAAGCGTGCGCAGGCGGCGGTCCAAGCCTGGCGTGAAAGCCCCCGGCTCAACCGGGGAGGGTCGTCGGGGACTGGGCCGCTTGAGGGCGGTAGGGGCTGGTGGAATTCCCGG	CACGTAGGGCCCGAGCGTTGTCCGGAGTTACTGGGCGTAAAGCGTGCGCAGGCGGCGGTCCAAGCCTGGCGTGAAAGCCCCCGGCTCAACCGGGGAGGGTCGTCGGGGACTGGGCCGCTTGAGGGCGGTAGGGGCTGGTGGAATTCCCGG	0.0
CACGTAGGGTGCGAGCGTTGTCCGGAATTATTGGGCGTAAAGAGCTCGTAGGCGGTGTGTCGCGTCGGCCGTGAAAACCTGTGGCTTAACTGCGGGCTTGCGGTCGATACGGGCATCACTGGAGTTCGGCAGGGGAGACTGGAATTCCTG	CACGTAGGGTGCGAGCGTTGTCCGGAATTATTGGGCGTAAAGAGCTCGTAGGCGGTGTGTCGCGTCGGCCGTGAAAACCTGTGGCTTAACTGCGGGCTTGCGGTCGATACGGGCATCACTGGAGTTCGGCAGGGGAGACTGGAATTCCTG	0.0
CACGTAGGGTGCGAGCGTTGTCCGGAATTATTGGGCGTAAAGAGCTCGTAGGCGGTGTGTCGCGTCGGCCGTGAAAACTTGCAGCTTAACTGTGAGCTTGCGGTCGATACGGGCATCACTGGAGTTCGGCAGGGGAGACTGGAATTCCTG	CACGTAGGGTGCGAGCGTTGTCCGGAATTATTGGGCGTAAAGAGCTCGTAGGCGGTGTGTCGCGTCGGCCGTGAAAACTTGCAGCTTAACTGTGAGCTTGCGGTCGATACGGGCATCACTGGAGTTCGGCAGGGGAGACTGGAATTCCTG	0.0
GACAGAGGGGGCAAGCGTTGTCCGGAATTACTGGGCGTAAAGCGCGCGCAGGCGGATACGTATGTGCCCGGTGACAGCCTCCCGCTCAACGGGAGAAGGCCTGGGTAGACAGCGTATCTGGAGGCAGGGAGAGGGTGATGGAATGCCCGG	GACAGAGGGGGCAAGCGTTGTCCGGAATTACTGGGCGTAAAGCGCGCGCAGGCGGATACGTATGTGCCCGGTGACAGCCTCCCGCTCAACGGGAGAAGGCCTGGGTAGACAGCGTATCTGGAGGCAGGGAGAGGGTGATGGAATGCCCGG	0.0
GACAGAGGGGGCAAGCGTTGTCCGGAATTACTGGGCGTAAAGCGCGCGCAGGCGGCGATGTATGTGCCTGGTGACAGTCTCTCGCTCAACGAGAGGAGGCCTGGGTAGACAGCATGGCTGGAGGCAGGGAGAGGGTGATGGAATGCCCGG	GACAGAGGGGGCAAGCGTTGTCCGGAATTACTGGGCGTAAAGCGCGCGCAGGCGGCGATGTATGTGCCTGGTGACAGTCTCTCGCTCAACGAGAGGAGGCCTGGGTAGACAGCATGGCTGGAGGCAGGGAGAGGGTGATGGAATGCCCGG	0.0
GACAGAGGGGGCAAGCGTTGTCCGGACTTACTGGGCGTACAGCGCGCGCAGGCGGCACGGTATGTGCCCGGTGACAGCCTCCCGCTCAACGGGAGAGGGCCCGGGTAGACAGCCGCGCTGGAGGCCGAGAGAGGGATGTGGAATACCCGG	GACAGAGGGGGCAAGCGTTGTCCGGACTTACTGGGCGTACAGCGCGCGCAGGCGGCACGGTATGTGCCCGGTGACAGCCTCCCGCTCAACGGGAGAGGGCCCGGGTAGACAGCCGCGCTGGAGGCCGAGAGAGGGATGTGGAATACCCGG	0.0
GACAGAGGGGGCAAGCGTTGTCCGGATTAACTGGGCGTACAGCGCGCGCAGGTGGGTCGGTTAGTCACCTGTGACATTGTTCGGCTCAACCGAACAGGGTCAGGTGAGACTGCCAGCCTGGAGGGATGGAGAGGGACGTGGAATACCCGG	GACAGAGGGGGCAAGCGTTGTCCGGATTAACTGGGCGTACAGCGCGCGCAGGTGGGTCGGTTAGTCACCTGTGACATTGTTCGGCTCAACCGAACAGGGTCAGGTGAGACTGCCAGCCTGGAGGGATGGAGAGGGACGTGGAATACCCGG	0.0
GACAGAGGGGGCAAGCGTTGTCCGGATTTACTGGGCGTACAGCGCGCGCAGGTGGCGGAGTATGTGCCGTGTGACAATTGGACGCTTAACGTCCAGAGGCCACGGTAGACAGCTTGGCTGGAGGCAGGGAGAGGGCTGTGGAATACCCGG	GACAGAGGGGGCAAGCGTTGTCCGGATTTACTGGGCGTACAGCGCGCGCAGGTGGCGGAGTATGTGCCGTGTGACAATTGGACGCTTAACGTCCAGAGGCCACGGTAGACAGCTTGGCTGGAGGCAGGGAGAGGGCTGTGGAATACCCGG	0.0
GACAGAGGGGGCAAGCGTTGTCCGGATTTACTGGGCGTACAGCGCGCGCAGGTGGTCGGCTATGTGCCGTGTGACAATCGACGGCTCAACCGTCGACGGCCACGGTAGACAGGCGGACTGGAGGCAGGGAGAGGGCTGTGGAATACCCGG	GACAGAGGGGGCAAGCGTTGTCCGGATTTACTGGGCGTACAGCGCGCGCAGGTGGTCGGCTATGTGCCGTGTGACAATCGACGGCTCAACCGTCGACGGCCACGGTAGACAGGCGGACTGGAGGCAGGGAGAGGGCTGTGGAATACCCGG	0.0
GACAGAGGGTGCTAGCGTTGTTCGGAATTACTGGGCGTAAAGGGCGCGTAGGCGGCTCGTTTAGTCGGGTGTGAAATCCCAAGGCTCAACCTTGGAACTGCATTCGATACTGGCGGGCTAGAGACCGGAAGAGGTGGGTGGAATACCCAG	GACAGAGGGTGCTAGCGTTGTTCGGAATTACTGGGCGTAAAGGGCGCGTAGGCGGCTCGTTTAGTCGGGTGTGAAATCCCAAGGCTCAACCTTGGAACTGCATTCGATACTGGCGGGCTAGAGACCGGAAGAGGTGGGTGGAATACCCAG	0.0
GACAGAGGTGCCAAGCGTTAGGCGGAATCACTGGGCTTAAAGCGTGTGTAGGCGGATTTGTAAGTACCTTGTGAAATCCCACGGCTCAACCGTGGAACTGCTCGGTATACTGCTTATCTTGAGCCACTTAGGGGCTACCGGAACAAATGG	GACAGAGGTGCCAAGCGTTAGGCGGAATCACTGGGCTTAAAGCGTGTGTAGGCGGATTTGTAAGTACCTTGTGAAATCCCACGGCTCAACCGTGGAACTGCTCGGTATACTGCTTATCTTGAGCCACTTAGGGGCTACCGGAACAAATGG	0.0
GACAGAGGTGCCGAGCGTTAGGCGGAATCACTGGGCTTAAAGCGTGTGTAGGCGGACCCGTAAGTACCTTGTGAAATCCCACGGCTCAACCGTGGAACTGCTCGGTATACTGCGGGTCTTGAGCGGTTTAGGGGCTGTCGGAACAGACGG	GACAGAGGTGCCGAGCGTTAGGCGGAATCACTGGGCTTAAAGCGTGTGTAGGCGGACCCGTAAGTACCTTGTGAAATCCCACGGCTCAACCGTGGAACTGCTCGGTATACTGCGGGTCTTGAGCGGTTTAGGGGCTGTCGGAACAGACGG	0.0
GACGAACCGTCCAAACGTTATTCGGTATCACTGGGCTTAAAGCGTGCGTAGGCGGCCTGGTAGGTGAGATGTGAAAGCCCACGGCTCAACCGTGGAATTGCGTTTCAAACCACCAGGCTTGAGGATGGCAGGGGTGATGGGAACTGATGG	GACGAACCGTCCAAACGTTATTCGGTATCACTGGGCTTAAAGCGTGCGTAGGCGGCCTGGTAGGTGAGATGTGAAAGCCCACGGCTCAACCGTGGAATTGCGTTTCAAACCACCAGGCTTGAGGATGGCAGGGGTGATGGGAACTGATGG	0.0
GACGAACCGTGCGAACGTTATTCGGAATCACTGGGCTTAAAGCGCGTGTAGGCGGCCCGGAACGTCTTTCGCTGAAATCCCCCGGCTCAACCGGGGAACGGGCGGGGATACGACCGGGCTGGAGGGGGGTAGGGGGAGCCGGAACTCACG	GACGAACCGTGCGAACGTTATTCGGAATCACTGGGCTTAAAGCGCGTGTAGGCGGCCCGGAACGTCTTTCGCTGAAATCCCCCGGCTCAACCGGGGAACGGGCGGGGATACGACCGGGCTGGAGGGGGGTAGGGGGAGCCGGAACTCACG	0.0
GACGAACCGTGCGAACGTTATTCGGAATCACTGGGCTTAAAGCGCGTGTAGGCGGGCCGCCGCGTCGGCTGCTGAAATCCCCCGGCTCAACCGGGGAAGGGGCACCGAAACGGGCGGCCTGGAGGGGAGTAGGGGGACCTGGAACTTCCG	GACGAACCGTGCGAACGTTATTCGGAATCACTGGGCTTAAAGCGCGTGTAGGCGGGCCGCCGCGTCGGCTGCTGAAATCCCCCGGCTCAACCGGGGAAGGGGCACCGAAACGGGCGGCCTGGAGGGGAGTAGGGGGACCTGGAACTTCCG	0.0
GACGAACCGTGCGAACGTTATTCGGAATCACTGGGCTTAAAGCGCGTGTAGGCGGGGCGGTGCGTCGGTCGCTGAAATCCCCCGGCTCAACCGGGGAAGGGGCGCCGAGACGACCGGCCTGGAGCGACGTAGGGGGAACTGGAACTTCCG	GACGAACCGTGCGAACGTTATTCGGAATCACTGGGCTTAAAGCGCGTGTAGGCGGGGCGGTGCGTCGGTCGCTGAAATCCCCCGGCTCAACCGGGGAAGGGGCGCCGAGACGACCGGCCTGGAGCGACGTAGGGGGAACTGGAACTTCCG	0.0
GACGGAGGATGCAAGCGTTATCCGGAATGATTGGGCGTAAAGCGTCCGCAGGTGGCCCTTCAAGTCTGCTGTCAAAGAGCAAGGCTCAACCTTGTCAAGGCAGTGGAAACTGAAAGGCTAGAGTGTGGTAGGGGTAGAGGGAATTCCCAG	GACGGAGGATGCAAGCGTTATCCGGAATGATTGGGCGTAAAGCGTCCGCAGGTGGCCCTTCAAGTCTGCTGTCAAAGAGCAAGGCTCAACCTTGTCAAGGCAGTGGAAACTGAAAGGCTAGAGTGTGGTAGGGGTAGAGGGAATTCCCAG	0.0
GACGGAGGATGCAAGCGTTATCCGGAATTATTGGGCGTAAAGCGTCCGCAGGTGGATTTACAAGTCTGCTGTTAAAGTGCAGAGCTTAACTCTGTAAAGGCGGTGGAAACTGTAAGTCTTGAGTATGGTAGGGGTAGAGGGAATTCCCGG	GACGGAGGATGCAAGCGTTATCCGGAATTATTGGGCGTAAAGCGTCCGCAGGTGGATTTACAAGTCTGCTGTTAAAGTGCAGAGCTTAACTCTGTAAAGGCGGTGGAAACTGTAAGTCTTGAGTATGGTAGGGGTAGAGGGAATTCCCGG	0.0
GACGGAGGATGCAAGCGTTATCCGGAATTATTGGGCGTAAAGCGTCCGCAGGTGGCTTATCAAGTCTGCTGTCAAAGCCCGGGGCTCAACCCTGGAGAGGCAGTGGAAACTGGTAAGCTCGAGTGCGGTAGGGGCAGAGGGAATTCCCGG	GACGGAGGATGCAAGCGTTATCCGGAATTATTGGGCGTAAAGCGTCCGCAGGTGGCTTATCAAGTCTGCTGTCAAAGCCCGGGGCTCAACCCTGGAGAGGCAGTGGAAACTGGTAAGCTCGAGTGCGGTAGGGGCAGAGGGAATTCCCGG	0.0
GACGGAGGATGCAAGCGTTATCCGGAATTATTGGGCGTAAAGCGTCCGCAGGTGGGTTTACAAGTCTGCTGTCAAAGTGCAGAGCTTAACTCTGTAAAGGCGGTGGAAACTGTAAGTCTTGAGTATGGTAGGGGTAGAGGGAATTCCCGG	GACGGAGGATGCAAGCGTTATCCGGAATTATTGGGCGTAAAGCGTCCGCAGGTGGGTTTACAAGTCTGCTGTCAAAGTGCAGAGCTTAACTCTGTAAAGGCGGTGGAAACTGTAAGTCTTGAGTATGGTAGGGGTAGAGGGAATTCCCGG	0.0
GACGGAGGATGCAAGTGTTATCCGGAATCACTGGGCGTAAAGCGTCTGTAGGTGGTTCGAAAAGTCCACTGTTAAAGATTGAGGCTTAACTTCAAAAATGCCGTGGAAACTTTCAAACTAGAGTATGGTAGGGGTAGAGGGAATTTCCAG	GACGGAGGATGCAAGTGTTATCCGGAATCACTGGGCGTAAAGCGTCTGTAGGTGGTTCGAAAAGTCCACTGTTAAAGATTGAGGCTTAACTTCAAAAATGCCGTGGAAACTTTCAAACTAGAGTATGGTAGGGGTAGAGGGAATTTCCAG	0.0
GACGGAGGATGCAAGTGTTGTCCGGAATCACTGGGCGTAAAGCGTCTGTAGGTGGTTTAAAAAGTCTGCTGTTAAAAGTTGAAGCTTAACTTCAAAGATGCCGTAGAAACTTTTAAACTTGAGGATGGTAGGGGTAGAGGGAATTTCCAG	GACGGAGGATGCAAGTGTTGTCCGGAATCACTGGGCGTAAAGCGTCTGTAGGTGGTTTAAAAAGTCTGCTGTTAAAAGTTGAAGCTTAACTTCAAAGATGCCGTAGAAACTTTTAAACTTGAGGATGGTAGGGGTAGAGGGAATTTCCAG	0.0
GACGGAGGGCGCTAGCGTTGTTCGGAATCACTGGGCGTAAAGGGCGCGCAGGCGGCCCGGCCAGTCGGGTGTGAAAGCCCGGGGCTCAACCCCGGAACGGCACCCGATACTGCCGGGCTCGAGGCCGGGAGAGGGTGGTGGAATACCCAG	GACGGAGGGCGCTAGCGTTGTTCGGAATCACTGGGCGTAAAGGGCGCGCAGGCGGCCCGGCCAGTCGGGTGTGAAAGCCCGGGGCTCAACCCCGGAACGGCACCCGATACTGCCGGGCTCGAGGCCGGGAGAGGGTGGTGGAATACCCAG	0.0
GACGGAGGGTGCTAGCGTTGTTCGGAATGACTGGGCGTAAAGGGCGCGTAGGCGGCCATTCACGTCGGATGTGAAAGCCCGGGGCTCAACCCCGGAACGGCATCCGATACGGGCTGGCTCGAGACCGAGAGAGGTGAGTGGAATACCCAG	GACGGAGGGTGCTAGCGTTGTTCGGAATGACTGGGCGTAAAGGGCGCGTAGGCGGCCATTCACGTCGGATGTGAAAGCCCGGGGCTCAACCCCGGAACGGCATCCGATACGGGCTGGCTCGAGACCGAGAGAGGTGAGTGGAATACCCAG	0.0
GACGTAGGGCGCGAGCGTTGTCCGGATTTATTGGGCGTAAAGAGCTCGTAGGCGGCTTGTCGCGTCGACCGTGAAAACTTGGGGCTCAACCCCAAGCCTGCGGTCGATACGGGCAGGCTAGAGTTCGGTAGGGGAGACTGGAATTCCTGG	GACGTAGGGCGCGAGCGTTGTCCGGATTTATTGGGCGTAAAGAGCTCGTAGGCGGCTTGTCGCGTCGACCGTGAAAACTTGGGGCTCAACCCCAAGCCTGCGGTCGATACGGGCAGGCTAGAGTTCGGTAGGGGAGACTGGAATTCCTGG	0.0
GACGTAGGGCGCGAGCGTTGTCCGGATTTATTGGGCGTAAAGAGCTCGTAGGCGGCTTGTCGCGTCGACTGTGAAAACCCGCGGCTCAACCGCGGGCCTGCAGCCGATACGGGCAGGCTAGAGTTCGGTAGGGGAGACTGGAATTCCTGG	GACGTAGGGCGCGAGCGTTGTCCGGATTTATTGGGCGTAAAGAGCTCGTAGGCGGCTTGTCGCGTCGACTGTGAAAACCCGCGGCTCAACCGCGGGCCTGCAGCCGATACGGGCAGGCTAGAGTTCGGTAGGGGAGACTGGAATTCCTGG	0.0
GACGTAGGGCGCGAGCGTTGTCCGGATTTATTGGGCGTAAAGAGCTCGTAGGCGGCTTGTCGCGTCGACTGTGAAAACCCGCGGCTCAACTGCGGGCTTGCAGCCGATACGGGCAGGCTAGAGTTCGGTAGGGGAGACTGGAATTCCTGG	GACGTAGGGCGCGAGCGTTGTCCGGATTTATTGGGCGTAAAGAGCTCGTAGGCGGCTTGTCGCGTCGACTGTGAAAACCCGCGGCTCAACTGCGGGCTTGCAGCCGATACGGGCAGGCTAGAGTTCGGTAGGGGAGACTGGAATTCCTGG	0.0
GACGTAGGGGGCGAGCGTTGTCCGGAATTATTGGGCGTAAAGGGCTCGTAGGCGGTTCGGTAAGTCAGATGTGAAAACTCAGGGCTCAACCCTGAGACGCCATCTGATACTGCTGTGACTTGAGTTCGGTAGAGGAGTGTGGAATTCCTG	GACGTAGGGGGCGAGCGTTGTCCGGAATTATTGGGCGTAAAGGGCTCGTAGGCGGTTCGGTAAGTCAGATGTGAAAACTCAGGGCTCAACCCTGAGACGCCATCTGATACTGCTGTGACTTGAGTTCGGTAGAGGAGTGTGGAATTCCTG	0.0
GACGTAGGGGGCGAGCGTTGTCCGGAATTATTGGGCGTAAAGGGCTCGTAGGCGGTTCGGTAAGTCGGATGTGAAAACTTGGGGCTCAACCCTGAGACGCCATCTGATACTGCTGTGACTTGAGTTCGGTAGAGGAGTGTGGAATTCCTG	GACGTAGGGGGCGAGCGTTGTCCGGAATTATTGGGCGTAAAGGGCTCGTAGGCGGTTCGGTAAGTCGGATGTGAAAACTTGGGGCTCAACCCTGAGACGCCATCTGATACTGCTGTGACTTGAGTTCGGTAGAGGAGTGTGGAATTCCTG	0.0
GACGTAGGGTCCAAGCGTTGTCCGGAGTTACTGGGCGTAAAGCGCGCGCAGGCGGTCCATCGCATCGGCGGTGAAAGCCCCCCGCTCAACGGGGGAGGGTCCGACGAGATGGGTGGACTGGAGGCAGGGAGAGGCGAGTGGAATTCCGGG	GACGTAGGGTCCAAGCGTTGTCCGGAGTTACTGGGCGTAAAGCGCGCGCAGGCGGTCCATCGCATCGGCGGTGAAAGCCCCCCGCTCAACGGGGGAGGGTCCGACGAGATGGGTGGACTGGAGGCAGGGAGAGGCGAGTGGAATTCCGGG	0.0
TACAGAGGGGGCAAGCGTTGTCCGGAATTACTGGGCGTACAGCGCGCGCAGGCGGCTGGGGACGTGCCGTGTGACAAGCCACCGCTCACCGGTGGAGGGCCATGGTACACGACCCGGCTGGAGGCAGGGAGAGGGATGTGGAATGCCCGG	TACAGAGGGGGCAAGCGTTGTCCGGAATTACTGGGCGTACAGCGCGCGCAGGCGGCTGGGGACGTGCCGTGTGACAAGCCACCGCTCACCGGTGGAGGGCCATGGTACACGACCCGGCTGGAGGCAGGGAGAGGGATGTGGAATGCCCGG	0.0
TACAGAGGGGGCAAGCGTTGTCCGGAATTACTGGGCGTAGAGCGCGCGCAGGCGGCTCGCGACGTGCCGTGTGACAAGCGGGGGCTTAACCCCCGAGGGTCACGGTAGACGCGCGAGCTGGAGGCAGGGAGAGGGATGTGGAATGCCCGG	TACAGAGGGGGCAAGCGTTGTCCGGAATTACTGGGCGTAGAGCGCGCGCAGGCGGCTCGCGACGTGCCGTGTGACAAGCGGGGGCTTAACCCCCGAGGGTCACGGTAGACGCGCGAGCTGGAGGCAGGGAGAGGGATGTGGAATGCCCGG	0.0
TACAGAGGGGGCAAGCGTTGTCCGGACTTACTGGGCGTACAGCGCGCGCAGGCGGCACCATATGTGCCCGGTGACATCTGCTCGCTTAACGAGCAGCGGCCCGGGTAGACAGTGGCGCTGGAGGCAGGGAGAGGGATGTGGAATACCCGG	TACAGAGGGGGCAAGCGTTGTCCGGACTTACTGGGCGTACAGCGCGCGCAGGCGGCACCATATGTGCCCGGTGACATCTGCTCGCTTAACGAGCAGCGGCCCGGGTAGACAGTGGCGCTGGAGGCAGGGAGAGGGATGTGGAATACCCGG	0.0
TACAGAGGGGGCAAGCGTTGTCCGGACTTACTGGGCGTACAGCGCGCGCAGGCGGCGCCATATGTGCTTGGTGACATCGGCTCGCTCAACGAGCCGCGGCCCGAGTAGACAGTGGTGCTGGAGGCAGGGAGAGGGATGTGGAATACCCGG	TACAGAGGGGGCAAGCGTTGTCCGGACTTACTGGGCGTACAGCGCGCGCAGGCGGCGCCATATGTGCTTGGTGACATCGGCTCGCTCAACGAGCCGCGGCCCGAGTAGACAGTGGTGCTGGAGGCAGGGAGAGGGATGTGGAATACCCGG	0.0
TACAGAGGGGGCAAGCGTTGTCCGGACTTACTGGGCGTACAGCGCGCGCAGGCGGCGGCATATGTGCCCGGTGACATCTGCTCGCTTAACGAGCAGCGGCCCGGGTAGACAGTGGCGCTGGAGGCAGGGAGAGGGATGTGGAATACCCGG	TACAGAGGGGGCAAGCGTTGTCCGGACTTACTGGGCGTACAGCGCGCGCAGGCGGCGGCATATGTGCCCGGTGACATCTGCTCGCTTAACGAGCAGCGGCCCGGGTAGACAGTGGCGCTGGAGGCAGGGAGAGGGATGTGGAATACCCGG	0.0
TACAGAGGGGGCAAGCGTTGTCCGGACTTACTGGGCGTACAGCGCGCGCAGGCGGTCATATATGTGCCCGGTGACATCTGCTCGCTTAACGAGCAGCGGCCCGGGTAGACAGTGTGACTGGAGGCAGGGAGAGGGATGTGGAATACCCGG	TACAGAGGGGGCAAGCGTTGTCCGGACTTACTGGGCGTACAGCGCGCGCAGGCGGTCATATATGTGCCCGGTGACATCTGCTCGCTTAACGAGCAGCGGCCCGGGTAGACAGTGTGACTGGAGGCAGGGAGAGGGATGTGGAATACCCGG	0.0
TACAGAGGGGGCAAGCGTTGTCCGGACTTACTGGGCGTACAGCGCGCGCAGGCGGTCGTATATGTGCCCGGTGACATCTGCACGCTCAACGTGCAGCGGTCTGGGTAGACAGTGCGACTGGAGGCAGGGAGAGGGATGTGGAATACCCGG	TACAGAGGGGGCAAGCGTTGTCCGGACTTACTGGGCGTACAGCGCGCGCAGGCGGTCGTATATGTGCCCGGTGACATCTGCACGCTCAACGTGCAGCGGTCTGGGTAGACAGTGCGACTGGAGGCAGGGAGAGGGATGTGGAATACCCGG	0.0
TACAGAGGGGGCAAGCGTTGTCCGGACTTACTGGGCGTACAGCGCGCGCAGGCGGTCGTATATGTGCCCGGTGACATCTGCGCGCTCAACGCGCAGCGGTCTGGGTAGACAGTGCGACTGGAGGCAGGGAGAGGGATGTGGAATACCCGG	TACAGAGGGGGCAAGCGTTGTCCGGACTTACTGGGCGTACAGCGCGCGCAGGCGGTCGTATATGTGCCCGGTGACATCTGCGCGCTCAACGCGCAGCGGTCTGGGTAGACAGTGCGACTGGAGGCAGGGAGAGGGATGTGGAATACCCGG	0.0
TACAGAGGGGGCAAGCGTTGTCCGGACTTACTGGGCGTACAGCGCGCGCAGGCGGTCGTATATGTGCCCGGTGACATCTGCGCGCTTAACGCGCAGCGGCCCGGGTAGACAGTGCGACTGGAGGCAGGGAGAGGGATGTGGAATACCCGG	TACAGAGGGGGCAAGCGTTGTCCGGACTTACTGGGCGTACAGCGCGCGCAGGCGGTCGTATATGTGCCCGGTGACATCTGCGCGCTTAACGCGCAGCGGCCCGGGTAGACAGTGCGACTGGAGGCAGGGAGAGGGATGTGGAATACCCGG	0.0
TACAGAGGGGGCAAGCGTTGTCCGGACTTACTGGGCGTACAGCGCGCGCAGGCGGTGCCATATGTGCCCGGTGACATCTGCTCGCTTAACGAGCAGCGGCCCGGGTAGACAGTGGCGCTGGAGGCAGGGAGAGGGATGTGGAATACCCGG	TACAGAGGGGGCAAGCGTTGTCCGGACTTACTGGGCGTACAGCGCGCGCAGGCGGTGCCATATGTGCCCGGTGACATCTGCTCGCTTAACGAGCAGCGGCCCGGGTAGACAGTGGCGCTGGAGGCAGGGAGAGGGATGTGGAATACCCGG	0.0
TACAGAGGGGGCAAGCGTTGTCCGGACTTACTGGGCGTACAGCGCGCGCAGGCGGTGCCATATGTGCTCGGTGACATCTGCTCGCTCAACGAGCAGCGGCCCGAGTAGACAGTGGCGCTGGAGGCAGGGAGAGGGATGTGGAATACCCGG	TACAGAGGGGGCAAGCGTTGTCCGGACTTACTGGGCGTACAGCGCGCGCAGGCGGTGCCATATGTGCTCGGTGACATCTGCTCGCTCAACGAGCAGCGGCCCGAGTAGACAGTGGCGCTGGAGGCAGGGAGAGGGATGTGGAATACCCGG	0.0
TACAGAGGGGGCAAGCGTTGTCCGGACTTACTGGGCGTACAGCGCGCGCAGGCGGTGCCATATGTGCTTGGTGACATCGGCTCGCTCAACGAGCCGCGGCCCGAGTAGACAGTGGCGCTGGAGGCAGGGAGAGGGATGTGGAATACCCGG	TACAGAGGGGGCAAGCGTTGTCCGGACTTACTGGGCGTACAGCGCGCGCAGGCGGTGCCATATGTGCTTGGTGACATCGGCTCGCTCAACGAGCCGCGGCCCGAGTAGACAGTGGCGCTGGAGGCAGGGAGAGGGATGTGGAATACCCGG	0.0
TACAGAGGGGGCAAGCGTTGTCCGGACTTACTGGGCGTACAGCGCGCGCAGGCGGTTACATATGTGCCCGGTGACATCTGCTCGCTTAACGAGCAGCGGCCCGGGTAGACAGTGTGACTGGAGGCAGGGAGAGGGATGTGGAATACCCGG	TACAGAGGGGGCAAGCGTTGTCCGGACTTACTGGGCGTACAGCGCGCGCAGGCGGTTACATATGTGCCCGGTGACATCTGCTCGCTTAACGAGCAGCGGCCCGGGTAGACAGTGTGACTGGAGGCAGGGAGAGGGATGTGGAATACCCGG	0.0
TACAGAGGGGGCAAGCGTTGTCCGGACTTACTGGGCGTACAGCGCGCGCAGGTGGTCGGCTAAGTTCGTGGTGACAGCGTGCGGCTCAACCGCACACGGTCCATGGAGACTGGTCGACTGGAGGCATCGAGAGGGATACGGAATACCCGG	TACAGAGGGGGCAAGCGTTGTCCGGACTTACTGGGCGTACAGCGCGCGCAGGTGGTCGGCTAAGTTCGTGGTGACAGCGTGCGGCTCAACCGCACACGGTCCATGGAGACTGGTCGACTGGAGGCATCGAGAGGGATACGGAATACCCGG	0.0
TACAGAGGGGGCAAGCGTTGTCCGGACTTACTGGGCGTACAGCGCGCGCAGGTGGTCGGCTAAGTTCGTGGTGACAGCGTGCGGCTCAACCGCACAGGGTCCATGGAGACTGGTCGACTAGAGGCATCGAGAGGGATACGGAATACCCGG	TACAGAGGGGGCAAGCGTTGTCCGGACTTACTGGGCGTACAGCGCGCGCAGGTGGTCGGCTAAGTTCGTGGTGACAGCGTGCGGCTCAACCGCACAGGGTCCATGGAGACTGGTCGACTAGAGGCATCGAGAGGGATACGGAATACCCGG	0.0
TACAGAGGGGGCAAGCGTTGTCCGGATTTACTGGGCGTACAGCGCGCGCAGGCGGACCGCGACGTGCCGTGTGACAAGCCACCGCTCACCGGTGGAGGGCCATGGTACACGAGCGGTCTGGAGGCAGGGAGAGGGATGTGGAATGCCCGG	TACAGAGGGGGCAAGCGTTGTCCGGATTTACTGGGCGTACAGCGCGCGCAGGCGGACCGCGACGTGCCGTGTGACAAGCCACCGCTCACCGGTGGAGGGCCATGGTACACGAGCGGTCTGGAGGCAGGGAGAGGGATGTGGAATGCCCGG	0.0
TACAGAGGGGGCAAGCGTTGTCCGGATTTACTGGGCGTACAGCGCGCGCAGGCGGATGGTGACGTGCCGTGTGACAAGCCACAGCTCAACTGTGGAGGGCCATGGTAGACGCACCGTCTGGAGGCAGGGAGAGGGATGTGGAATACCCGG	TACAGAGGGGGCAAGCGTTGTCCGGATTTACTGGGCGTACAGCGCGCGCAGGCGGATGGTGACGTGCCGTGTGACAAGCCACAGCTCAACTGTGGAGGGCCATGGTAGACGCACCGTCTGGAGGCAGGGAGAGGGATGTGGAATACCCGG	0.0
TACAGAGGGGGCAAGCGTTGTCCGGATTTACTGGGCGTACAGCGCGCGCAGGCGGATGGTGACGTGCCGTGTGACAAGCCCCAGCTCAACTGGGGAGGGCCATGGTAGACGCACGGTCTGGAGGCAGGGAGAGGGATGTGGAATACCCGG	TACAGAGGGGGCAAGCGTTGTCCGGATTTACTGGGCGTACAGCGCGCGCAGGCGGATGGTGACGTGCCGTGTGACAAGCCCCAGCTCAACTGGGGAGGGCCATGGTAGACGCACGGTCTGGAGGCAGGGAGAGGGATGTGGAATACCCGG	0.0
TACAGAGGGGGCAAGCGTTGTCCGGATTTACTGGGCGTACAGCGCGCGCAGGCGGCTGGCGACGTGCCGTGTGACAAGCCACCGCTCACCGGTGGAGGGCCACGGTACACGAGCCGGCTGGAGGCAGGGAGAGGGATGTGGAATGCCCGG	TACAGAGGGGGCAAGCGTTGTCCGGATTTACTGGGCGTACAGCGCGCGCAGGCGGCTGGCGACGTGCCGTGTGACAAGCCACCGCTCACCGGTGGAGGGCCACGGTACACGAGCCGGCTGGAGGCAGGGAGAGGGATGTGGAATGCCCGG	0.0
TACAGAGGGGGCAAGCGTTGTCCGGATTTACTGGGCGTACAGCGCGCGCAGGCGGCTGGCGACGTGCCGTGTGACAAGCCACCGCTCACCGGTGGAGGGCCATGGCACACGAGCCGGCTGGAGGCAGGGAGAGGGATGTGGAATGCCCGG	TACAGAGGGGGCAAGCGTTGTCCGGATTTACTGGGCGTACAGCGCGCGCAGGCGGCTGGCGACGTGCCGTGTGACAAGCCACCGCTCACCGGTGGAGGGCCATGGCACACGAGCCGGCTGGAGGCAGGGAGAGGGATGTGGAATGCCCGG	0.0
TACAGAGGGGGCAAGCGTTGTCCGGATTTACTGGGCGTACAGCGCGCGCAGGCGGCTGGCGACGTGCCGTGTGACACACCACCGCTCACCGGTGGAGGGCCATGGTACACGAGCCGGCTGGAGGCAGGGAGAGGGATGTGGAATGCCCGG	TACAGAGGGGGCAAGCGTTGTCCGGATTTACTGGGCGTACAGCGCGCGCAGGCGGCTGGCGACGTGCCGTGTGACACACCACCGCTCACCGGTGGAGGGCCATGGTACACGAGCCGGCTGGAGGCAGGGAGAGGGATGTGGAATGCCCGG	0.0
TACAGAGGGGGCAAGCGTTGTCCGGATTTACTGGGCGTACAGCGCGCGCAGGCGGCTGGGAACGTGCCGTGTGACAAGCCACCGCTCACCGGTGGAGGGCCATGGTAGACGTCCCGGCTAGAGGCAGGGAGAGGGATGTGGAATGCCCGG	TACAGAGGGGGCAAGCGTTGTCCGGATTTACTGGGCGTACAGCGCGCGCAGGCGGCTGGGAACGTGCCGTGTGACAAGCCACCGCTCACCGGTGGAGGGCCATGGTAGACGTCCCGGCTAGAGGCAGGGAGAGGGATGTGGAATGCCCGG	0.0
TACAGAGGGGGCAAGCGTTGTCCGGATTTACTGGGCGTACAGCGCGCGCAGGCGGCTGGGAACGTGCCGTGTGACAAGCCACCGCTCACCGGTGGAGGGCCATGGTAGACGTCCCGGCTGGAGGCAGGGAGAGGGATGTGGAATGCCCGG	TACAGAGGGGGCAAGCGTTGTCCGGATTTACTGGGCGTACAGCGCGCGCAGGCGGCTGGGAACGTGCCGTGTGACAAGCCACCGCTCACCGGTGGAGGGCCATGGTAGACGTCCCGGCTGGAGGCAGGGAGAGGGATGTGGAATGCCCGG	0.0
TACAGAGGGGGCAAGCGTTGTCCGGATTTACTGGGCGTACAGCGCGCGCAGGCGGCTGGGTACGTGCCGTGTGACATACGGAAGCTTAACTTCCGGGGGCCATGGTAGACGACCCGGCTGGAGGCAGGGAGAGGGATGTGGAATACCCGG	TACAGAGGGGGCAAGCGTTGTCCGGATTTACTGGGCGTACAGCGCGCGCAGGCGGCTGGGTACGTGCCGTGTGACATACGGAAGCTTAACTTCCGGGGGCCATGGTAGACGACCCGGCTGGAGGCAGGGAGAGGGATGTGGAATACCCGG	0.0
TACAGAGGGGGCAAGCGTTGTCCGGATTTACTGGGCGTACAGCGCGCGCAGGCGGGTGGTGACGTGCCGTGTGACAAGCCGCAGCTTAACTGCGGAGGGCCATGGTAGACGCACCGCCTGGAGGCAGGGAGAGGGATGTGGAATACCCGG	TACAGAGGGGGCAAGCGTTGTCCGGATTTACTGGGCGTACAGCGCGCGCAGGCGGGTGGTGACGTGCCGTGTGACAAGCCGCAGCTTAACTGCGGAGGGCCATGGTAGACGCACCGCCTGGAGGCAGGGAGAGGGATGTGGAATACCCGG	0.0
TACAGAGGGGGCAAGCGTTGTCCGGATTTACTGGGCGTACAGCGCGCGCAGGCGGTCGTATATGTGCCTGGTGACATCTTCCCGCTCAACGGGAAGCGGCCCGGGTAGACAGTGGGACTGGAGGCAGGGAGAGGGATGTGGAATACCCGG	TACAGAGGGGGCAAGCGTTGTCCGGATTTACTGGGCGTACAGCGCGCGCAGGCGGTCGTATATGTGCCTGGTGACATCTTCCCGCTCAACGGGAAGCGGCCCGGGTAGACAGTGGGACTGGAGGCAGGGAGAGGGATGTGGAATACCCGG	0.0
TACAGAGGGGGCAAGCGTTGTCCGGATTTACTGGGCGTACAGCGCGCGCAGGCGGTCGTCGACGTGCCGTGTGACAAGCCCCAGCTCAACTGGGGAGGGCCATGGTAGACGCGGGGACTGGAGGCAGGGAGAGGGATGTGGAATACCCGG	TACAGAGGGGGCAAGCGTTGTCCGGATTTACTGGGCGTACAGCGCGCGCAGGCGGTCGTCGACGTGCCGTGTGACAAGCCCCAGCTCAACTGGGGAGGGCCATGGTAGACGCGGGGACTGGAGGCAGGGAGAGGGATGTGGAATACCCGG	0.0
TACAGAGGGTGCAAGCGTTGTTCGGAATCATTGGGCGTAAAGCGCACGTAGGCGGCCGTTTAAGTCCGACTGTGAAAGACCGGGGCTCAACCCCGGGGCTGCAGCGGATACTGAGCGGCTTGAGACACGTAGAGGCTGGCGGAATTCCGG	TACAGAGGGTGCAAGCGTTGTTCGGAATCATTGGGCGTAAAGCGCACGTAGGCGGCCGTTTAAGTCCGACTGTGAAAGACCGGGGCTCAACCCCGGGGCTGCAGCGGATACTGAGCGGCTTGAGACACGTAGAGGCTGGCGGAATTCCGG	0.0
TACAGAGGGTGCAAGCGTTGTTCGGAATTATTGGGCGTAAAGCGCGTGTAGGCGGCGTGACAAGTCGGGTGTGAAAGCCCTCAGCTCAACTGAGGAAGTGCGCCCGAAACTGTCGTGCTTGAGTGCCGGAGAGGGTGGCGGAATTCCCCA	TACAGAGGGTGCAAGCGTTGTTCGGAATTATTGGGCGTAAAGCGCGTGTAGGCGGCGTGACAAGTCGGGTGTGAAAGCCCTCAGCTCAACTGAGGAAGTGCGCCCGAAACTGTCGTGCTTGAGTGCCGGAGAGGGTGGCGGAATTCCCCA	0.0
TACAGAGGGTGCGAGCGTTGTCCGGAATCACTGGGCGTAAAGGGCGCGTAGGCGGTCTGGTAAGCGTGTGGTGAAAGCTCGGGGCTCAACCCCGAGTCGGCCGTGCGAACTGCTGGACTGGAGCATGTCAGAGGCAGGCGGAATTCCGGG	TACAGAGGGTGCGAGCGTTGTCCGGAATCACTGGGCGTAAAGGGCGCGTAGGCGGTCTGGTAAGCGTGTGGTGAAAGCTCGGGGCTCAACCCCGAGTCGGCCGTGCGAACTGCTGGACTGGAGCATGTCAGAGGCAGGCGGAATTCCGGG	0.0
TACAGAGGGTGCGAGCGTTGTCCGGAATCACTGGGCGTAAAGGGCGCGTAGGCGGTCTGGTAAGCGTGTGGTGAAAGCTCGGGGCTCAACCCCGAGTCGGCCGTGCGAACTGCTGGACTTGAGCATGTCAGAGGCAGGCGGAATTCCGGG	TACAGAGGGTGCGAGCGTTGTCCGGAATCACTGGGCGTAAAGGGCGCGTAGGCGGTCTGGTAAGCGTGTGGTGAAAGCTCGGGGCTCAACCCCGAGTCGGCCGTGCGAACTGCTGGACTTGAGCATGTCAGAGGCAGGCGGAATTCCGGG	0.0
TACAGAGGGTGCGAGCGTTGTCCGGAATCACTGGGCGTAAAGGGCGCGTAGGTGGCAGGTCACGCGTGCCGTGAAAGCCCGGGGCTCAACCCCGGGTCGGCGGTGCGAACGGGCCAGCTTGAGCGTACGAGAGGCAGGCGGAATTCCGGG	TACAGAGGGTGCGAGCGTTGTCCGGAATCACTGGGCGTAAAGGGCGCGTAGGTGGCAGGTCACGCGTGCCGTGAAAGCCCGGGGCTCAACCCCGGGTCGGCGGTGCGAACGGGCCAGCTTGAGCGTACGAGAGGCAGGCGGAATTCCGGG	0.0
TACAGAGGGTGCGAGCGTTGTCCGGAATCACTGGGCGTAAAGGGCGCGTAGGTGGCGCGGCAAGCGTGCGGTGAAAGCCCGGGGCTCAACCCCGGGTCGGCCGTGCGAACTGCCGCGCTCGAGCAGAGTAGAGGCGGGTGGAATTCCGGG	TACAGAGGGTGCGAGCGTTGTCCGGAATCACTGGGCGTAAAGGGCGCGTAGGTGGCGCGGCAAGCGTGCGGTGAAAGCCCGGGGCTCAACCCCGGGTCGGCCGTGCGAACTGCCGCGCTCGAGCAGAGTAGAGGCGGGTGGAATTCCGGG	0.0
TACAGAGGGTGCGAGCGTTGTCCGGAATCACTGGGCGTAAAGGGCGCGTAGGTGGCGGGTCACGCGTGCCGTGAAAGCCCGGGGCTCAACCCCGGGTCGGCGGTGCGAACGGGCTCGCTCGAGCGTACGAGAGGCAGGCGGAATTCCGGG	TACAGAGGGTGCGAGCGTTGTCCGGAATCACTGGGCGTAAAGGGCGCGTAGGTGGCGGGTCACGCGTGCCGTGAAAGCCCGGGGCTCAACCCCGGGTCGGCGGTGCGAACGGGCTCGCTCGAGCGTACGAGAGGCAGGCGGAATTCCGGG	0.0
TACAGAGGGTGCGAGCGTTGTCCGGAATTACTGGGCGTAAAGGGCGCGTAGGCGGTCCCTCACGCGTGCCGTGAAAGCCCGGGGCTCAACCCCGGGTCGGCGGTGCGAACGGGGGGACTGGAGCACACCAGAGGCCGGCGGAATTCCGGG	TACAGAGGGTGCGAGCGTTGTCCGGAATTACTGGGCGTAAAGGGCGCGTAGGCGGTCCCTCACGCGTGCCGTGAAAGCCCGGGGCTCAACCCCGGGTCGGCGGTGCGAACGGGGGGACTGGAGCACACCAGAGGCCGGCGGAATTCCGGG	0.0
TACAGAGGGTGCGAGCGTTGTCCGGAATTACTGGGCGTAAAGGGCGCGTAGGTGGCCCGGTGCGCGTGCCGTGAAAGCCCGGGGCTCAACCCCGGGTCGGCGGTGCGAACGGCCGGGCTGGAGCGTACGAGAGGCAGGCGGAATTCCGGG	TACAGAGGGTGCGAGCGTTGTCCGGAATTACTGGGCGTAAAGGGCGCGTAGGTGGCCCGGTGCGCGTGCCGTGAAAGCCCGGGGCTCAACCCCGGGTCGGCGGTGCGAACGGCCGGGCTGGAGCGTACGAGAGGCAGGCGGAATTCCGGG	0.0
TACAGAGGGTGCGAGCGTTGTTCGGAATTACTGGGCGTAAAGCGCGCGCAGGCGGCCCTTTAAGTCTACCCGTGAAATGCCGGAGCTCAACTCCGTGCACGCCGGGGGATACTGGAGGGCTGGAGACAGGTAGAGGCAGGCGGAATTCCG	TACAGAGGGTGCGAGCGTTGTTCGGAATTACTGGGCGTAAAGCGCGCGCAGGCGGCCCTTTAAGTCTACCCGTGAAATGCCGGAGCTCAACTCCGTGCACGCCGGGGGATACTGGAGGGCTGGAGACAGGTAGAGGCAGGCGGAATTCCG	0.0
TACAGAGGGTGCGAGCGTTGTTCGGAATTACTGGGCGTAAAGCGCGCGCAGGCGGCCGTTTAAGTCTCACCGTTCAAGCCCGGAGCTCAACTCCGGTCCGCGGGGGATACTGGACGGCTAGGGACATGTAGGGGCAAGCGGAATTCCGGG	TACAGAGGGTGCGAGCGTTGTTCGGAATTACTGGGCGTAAAGCGCGCGCAGGCGGCCGTTTAAGTCTCACCGTTCAAGCCCGGAGCTCAACTCCGGTCCGCGGGGGATACTGGACGGCTAGGGACATGTAGGGGCAAGCGGAATTCCGGG	0.0
TACAGAGGGTGCGAGCGTTGTTCGGAATTACTGGGCGTAAAGCGCGCGCAGGCGGCCGTTTAAGTCTCACCGTTCAAGCCCGGAGCTCAACTCCGGTCCGCGGGGGATACTGGACGGCTAGGGACATGTAGGGGCGAGCGGAATTCCGGG	TACAGAGGGTGCGAGCGTTGTTCGGAATTACTGGGCGTAAAGCGCGCGCAGGCGGCCGTTTAAGTCTCACCGTTCAAGCCCGGAGCTCAACTCCGGTCCGCGGGGGATACTGGACGGCTAGGGACATGTAGGGGCGAGCGGAATTCCGGG	0.0
TACAGAGGGTGCGAGCGTTGTTCGGAATTACTGGGCGTAAAGCGCGCGCAGGCGGCCTTTTAAGTCTACCCGTGAAATGCCGGAGCTCAACTCCGTGCACGCCGGGGGATACTGGGAGGCTGGAGACATGTAGAGGCAAGCGGAATTCCG	TACAGAGGGTGCGAGCGTTGTTCGGAATTACTGGGCGTAAAGCGCGCGCAGGCGGCCTTTTAAGTCTACCCGTGAAATGCCGGAGCTCAACTCCGTGCACGCCGGGGGATACTGGGAGGCTGGAGACATGTAGAGGCAAGCGGAATTCCG	0.0
TACAGAGGGTGCGAGCGTTGTTCGGAATTACTGGGCGTAAAGCGCGCGCAGGCGGCCTTTTAAGTCTCACCGTTCAAGCCCGGAGCTCAACTCCGGTCCGCGGGGGATACTGGGAGGCTAGGGACATGTAGGGGCGAGCGGAATTCCGGG	TACAGAGGGTGCGAGCGTTGTTCGGAATTACTGGGCGTAAAGCGCGCGCAGGCGGCCTTTTAAGTCTCACCGTTCAAGCCCGGAGCTCAACTCCGGTCCGCGGGGGATACTGGGAGGCTAGGGACATGTAGGGGCGAGCGGAATTCCGGG	0.0
TACAGAGGGTGCGAGCGTTGTTCGGAATTACTGGGCGTAAAGCGCGCGCAGGCGGTCCTTTAAGTCTCACCGTTCAAGCCCGGAGCTCAACTCCGGTCCGCGGGGGATACTGAGGGACTAGGGACATGTAGGGGCAAGCGGAATTCCGGG	TACAGAGGGTGCGAGCGTTGTTCGGAATTACTGGGCGTAAAGCGCGCGCAGGCGGTCCTTTAAGTCTCACCGTTCAAGCCCGGAGCTCAACTCCGGTCCGCGGGGGATACTGAGGGACTAGGGACATGTAGGGGCAAGCGGAATTCCGGG	0.0
TACAGAGGTCTCAAGCGTTGTTCGGATTCATTGGGCGTAAAGGGTGCGTAGGCGGCGAGGCAAGTCTGGTGTGAAATCCCGGGGCTCAACCCCGGAACTGCACTGGATACTGCTTTGCTAGAGTACTGGAGAGGGAACTGGAATTTACGG	TACAGAGGTCTCAAGCGTTGTTCGGATTCATTGGGCGTAAAGGGTGCGTAGGCGGCGAGGCAAGTCTGGTGTGAAATCCCGGGGCTCAACCCCGGAACTGCACTGGATACTGCTTTGCTAGAGTACTGGAGAGGGAACTGGAATTTACGG	0.0
TACAGGGGGGGCAAGCGTTGTCCGGAATTACTGGGCGTACAGCGCGCGCAGGCGGTCCACTACGTGCCGTGTGACAGACGTCGGCTTAACCGACGTAGGCCAGGGTACACGGGTGAACTTGAGGCAGAGAGAGGGATGTGGAATACCCGG	TACAGGGGGGGCAAGCGTTGTCCGGAATTACTGGGCGTACAGCGCGCGCAGGCGGTCCACTACGTGCCGTGTGACAGACGTCGGCTTAACCGACGTAGGCCAGGGTACACGGGTGAACTTGAGGCAGAGAGAGGGATGTGGAATACCCGG	0.0
TACCAGCACCCCGAGTGGTCGGGACGATTATTGGGCCTAAAGCATCCGTAGCCGGTACTGCAAGTCTTCCGTTAAATCCACCTGCTTAACAGTTGGGCTGCGGGGGATACTACAGCGCTAGGAGGCGGGAGAGGCAAGCGGTACTCAATG	TACCAGCACCCCGAGTGGTCGGGACGATTATTGGGCCTAAAGCATCCGTAGCCGGTACTGCAAGTCTTCCGTTAAATCCACCTGCTTAACAGTTGGGCTGCGGGGGATACTACAGCGCTAGGAGGCGGGAGAGGCAAGCGGTACTCAATG	0.0
TACCAGCACCCCGAGTGGTCGGGACGATTATTGGGCCTAAAGCATCCGTAGCCGGTTCTACAAGTCTTCCGTTAAATCCATCTGCTTAACAGATGGGCTGCGGAGGATACTATGGAGCTAGGAGGCGGGAGAGGCAAGCGGTACTTAGTG	TACCAGCACCCCGAGTGGTCGGGACGATTATTGGGCCTAAAGCATCCGTAGCCGGTTCTACAAGTCTTCCGTTAAATCCATCTGCTTAACAGATGGGCTGCGGAGGATACTATGGAGCTAGGAGGCGGGAGAGGCAAGCGGTACTTAGTG	0.0
TACCAGCACCCCGAGTGGTCGGGACGTTTATTGGGCCTAAAGCATCCGTAGCCGGTTCCACAAGTCTTCCGTTAAATCCACCTGCTCAACAGATGGGCTGCGGAAGATACTATGGAGCTAGGAGGCGGGAGAGGCAAGCGGTACTCGATG	TACCAGCACCCCGAGTGGTCGGGACGTTTATTGGGCCTAAAGCATCCGTAGCCGGTTCCACAAGTCTTCCGTTAAATCCACCTGCTCAACAGATGGGCTGCGGAAGATACTATGGAGCTAGGAGGCGGGAGAGGCAAGCGGTACTCGATG	0.0
TACCAGCACCCCGAGTGGTCGGGACGTTTATTGGGCCTAAAGCATCCGTAGCCGGTTCCACAAGTCTTCCGTTAAATCCACCTGCTTAACAGATGGGCTGCGGAAGATACTATGGAGCTAGGAGGCGGGAGAGGCAAGCGGTACTCGATG	TACCAGCACCCCGAGTGGTCGGGACGTTTATTGGGCCTAAAGCATCCGTAGCCGGTTCCACAAGTCTTCCGTTAAATCCACCTGCTTAACAGATGGGCTGCGGAAGATACTATGGAGCTAGGAGGCGGGAGAGGCAAGCGGTACTCGATG	0.0
TACCAGCACCCCGAGTGGTCGGGACGTTTATTGGGCCTAAAGCATCCGTAGCCGGTTCTACAAGTCTTCCGTTAAATCCACCTGCTCAACAGATGGGCTGCGGAAGATACTATGGAGCTAGGAGGCGGGAGAGGCAAGCGGTACTCGATG	TACCAGCACCCCGAGTGGTCGGGACGTTTATTGGGCCTAAAGCATCCGTAGCCGGTTCTACAAGTCTTCCGTTAAATCCACCTGCTCAACAGATGGGCTGCGGAAGATACTATGGAGCTAGGAGGCGGGAGAGGCAAGCGGTACTCGATG	0.0
TACCAGCACCCCGAGTTGTCGGGACGATTATTGGGCCTAAAGCATCCGTAGCCTGTTCTGCAAGTCCTCCGTTAAATCCACCTGCTCAACGGATGGGCTGCGGAGGATACCGCAGAGCTAGGAGGCGGGAGAGGCAAACGGTACTCAGTG	TACCAGCACCCCGAGTTGTCGGGACGATTATTGGGCCTAAAGCATCCGTAGCCTGTTCTGCAAGTCCTCCGTTAAATCCACCTGCTCAACGGATGGGCTGCGGAGGATACCGCAGAGCTAGGAGGCGGGAGAGGCAAACGGTACTCAGTG	0.0
TACGAAGGGGGCGAGCGTTGTTCGGATTTACTGGGCGTAAAGGGCGCGCAGGCGGCTTATTTTGTCAGGCGTGAAAGCCCCGGGCTTAACCTGGGAACTGCGTTTGATACGGATGGGCTAGAGTTCGGGAGAGGAGAGTGGAATTCCCAG	TACGAAGGGGGCGAGCGTTGTTCGGATTTACTGGGCGTAAAGGGCGCGCAGGCGGCTTATTTTGTCAGGCGTGAAAGCCCCGGGCTTAACCTGGGAACTGCGTTTGATACGGATGGGCTAGAGTTCGGGAGAGGAGAGTGGAATTCCCAG	0.0
TACGAAGGGGGCTAGCGTTACTCGGAATTACTGGGCGTAAAGGGCGCGTAGGCGGCTCTGTTAGTCAGGCGTGAAATTCCCGGGCTTAACCTGGGGACTGCGCTTGATACTGCGGGGCTTGAGGATGGAAGAGGGTCGTGGAATTCCCAG	TACGAAGGGGGCTAGCGTTACTCGGAATTACTGGGCGTAAAGGGCGCGTAGGCGGCTCTGTTAGTCAGGCGTGAAATTCCCGGGCTTAACCTGGGGACTGCGCTTGATACTGCGGGGCTTGAGGATGGAAGAGGGTCGTGGAATTCCCAG	0.0
TACGAAGGGGGCTAGCGTTACTCGGAATTACTGGGCGTAAAGGGCGCGTAGGCGGCTTGGTAAGTCAGGCGTGAAATTCCCGGGCTCAACCTGGGGACTGCGCTTGAGACTGCTGGGCTAGAGGATGGAAGAGGGTCGTGGAATTCCCAG	TACGAAGGGGGCTAGCGTTACTCGGAATTACTGGGCGTAAAGGGCGCGTAGGCGGCTTGGTAAGTCAGGCGTGAAATTCCCGGGCTCAACCTGGGGACTGCGCTTGAGACTGCTGGGCTAGAGGATGGAAGAGGGTCGTGGAATTCCCAG	0.0
TACGAAGGGGGCTAGCGTTGCTCGGAATCACTGGGCGTAAAGCGCGCGTAGGCGGATCTTTAAGTCAGGGGTGAAATCCCGGGGCTCAACCCCGGAACTGCCTTTGATACTGGGGATCTTGAGTTCGAGAGAGGTTGGTGGAACTGCGAG	TACGAAGGGGGCTAGCGTTGCTCGGAATCACTGGGCGTAAAGCGCGCGTAGGCGGATCTTTAAGTCAGGGGTGAAATCCCGGGGCTCAACCCCGGAACTGCCTTTGATACTGGGGATCTTGAGTTCGAGAGAGGTTGGTGGAACTGCGAG	0.0
TACGAAGGGGGCTAGCGTTGCTCGGAATCACTGGGCGTAAAGGGCGCGTAGGCGGACATTTAAGTCAGGGGTGAAAGCCCAGAGCTCAACTCTGGAATTGCCTTTGATACTGGGTGTCTCGAGTCTGGTAGAGGTTGGTGGAACTGCGAG	TACGAAGGGGGCTAGCGTTGCTCGGAATCACTGGGCGTAAAGGGCGCGTAGGCGGACATTTAAGTCAGGGGTGAAAGCCCAGAGCTCAACTCTGGAATTGCCTTTGATACTGGGTGTCTCGAGTCTGGTAGAGGTTGGTGGAACTGCGAG	0.0
TACGAAGGGGGCTAGCGTTGCTCGGAATCACTGGGCGTAAAGGGCGCGTAGGCGGACCTTTAAGTCAGGGGTGAAAGCCTGTGGCTCAACCACAGAATTGCCTTTGATACTGAGGGTCTCGAGACCGGAAGAGGTTGGTGGAACTGCGAG	TACGAAGGGGGCTAGCGTTGCTCGGAATCACTGGGCGTAAAGGGCGCGTAGGCGGACCTTTAAGTCAGGGGTGAAAGCCTGTGGCTCAACCACAGAATTGCCTTTGATACTGAGGGTCTCGAGACCGGAAGAGGTTGGTGGAACTGCGAG	0.0
TACGAAGGGGGCTAGCGTTGCTCGGAATCACTGGGCGTAAAGGGCGCGTAGGCGGATCCTTAAGTCAGGGGTGAAAGCCCGAGGCTCAACCTCGGAATGGCCTTTGATACTGGGGATCTGGAGACCGGAAGAGGTGAGTGGAACTGCGAG	TACGAAGGGGGCTAGCGTTGCTCGGAATCACTGGGCGTAAAGGGCGCGTAGGCGGATCCTTAAGTCAGGGGTGAAAGCCCGAGGCTCAACCTCGGAATGGCCTTTGATACTGGGGATCTGGAGACCGGAAGAGGTGAGTGGAACTGCGAG	0.0
TACGAAGGGGGCTAGCGTTGCTCGGAATCACTGGGCGTAAAGGGCGCGTAGGCGGATTGTTAAGTCAGAGGTGAAAGCCCAGGGCTCAACCCTGGAATTGCCTTTGATACTGGCAATCTTGAGACCGGAAGAGGTTAGTGGAACTGCGAG	TACGAAGGGGGCTAGCGTTGCTCGGAATCACTGGGCGTAAAGGGCGCGTAGGCGGATTGTTAAGTCAGAGGTGAAAGCCCAGGGCTCAACCCTGGAATTGCCTTTGATACTGGCAATCTTGAGACCGGAAGAGGTTAGTGGAACTGCGAG	0.0
TACGAAGGGGGCTAGCGTTGCTCGGAATCACTGGGCGTAAAGGGCGCGTAGGCGGCCATTCAAGTCAGAGGTGAAAGCCCAAGGCTCAACCTTGGAATTGCCTTTGATACTGTTTGGCTTGAGACCGGAAGAGGTTAGTGGAACTGCGAG	TACGAAGGGGGCTAGCGTTGCTCGGAATCACTGGGCGTAAAGGGCGCGTAGGCGGCCATTCAAGTCAGAGGTGAAAGCCCAAGGCTCAACCTTGGAATTGCCTTTGATACTGTTTGGCTTGAGACCGGAAGAGGTTAGTGGAACTGCGAG	0.0
TACGAAGGGGGCTAGCGTTGCTCGGAATCACTGGGCGTAAAGGGCGCGTAGGCGGCCATTCAAGTCAGGGGTGAAAGCCTGTGGCTCAACCACAGAATTGCCTTTGATACTGTTTGGCTAGAGACCGGAAGAGGTAAGTGGAACTGCGAG	TACGAAGGGGGCTAGCGTTGCTCGGAATCACTGGGCGTAAAGGGCGCGTAGGCGGCCATTCAAGTCAGGGGTGAAAGCCTGTGGCTCAACCACAGAATTGCCTTTGATACTGTTTGGCTAGAGACCGGAAGAGGTAAGTGGAACTGCGAG	0.0
TACGAAGGGGGCTAGCGTTGCTCGGAATCACTGGGCGTAAAGGGCGCGTAGGCGGCCCGGCAAGTCAGGCGTGAAATCCCCGGGCTCAACCCGGGGGCTGCGCTTGAGACTGCGGGGCTCGAGGGCGGGAGAGGCTCGCGGAATTCCCAG	TACGAAGGGGGCTAGCGTTGCTCGGAATCACTGGGCGTAAAGGGCGCGTAGGCGGCCCGGCAAGTCAGGCGTGAAATCCCCGGGCTCAACCCGGGGGCTGCGCTTGAGACTGCGGGGCTCGAGGGCGGGAGAGGCTCGCGGAATTCCCAG	0.0
TACGAAGGGGGCTAGCGTTGCTCGGAATCACTGGGCGTAAAGGGCGCGTAGGCGGCCGATCAAGTCAGAGGTGAAAGCCCAAGGCTCAACCTTGGAATTGCCTTTGATACTGTTCGGCTCGAGACCGGAAGAGGTAAGTGGAACTGCGAG	TACGAAGGGGGCTAGCGTTGCTCGGAATCACTGGGCGTAAAGGGCGCGTAGGCGGCCGATCAAGTCAGAGGTGAAAGCCCAAGGCTCAACCTTGGAATTGCCTTTGATACTGTTCGGCTCGAGACCGGAAGAGGTAAGTGGAACTGCGAG	0.0
TACGAAGGGGGCTAGCGTTGCTCGGAATCACTGGGCGTAAAGGGCGCGTAGGCGGCCGATCAAGTCAGAGGTGAAAGCCCAAGGCTCAACCTTGGAATTGCCTTTGATACTGTTCGGCTCGAGACCGGAAGAGGTTAGTGGAACTGCGAG	TACGAAGGGGGCTAGCGTTGCTCGGAATCACTGGGCGTAAAGGGCGCGTAGGCGGCCGATCAAGTCAGAGGTGAAAGCCCAAGGCTCAACCTTGGAATTGCCTTTGATACTGTTCGGCTCGAGACCGGAAGAGGTTAGTGGAACTGCGAG	0.0
TACGAAGGGGGCTAGCGTTGCTCGGAATCACTGGGCGTAAAGGGCGCGTAGGCGGCCGATCAAGTCAGGGGTGAAAGCCTGTGGCTCAACCACAGAATTGCCTTTGATACTGTTCGGCTCGAGACCGGAAGAGGTTGGTGGAACTGCGAG	TACGAAGGGGGCTAGCGTTGCTCGGAATCACTGGGCGTAAAGGGCGCGTAGGCGGCCGATCAAGTCAGGGGTGAAAGCCTGTGGCTCAACCACAGAATTGCCTTTGATACTGTTCGGCTCGAGACCGGAAGAGGTTGGTGGAACTGCGAG	0.0
TACGAAGGGGGCTAGCGTTGCTCGGAATCACTGGGCGTAAAGGGCGCGTAGGCGGCCGATCAAGTCAGGGGTGAAAGCCTGTGGCTCAACCACAGAATTGCCTTTGATACTGTTTGGCTCGAGACCGGAAGAGGTTGGTGGAACTGCGAG	TACGAAGGGGGCTAGCGTTGCTCGGAATCACTGGGCGTAAAGGGCGCGTAGGCGGCCGATCAAGTCAGGGGTGAAAGCCTGTGGCTCAACCACAGAATTGCCTTTGATACTGTTTGGCTCGAGACCGGAAGAGGTTGGTGGAACTGCGAG	0.0
TACGAAGGGGGCTAGCGTTGCTCGGAATCACTGGGCGTAAAGGGCGCGTAGGCGGCCGTTCAAGTCGGGGGTGAAAGCCTGTGGCTCAACCACAGAATTGCCTTCGATACTGTACGGCTCGAGACCGGAAGAGGTGAGTGGAACTGCGAG	TACGAAGGGGGCTAGCGTTGCTCGGAATCACTGGGCGTAAAGGGCGCGTAGGCGGCCGTTCAAGTCGGGGGTGAAAGCCTGTGGCTCAACCACAGAATTGCCTTCGATACTGTACGGCTCGAGACCGGAAGAGGTGAGTGGAACTGCGAG	0.0
TACGAAGGGGGCTAGCGTTGCTCGGAATCACTGGGCGTAAAGGGCGCGTAGGCGGCGGACTTAGTCGGGCGTGAAATCCCCGGGCTCAACCCGGGGGCTGCGCCCGATACGGGTCTGCTGGAGGACGGGAGAGGCTCGCGGAATTCCCAG	TACGAAGGGGGCTAGCGTTGCTCGGAATCACTGGGCGTAAAGGGCGCGTAGGCGGCGGACTTAGTCGGGCGTGAAATCCCCGGGCTCAACCCGGGGGCTGCGCCCGATACGGGTCTGCTGGAGGACGGGAGAGGCTCGCGGAATTCCCAG	0.0
TACGAAGGGGGCTAGCGTTGCTCGGAATCACTGGGCGTAAAGGGCGCGTAGGCGGCTCTGTTAGTCAGGCGTGAAATTCCTGGGCTCAACCTGGGGACTGCGCTTGATACGGCGGGGCTTGAGGATGGAAGAGGGTCGTGGAATTCCCAG	TACGAAGGGGGCTAGCGTTGCTCGGAATCACTGGGCGTAAAGGGCGCGTAGGCGGCTCTGTTAGTCAGGCGTGAAATTCCTGGGCTCAACCTGGGGACTGCGCTTGATACGGCGGGGCTTGAGGATGGAAGAGGGTCGTGGAATTCCCAG	0.0
TACGAAGGGGGCTAGCGTTGCTCGGAATCATTGGGCGTAAAGGGCGCGTAGGCGGCCAGATTTGTCAGGCGTGAAAATCCTGGGCTCAACCCAGGGACTGCGTTTGAAACGGTCTGGCTAGAGGACGGAAGAGGCTCGTGGAACTCCCAG	TACGAAGGGGGCTAGCGTTGCTCGGAATCATTGGGCGTAAAGGGCGCGTAGGCGGCCAGATTTGTCAGGCGTGAAAATCCTGGGCTCAACCCAGGGACTGCGTTTGAAACGGTCTGGCTAGAGGACGGAAGAGGCTCGTGGAACTCCCAG	0.0
TACGAAGGGGGCTAGCGTTGCTCGGAATCATTGGGCGTAAAGGGCGCGTAGGCGGCCCCGTTAGTCAGGCGTGAAACCCCCGGGCTCAACCCGGGGACTGCGCTTGATACGGCGGGGCTTGAGGATGGAAGAGGGTCGCGGAATTCCCAG	TACGAAGGGGGCTAGCGTTGCTCGGAATCATTGGGCGTAAAGGGCGCGTAGGCGGCCCCGTTAGTCAGGCGTGAAACCCCCGGGCTCAACCCGGGGACTGCGCTTGATACGGCGGGGCTTGAGGATGGAAGAGGGTCGCGGAATTCCCAG	0.0
TACGAAGGGGGCTAGCGTTGCTCGGAATCATTGGGCGTAAAGGGCGCGTAGGCGGCCCCGTTGGTCAGGCGTGAAACCCCCGGGCTCAACCCGGGGACTGCGCTTGATACGGCGGGGCTCGAGGACGGGAGAGGCTCGCGGAATTCCCAG	TACGAAGGGGGCTAGCGTTGCTCGGAATCATTGGGCGTAAAGGGCGCGTAGGCGGCCCCGTTGGTCAGGCGTGAAACCCCCGGGCTCAACCCGGGGACTGCGCTTGATACGGCGGGGCTCGAGGACGGGAGAGGCTCGCGGAATTCCCAG	0.0
TACGAAGGGGGCTAGCGTTGCTCGGAATCATTGGGCGTAAAGGGCGCGTAGGCGGCCTCGTTAGTCAGGCGTGAAACCCCCGGGCTCAACCCGGGGACTGCGCTTGATACGGCGGGGCTTGAGGATGGAAGAGGGTCGCGGAATTCCCAG	TACGAAGGGGGCTAGCGTTGCTCGGAATCATTGGGCGTAAAGGGCGCGTAGGCGGCCTCGTTAGTCAGGCGTGAAACCCCCGGGCTCAACCCGGGGACTGCGCTTGATACGGCGGGGCTTGAGGATGGAAGAGGGTCGCGGAATTCCCAG	0.0
TACGAAGGGGGCTAGCGTTGCTCGGAATCATTGGGCGTAAAGGGCGCGTAGGCGGCGCAGCTAGTCAGGCGTGAAACCCCCGGGCTCAACCCGGGGACTGCGTTTGATACGGCTGTGCTAGAGGATGGAAGAGGGCCGCGGAATTCCCAG	TACGAAGGGGGCTAGCGTTGCTCGGAATCATTGGGCGTAAAGGGCGCGTAGGCGGCGCAGCTAGTCAGGCGTGAAACCCCCGGGCTCAACCCGGGGACTGCGTTTGATACGGCTGTGCTAGAGGATGGAAGAGGGCCGCGGAATTCCCAG	0.0
TACGAAGGGGGCTAGCGTTGCTCGGAATCATTGGGCGTAAAGGGCGCGTAGGCGGCGCAGTTAGTCAGGCGTGAAATCCCCGGGCTCAACCCAGGGACTGCGCTTGATACGGCTGTGCTCGAGGATGGAAGAGGGCCGCGGAATTCCCAG	TACGAAGGGGGCTAGCGTTGCTCGGAATCATTGGGCGTAAAGGGCGCGTAGGCGGCGCAGTTAGTCAGGCGTGAAATCCCCGGGCTCAACCCAGGGACTGCGCTTGATACGGCTGTGCTCGAGGATGGAAGAGGGCCGCGGAATTCCCAG	0.0
TACGAAGGGGGCTAGCGTTGCTCGGAATCATTGGGCGTAAAGGGCGCGTAGGCGGCGCTGTTAGTCAGGCGTGAAACCCCTGGGCTCAACCCAGGAACTGCGCTTGATACGGCAGGGCTCGAGGATGGAAGAGGGCCGCGGAATTCCCAG	TACGAAGGGGGCTAGCGTTGCTCGGAATCATTGGGCGTAAAGGGCGCGTAGGCGGCGCTGTTAGTCAGGCGTGAAACCCCTGGGCTCAACCCAGGAACTGCGCTTGATACGGCAGGGCTCGAGGATGGAAGAGGGCCGCGGAATTCCCAG	0.0
TACGAAGGGGGCTAGCGTTGCTCGGAATCATTGGGCGTAAAGGGCGCGTAGGCGGCGCTGTTAGTCAGGCGTGAAACCCCTGGGCTCAACCCAGGAACTGCGCTTGATACGGCAGGGCTTGAGGATGGAAGAGGGCCGCGGAATTCCCAG	TACGAAGGGGGCTAGCGTTGCTCGGAATCATTGGGCGTAAAGGGCGCGTAGGCGGCGCTGTTAGTCAGGCGTGAAACCCCTGGGCTCAACCCAGGAACTGCGCTTGATACGGCAGGGCTTGAGGATGGAAGAGGGCCGCGGAATTCCCAG	0.0
TACGAAGGGGGCTAGCGTTGCTCGGAATTACTGGGCGTAAAGGGCGCGTAGGCGGACAGTTTAGTCAGAGGTGAAAGCCCAGGGCTCAACCTTGGAATTGCCTTTGATACTGGCTGTCTTGAGTTCGGGAGAGGTGAGTGGAATGCCGAG	TACGAAGGGGGCTAGCGTTGCTCGGAATTACTGGGCGTAAAGGGCGCGTAGGCGGACAGTTTAGTCAGAGGTGAAAGCCCAGGGCTCAACCTTGGAATTGCCTTTGATACTGGCTGTCTTGAGTTCGGGAGAGGTGAGTGGAATGCCGAG	0.0
TACGAAGGGGGCTAGCGTTGCTCGGAATTACTGGGCGTAAAGGGCGCGTAGGCGGCACGATTAGTCAGGCGTGAAATTCCTGGGCTCAACCTGGGGACTGCGCTTGATACGGTCGAGCTAGAGGATGGAAGAGGGTCGCGGAATTCCCAG	TACGAAGGGGGCTAGCGTTGCTCGGAATTACTGGGCGTAAAGGGCGCGTAGGCGGCACGATTAGTCAGGCGTGAAATTCCTGGGCTCAACCTGGGGACTGCGCTTGATACGGTCGAGCTAGAGGATGGAAGAGGGTCGCGGAATTCCCAG	0.0
TACGAAGGGGGCTAGCGTTGCTCGGAATTACTGGGCGTAAAGGGCGCGTAGGCGGCACTGTTAGTCAGGCGTGAAAGTCCTGGGCTCAACCTGGGAACTGCGCTTGATACGGCAGAGCTAGAGGATGGAAGAGGCTCGCGGAATTCCCAG	TACGAAGGGGGCTAGCGTTGCTCGGAATTACTGGGCGTAAAGGGCGCGTAGGCGGCACTGTTAGTCAGGCGTGAAAGTCCTGGGCTCAACCTGGGAACTGCGCTTGATACGGCAGAGCTAGAGGATGGAAGAGGCTCGCGGAATTCCCAG	0.0
TACGAAGGGGGCTAGCGTTGCTCGGAATTACTGGGCGTAAAGGGCGCGTAGGCGGCACTGTTAGTCAGGCGTGAAATTCCTGGGCTCAACCTGGGGACTGCGCTTGATACGGCAGAGCTAGAGGATGGAAGAGGCTCGCGGAATTCCCAG	TACGAAGGGGGCTAGCGTTGCTCGGAATTACTGGGCGTAAAGGGCGCGTAGGCGGCACTGTTAGTCAGGCGTGAAATTCCTGGGCTCAACCTGGGGACTGCGCTTGATACGGCAGAGCTAGAGGATGGAAGAGGCTCGCGGAATTCCCAG	0.0
TACGAAGGGGGCTAGCGTTGCTCGGAATTACTGGGCGTAAAGGGCGCGTAGGCGGCCAGATTAGTCAGGCGTGAAATTCCTGGGCTCAACCTGGGGACTGCGCTTGATACGGTTTGGCTTGAGGGCAGGAGAGGCTCGCGGAATTCCCAG	TACGAAGGGGGCTAGCGTTGCTCGGAATTACTGGGCGTAAAGGGCGCGTAGGCGGCCAGATTAGTCAGGCGTGAAATTCCTGGGCTCAACCTGGGGACTGCGCTTGATACGGTTTGGCTTGAGGGCAGGAGAGGCTCGCGGAATTCCCAG	0.0
TACGAAGGGGGCTAGCGTTGCTCGGAATTACTGGGCGTAAAGGGCGCGTAGGCGGCCTGGTGAGTGAGGCGTGAAATTCCCGGGCTTAACCTGGGGACTGCGCTTCATACTGCTGGGCTTGAGGATGGAAGAGGGTCGTGGAATTCCCAG	TACGAAGGGGGCTAGCGTTGCTCGGAATTACTGGGCGTAAAGGGCGCGTAGGCGGCCTGGTGAGTGAGGCGTGAAATTCCCGGGCTTAACCTGGGGACTGCGCTTCATACTGCTGGGCTTGAGGATGGAAGAGGGTCGTGGAATTCCCAG	0.0
TACGAAGGGGGCTAGCGTTGCTCGGAATTACTGGGCGTAAAGGGCGCGTAGGCGGCGCAGTTAGTCAGGCGTGAAATTCCTGGGCTTAACCTGGGGACTGCGCTTGATACGGCTGTGCTAGAGGGTGGAAGAGGCTCGCGGAATTCCCAG	TACGAAGGGGGCTAGCGTTGCTCGGAATTACTGGGCGTAAAGGGCGCGTAGGCGGCGCAGTTAGTCAGGCGTGAAATTCCTGGGCTTAACCTGGGGACTGCGCTTGATACGGCTGTGCTAGAGGGTGGAAGAGGCTCGCGGAATTCCCAG	0.0
TACGAAGGGGGCTAGCGTTGCTCGGAATTACTGGGCGTAAAGGGCGCGTAGGCGGCGCTGCAAGTCAGGCGTGAAATTCCTGGGCTTAACCTGGGGGCTGCGCTTGAGACTGTGGTGCTAGAGGATGGAAGAGGGTCGTGGAATTCCCAG	TACGAAGGGGGCTAGCGTTGCTCGGAATTACTGGGCGTAAAGGGCGCGTAGGCGGCGCTGCAAGTCAGGCGTGAAATTCCTGGGCTTAACCTGGGGGCTGCGCTTGAGACTGTGGTGCTAGAGGATGGAAGAGGGTCGTGGAATTCCCAG	0.0
TACGAAGGGGGCTAGCGTTGCTCGGAATTACTGGGCGTAAAGGGCGCGTAGGCGGCGCTGTTAGTCAGGCGTGAAATTCCTGGGCTCAACCTGGGGACTGCGCTTGATACGGCAGTGCTAGAGGATGGAAGAGGCTCGCGGAATTCCCAG	TACGAAGGGGGCTAGCGTTGCTCGGAATTACTGGGCGTAAAGGGCGCGTAGGCGGCGCTGTTAGTCAGGCGTGAAATTCCTGGGCTCAACCTGGGGACTGCGCTTGATACGGCAGTGCTAGAGGATGGAAGAGGCTCGCGGAATTCCCAG	0.0
TACGAAGGGGGCTAGCGTTGCTCGGAATTACTGGGCGTAAAGGGCGCGTAGGCGGCGGACATAGTCAGGCGTGAAATTCCTGGGCTTAACCTGGGGGCTGCGCTTGATACGTGTTTGCTAGAGGATGGAAGAGGGTCGTGGAATTCCCAG	TACGAAGGGGGCTAGCGTTGCTCGGAATTACTGGGCGTAAAGGGCGCGTAGGCGGCGGACATAGTCAGGCGTGAAATTCCTGGGCTTAACCTGGGGGCTGCGCTTGATACGTGTTTGCTAGAGGATGGAAGAGGGTCGTGGAATTCCCAG	0.0
TACGAAGGGGGCTAGCGTTGCTCGGAATTACTGGGCGTAAAGGGCGCGTAGGCGGCGGTGTTAGTCAGGCGTGAAATTCCTGGGCTCAACCTGGGGACTGCGCTTGATACGGCATTGCTAGAGGATGGAAGAGGGTCGCGGAATTCCCAG	TACGAAGGGGGCTAGCGTTGCTCGGAATTACTGGGCGTAAAGGGCGCGTAGGCGGCGGTGTTAGTCAGGCGTGAAATTCCTGGGCTCAACCTGGGGACTGCGCTTGATACGGCATTGCTAGAGGATGGAAGAGGGTCGCGGAATTCCCAG	0.0
TACGAAGGGGGCTAGCGTTGCTCGGAATTACTGGGCGTAAAGGGCGCGTAGGCGGCTCGCTTAGTCAGGCGTGAAATTCCTGGGCTCAACCTGGGGACTGCGCTTGAGACGGGTGGGCTAGAGGACGGAAGAGGCTCGCGGAATTCCCAG	TACGAAGGGGGCTAGCGTTGCTCGGAATTACTGGGCGTAAAGGGCGCGTAGGCGGCTCGCTTAGTCAGGCGTGAAATTCCTGGGCTCAACCTGGGGACTGCGCTTGAGACGGGTGGGCTAGAGGACGGAAGAGGCTCGCGGAATTCCCAG	0.0
TACGAAGGGGGCTAGCGTTGCTCGGAATTACTGGGCGTAAAGGGCGCGTAGGCGGCTCTGTTAGTCAGGCGTGAAAGCCCTGGGCTCAACCTGGGGACTGCGCTTGATACGGCAGGGCTTGAGGGCAGAAGAGGCTCGCGGAATTCCCAG	TACGAAGGGGGCTAGCGTTGCTCGGAATTACTGGGCGTAAAGGGCGCGTAGGCGGCTCTGTTAGTCAGGCGTGAAAGCCCTGGGCTCAACCTGGGGACTGCGCTTGATACGGCAGGGCTTGAGGGCAGAAGAGGCTCGCGGAATTCCCAG	0.0
TACGAAGGGGGCTAGCGTTGCTCGGAATTACTGGGCGTAAAGGGCGCGTAGGCGGCTTAGTTAGTCAGGCGTGAAAGCCCTGGGCTCAACCTGGGGACTGCGCTTGATACGGCTGGGCTAGAGGATGGAAGAGGGTCGCGGAATTCCCAG	TACGAAGGGGGCTAGCGTTGCTCGGAATTACTGGGCGTAAAGGGCGCGTAGGCGGCTTAGTTAGTCAGGCGTGAAAGCCCTGGGCTCAACCTGGGGACTGCGCTTGATACGGCTGGGCTAGAGGATGGAAGAGGGTCGCGGAATTCCCAG	0.0
TACGAAGGGGGCTAGCGTTGCTCGGAATTACTGGGCGTAAAGGGCGCGTAGGCGGTCATTTTAGTCAGGCGTGAAATTCCCGGGCTTAACCTGGGGACTGCGCTTGATACTGGGTGACTAGAGGGTGGAAGAGGGTCGTGGAATTCCCAG	TACGAAGGGGGCTAGCGTTGCTCGGAATTACTGGGCGTAAAGGGCGCGTAGGCGGTCATTTTAGTCAGGCGTGAAATTCCCGGGCTTAACCTGGGGACTGCGCTTGATACTGGGTGACTAGAGGGTGGAAGAGGGTCGTGGAATTCCCAG	0.0
TACGAAGGGGGCTAGCGTTGCTCGGAATTACTGGGCGTAAAGGGCGCGTAGGCGGTCATTTTAGTCAGGCGTGAAATTCCCGGGCTTAACCTGGGGACTGCGCTTGATACTGGGTGACTTGAGGGTGGAAGAGGGTCGTGGAATTCCCAG	TACGAAGGGGGCTAGCGTTGCTCGGAATTACTGGGCGTAAAGGGCGCGTAGGCGGTCATTTTAGTCAGGCGTGAAATTCCCGGGCTTAACCTGGGGACTGCGCTTGATACTGGGTGACTTGAGGGTGGAAGAGGGTCGTGGAATTCCCAG	0.0
TACGAAGGGGGCTAGCGTTGCTCGGAATTACTGGGCGTAAAGGGCGCGTAGGCGGTTCTGTTAGTCAGGCGTGAAATTCCTGGGCTCAACCTGGGGACTGCGCTTGATACGGCGGAACTTGAGGGCAGGAGAGGCTCGCGGAATTCCCAG	TACGAAGGGGGCTAGCGTTGCTCGGAATTACTGGGCGTAAAGGGCGCGTAGGCGGTTCTGTTAGTCAGGCGTGAAATTCCTGGGCTCAACCTGGGGACTGCGCTTGATACGGCGGAACTTGAGGGCAGGAGAGGCTCGCGGAATTCCCAG	0.0
TACGAAGGGGGCTAGCGTTGCTCGGATTTACTGGGCGTAAAGGGCGCGTAGGCGGACGACCAAGTTGGGGGTGAAAGCCCGGGGCTCAACCTCGGAATTGCCTTCAAAACTGGTCGTCTTGAGTATGAGAGAGGTGTGTGGAACTCCGAG	TACGAAGGGGGCTAGCGTTGCTCGGATTTACTGGGCGTAAAGGGCGCGTAGGCGGACGACCAAGTTGGGGGTGAAAGCCCGGGGCTCAACCTCGGAATTGCCTTCAAAACTGGTCGTCTTGAGTATGAGAGAGGTGTGTGGAACTCCGAG	0.0
TACGAAGGGGGCTAGCGTTGCTCGGATTTACTGGGCGTAAAGGGCGCGTAGGCGGATGACCAAGTTGGGGGTGAAAGCCCGGGGCTCAACCTCGGAATTGCCTTCAAAACTGGTTGTCTTGAGTATGGGAGAGGTGTGTGGAACTCCGAG	TACGAAGGGGGCTAGCGTTGCTCGGATTTACTGGGCGTAAAGGGCGCGTAGGCGGATGACCAAGTTGGGGGTGAAAGCCCGGGGCTCAACCTCGGAATTGCCTTCAAAACTGGTTGTCTTGAGTATGGGAGAGGTGTGTGGAACTCCGAG	0.0
TACGAAGGGGGCTAGCGTTGTTCGGAATCACTGGGCGTAAAGGGCGCGTAGGCGGCCCGTCAAGTCAGGCGTGAAAGCCCCGGGCTCAACCCGGGATGTGCGCTTGGGACTGGCGGGCTCGAGGCCGGGAGAGGGTGGCGGAATTCCCAG	TACGAAGGGGGCTAGCGTTGTTCGGAATCACTGGGCGTAAAGGGCGCGTAGGCGGCCCGTCAAGTCAGGCGTGAAAGCCCCGGGCTCAACCCGGGATGTGCGCTTGGGACTGGCGGGCTCGAGGCCGGGAGAGGGTGGCGGAATTCCCAG	0.0
TACGAAGGGGGCTAGCGTTGTTCGGAATCACTGGGCGTAAAGGGCGCGTAGGCGGCCGATCAAGTCGGGGGTGAAAGCCTGTGGCTCAACCACAGAATGGCCTTCGATACTGTTTGGCTTGAGACCGGAAGAGGTCAGTGGAACTGCGAG	TACGAAGGGGGCTAGCGTTGTTCGGAATCACTGGGCGTAAAGGGCGCGTAGGCGGCCGATCAAGTCGGGGGTGAAAGCCTGTGGCTCAACCACAGAATGGCCTTCGATACTGTTTGGCTTGAGACCGGAAGAGGTCAGTGGAACTGCGAG	0.0
TACGAAGGGGGCTAGCGTTGTTCGGAATCACTGGGCGTAAAGGGCGCGTAGGCGGCCTGATAAGTCGGGGGTGAAAGCCTGTGGCTCAACCACAGAATTGCCTTCGATACTGTCGGGCTTGAGACCGGAAGAGGTAAGTGGAACTGCGAG	TACGAAGGGGGCTAGCGTTGTTCGGAATCACTGGGCGTAAAGGGCGCGTAGGCGGCCTGATAAGTCGGGGGTGAAAGCCTGTGGCTCAACCACAGAATTGCCTTCGATACTGTCGGGCTTGAGACCGGAAGAGGTAAGTGGAACTGCGAG	0.0
TACGAAGGGGGCTAGCGTTGTTCGGAATCACTGGGCGTAAAGGGCGCGTAGGCGGCTGTTCAAGTCGGGGGTGAAAGCCTGTGGCTCAACCACAGAATGGCCTTCGATACTGGACGGCTCGAGACCGGAAGAGGTGAGTGGAACTGCGAG	TACGAAGGGGGCTAGCGTTGTTCGGAATCACTGGGCGTAAAGGGCGCGTAGGCGGCTGTTCAAGTCGGGGGTGAAAGCCTGTGGCTCAACCACAGAATGGCCTTCGATACTGGACGGCTCGAGACCGGAAGAGGTGAGTGGAACTGCGAG	0.0
TACGAAGGGGGCTAGCGTTGTTCGGAATCACTGGGCGTAAAGGGCGCGTAGGCGGCTTGATAAGTCGGGGGTGAAAGCCTGTGGCTCAACCACAGAATTGCCTTCGATACTGTCTGGCTTGAGACCGGAAGAGGTAAGTGGAACTGCGAG	TACGAAGGGGGCTAGCGTTGTTCGGAATCACTGGGCGTAAAGGGCGCGTAGGCGGCTTGATAAGTCGGGGGTGAAAGCCTGTGGCTCAACCACAGAATTGCCTTCGATACTGTCTGGCTTGAGACCGGAAGAGGTAAGTGGAACTGCGAG	0.0
TACGAAGGGGGCTAGCGTTGTTCGGAATCACTGGGCGTAAAGGGCGCGTAGGCGGCTTTATAAGTCGGGGGTGAAAGCCTGTGGCTCAACCACAGAATTGCCTTCGATACTGTATGGCTTGAGACCGGAAGAGGTAAGTGGAACTGCGAG	TACGAAGGGGGCTAGCGTTGTTCGGAATCACTGGGCGTAAAGGGCGCGTAGGCGGCTTTATAAGTCGGGGGTGAAAGCCTGTGGCTCAACCACAGAATTGCCTTCGATACTGTATGGCTTGAGACCGGAAGAGGTAAGTGGAACTGCGAG	0.0
TACGAAGGGGGCTAGCGTTGTTCGGAATCACTGGGCGTAAAGGGCGCGTAGGCGGCTTTGTAAGTCGGGGGTGAAAGCCTGTGGCTCAACCACAGAATTGCCTTCGATACTGCATGGCTTGAGACCGGAAGAGGTAAGTGGAACTGCGAG	TACGAAGGGGGCTAGCGTTGTTCGGAATCACTGGGCGTAAAGGGCGCGTAGGCGGCTTTGTAAGTCGGGGGTGAAAGCCTGTGGCTCAACCACAGAATTGCCTTCGATACTGCATGGCTTGAGACCGGAAGAGGTAAGTGGAACTGCGAG	0.0
TACGAAGGGGGCTAGCGTTGTTCGGAATCACTGGGCGTAAAGGGCGCGTAGGCGGGTCTTTAAGTCGGGGGTGAAAGCCTGTGGCTCAACCACAGAATGGCCTTCGATACTGGGGACCTTGAGACCGGAAGAGGTAAGTGGAACTGCGAG	TACGAAGGGGGCTAGCGTTGTTCGGAATCACTGGGCGTAAAGGGCGCGTAGGCGGGTCTTTAAGTCGGGGGTGAAAGCCTGTGGCTCAACCACAGAATGGCCTTCGATACTGGGGACCTTGAGACCGGAAGAGGTAAGTGGAACTGCGAG	0.0
TACGAAGGGGGCTAGCGTTGTTCGGAATTACTGGGCGTAAAGCGCGCGTAGGCGGACATTTAAGTCAGGGGTGAAATCCCGAGGCTCAACCTCGGAACTGCCTTTGATACTGGGTGTCTGGAGTCCGGAAGAGGTTGGTGGAATTCCGAG	TACGAAGGGGGCTAGCGTTGTTCGGAATTACTGGGCGTAAAGCGCGCGTAGGCGGACATTTAAGTCAGGGGTGAAATCCCGAGGCTCAACCTCGGAACTGCCTTTGATACTGGGTGTCTGGAGTCCGGAAGAGGTTGGTGGAATTCCGAG	0.0
TACGAAGGGGGCTAGCGTTGTTCGGAATTACTGGGCGTAAAGCGCGCGTAGGCGGATATTTAAGTCAGGGGTGAAATCCCAGGGCTCAACCCTGGAACTGCCTTTGATACTGGATATCTGGAGTTCGGGAGAGGTGAGTGGAATTCCGAG	TACGAAGGGGGCTAGCGTTGTTCGGAATTACTGGGCGTAAAGCGCGCGTAGGCGGATATTTAAGTCAGGGGTGAAATCCCAGGGCTCAACCCTGGAACTGCCTTTGATACTGGATATCTGGAGTTCGGGAGAGGTGAGTGGAATTCCGAG	0.0
TACGAAGGGGGCTAGCGTTGTTCGGAATTACTGGGCGTAAAGCGCGCGTAGGCGGATATTTAAGTCAGGGGTGAAATCCCAGGGCTCAACCCTGGAACTGCCTTTGATACTGGGTATCTGGAGTTCGGGAGAGGTGAGTGGAATTCCGAG	TACGAAGGGGGCTAGCGTTGTTCGGAATTACTGGGCGTAAAGCGCGCGTAGGCGGATATTTAAGTCAGGGGTGAAATCCCAGGGCTCAACCCTGGAACTGCCTTTGATACTGGGTATCTGGAGTTCGGGAGAGGTGAGTGGAATTCCGAG	0.0
TACGAAGGGGGCTAGCGTTGTTCGGAATTACTGGGCGTAAAGCGCGCGTAGGCGGGCATTTAAGTCAGGGGTGAAATCCCAGGGCTCAACCCTGGAACTGCCTTTGATACTGGATGCCTGGAGTTCGGGAGAGGTGAGTGGAATTCCGAG	TACGAAGGGGGCTAGCGTTGTTCGGAATTACTGGGCGTAAAGCGCGCGTAGGCGGGCATTTAAGTCAGGGGTGAAATCCCAGGGCTCAACCCTGGAACTGCCTTTGATACTGGATGCCTGGAGTTCGGGAGAGGTGAGTGGAATTCCGAG	0.0
TACGAAGGGGGCTAGCGTTGTTCGGAATTACTGGGCGTAAAGGGCGCGTAGGCGGTATGTCAAGTCAGGCGTGAAAGCCCCGGGCTCAACCTGGGAACCGCGCTTGAGACTGGCACACTCGAGTTCGGGAGAGGATGGTGGAATTCCCAG	TACGAAGGGGGCTAGCGTTGTTCGGAATTACTGGGCGTAAAGGGCGCGTAGGCGGTATGTCAAGTCAGGCGTGAAAGCCCCGGGCTCAACCTGGGAACCGCGCTTGAGACTGGCACACTCGAGTTCGGGAGAGGATGGTGGAATTCCCAG	0.0
TACGAAGGGGGCTAGCGTTGTTCGGAATTACTGGGCGTAAAGGGCGCGTAGGCGGTCCCTCAAGTCAGGCGTGAAAGCCCCGGGCTCAACCTGGGAACCGCGCTTGAGACTGATGGGCTAGAGTTCGGGAGAGGATGGTGGAATTCCCAG	TACGAAGGGGGCTAGCGTTGTTCGGAATTACTGGGCGTAAAGGGCGCGTAGGCGGTCCCTCAAGTCAGGCGTGAAAGCCCCGGGCTCAACCTGGGAACCGCGCTTGAGACTGATGGGCTAGAGTTCGGGAGAGGATGGTGGAATTCCCAG	0.0
TACGAAGGGGGCTAGCGTTGTTCGGAATTACTGGGCGTAAAGGGCGCGTAGGCGGTGCATCAAGTCAGGCGTGAAAGCCCCGGGCTCAACCTGGGAACCGCGCTTGAGACTGGTGCGCTAGAGTTCGGGAGAGGATGGTGGAATTCCCAG	TACGAAGGGGGCTAGCGTTGTTCGGAATTACTGGGCGTAAAGGGCGCGTAGGCGGTGCATCAAGTCAGGCGTGAAAGCCCCGGGCTCAACCTGGGAACCGCGCTTGAGACTGGTGCGCTAGAGTTCGGGAGAGGATGGTGGAATTCCCAG	0.0
TACGAAGGGGGCTAGCGTTGTTCGGAATTACTGGGCGTAAAGGGCGCGTAGGCGGTGTGTCAAGTCAGGCGTGAAAGCCCCGGGCTCAACCTGGGAACCGCGCTTGAGACTGGCACGCTAGAGTTCGGGAGAGGATGGTGGAATTCCCAG	TACGAAGGGGGCTAGCGTTGTTCGGAATTACTGGGCGTAAAGGGCGCGTAGGCGGTGTGTCAAGTCAGGCGTGAAAGCCCCGGGCTCAACCTGGGAACCGCGCTTGAGACTGGCACGCTAGAGTTCGGGAGAGGATGGTGGAATTCCCAG	0.0
TACGAAGGGGGCTAGCGTTGTTCGGAATTACTGGGCGTAAAGGGCGCGTAGGCGGTGTGTCAAGTCAGGCGTGAAAGCCCCGGGCTCAACCTGGGAACCGCGCTTGAGACTGGCACGCTCGAGTTCGGGAGAGGATGGTGGAATTCCCAG	TACGAAGGGGGCTAGCGTTGTTCGGAATTACTGGGCGTAAAGGGCGCGTAGGCGGTGTGTCAAGTCAGGCGTGAAAGCCCCGGGCTCAACCTGGGAACCGCGCTTGAGACTGGCACGCTCGAGTTCGGGAGAGGATGGTGGAATTCCCAG	0.0
TACGAAGGGGGCTAGCGTTGTTCGGATTTACTGGGCGTAAAGCGCACGTAGGCGGATTGTTAAGTCAGGGGTGAAATCCTGGAGCTCAACTCCAGAACTGCCTTTGATACTGGCAATCTCGAGTCCGGAAGAGGTAAGTGGAACTCCTAG	TACGAAGGGGGCTAGCGTTGTTCGGATTTACTGGGCGTAAAGCGCACGTAGGCGGATTGTTAAGTCAGGGGTGAAATCCTGGAGCTCAACTCCAGAACTGCCTTTGATACTGGCAATCTCGAGTCCGGAAGAGGTAAGTGGAACTCCTAG	0.0
TACGAAGGGTGCAAGCGTTACTCGGAATTACTGGGCGTAAAGCGTGCGTAGGTGGTTTGTTAAGTCTGATGTGAAAGCCCTGGGCTCAACCTGGGAACTGCATTGGAAACTGGCTTACTAGAGTGCGGTAGAGGGGTGCGGAATTCCCGG	TACGAAGGGTGCAAGCGTTACTCGGAATTACTGGGCGTAAAGCGTGCGTAGGTGGTTTGTTAAGTCTGATGTGAAAGCCCTGGGCTCAACCTGGGAACTGCATTGGAAACTGGCTTACTAGAGTGCGGTAGAGGGGTGCGGAATTCCCGG	0.0
TACGAAGGGTGCAAGCGTTACTCGGAATTACTGGGCGTAAAGCGTGCGTAGGTGGTTTGTTAAGTCTGATGTGAAAGCCCTGGGCTCAACCTGGGAACTGCATTGGAAACTGGCTTACTAGAGTGCGGTAGAGGGTGGCGGAATTCCCGG	TACGAAGGGTGCAAGCGTTACTCGGAATTACTGGGCGTAAAGCGTGCGTAGGTGGTTTGTTAAGTCTGATGTGAAAGCCCTGGGCTCAACCTGGGAACTGCATTGGAAACTGGCTTACTAGAGTGCGGTAGAGGGTGGCGGAATTCCCGG	0.0
TACGAAGGTGGCAAGCGTTGTTCGGATTCACTGGGCGTACAGGGAGCGTAGGCGGTTGGGTAAGCCCTCCGTGAAATCTCCGGGCCTAACCCGGAAAGGGCAGAGGGGACTGCTTGGCTTGAGGACGGGAGAGGAGCGCGGAATTCCCGG	TACGAAGGTGGCAAGCGTTGTTCGGATTCACTGGGCGTACAGGGAGCGTAGGCGGTTGGGTAAGCCCTCCGTGAAATCTCCGGGCCTAACCCGGAAAGGGCAGAGGGGACTGCTTGGCTTGAGGACGGGAGAGGAGCGCGGAATTCCCGG	0.0
TACGAGGGGAGCAAGCGTTGTTCGGATTTACTGGGCGTAAAGGGTGCGTAGGCGGCACCACAAGTCACTTGTGAAATCTTTGGGCTTAACCCAAAGCGGTCAAGTGATACTGTGGAGCTAGAGTGCAGAAGGGGCAACTGGAATTCCCGG	TACGAGGGGAGCAAGCGTTGTTCGGATTTACTGGGCGTAAAGGGTGCGTAGGCGGCACCACAAGTCACTTGTGAAATCTTTGGGCTTAACCCAAAGCGGTCAAGTGATACTGTGGAGCTAGAGTGCAGAAGGGGCAACTGGAATTCCCGG	0.0
TACGGAGGATCCAAGCGTTATCCGGATTTATTGGGTTTAAAGGGTGCGTAGGCGGCTTATTAAGTCAGGGGTGAAAGACGGTGGCTCAACCATCGCAGTGCCTTTGATACTGATGAGCTTGAATGAACTTGAGGTAGGCGGAATGTGACA	TACGGAGGATCCAAGCGTTATCCGGATTTATTGGGTTTAAAGGGTGCGTAGGCGGCTTATTAAGTCAGGGGTGAAAGACGGTGGCTCAACCATCGCAGTGCCTTTGATACTGATGAGCTTGAATGAACTTGAGGTAGGCGGAATGTGACA	0.0
TACGGAGGATGCAAGCGTTATCCGGAATAATTGGGCGTAAAGCGTCCGTAGGTGGCTGTTCAAGTCTGCCGTTAAAGACCGGGGCTTAACCCTGGAAAGGCGGTGGAAACTGAACGGCTAGAGTGCAGTAGGGGTAGAGGGAATTCCCGG	TACGGAGGATGCAAGCGTTATCCGGAATAATTGGGCGTAAAGCGTCCGTAGGTGGCTGTTCAAGTCTGCCGTTAAAGACCGGGGCTTAACCCTGGAAAGGCGGTGGAAACTGAACGGCTAGAGTGCAGTAGGGGTAGAGGGAATTCCCGG	0.0
TACGGAGGATGCAAGCGTTATCCGGAATCATTGGGCGTAAAGCGTCCGCAGGTGGCTTTTCAAGTCTGCTGTCAAAGCCCGGGGCTCAACCCTGGAGAGGCAGTGGAAACTGAGGAGCTGGAGTGCGGTAGGGGCAGAGGGAATTCCCGG	TACGGAGGATGCAAGCGTTATCCGGAATCATTGGGCGTAAAGCGTCCGCAGGTGGCTTTTCAAGTCTGCTGTCAAAGCCCGGGGCTCAACCCTGGAGAGGCAGTGGAAACTGAGGAGCTGGAGTGCGGTAGGGGCAGAGGGAATTCCCGG	0.0
TACGGAGGATGCAAGCGTTATCCGGAATGATTGGGCGTAAAGAGTCCGTAGGTGGTTATTCAAGTCGATTGTTAAAGAGCGGGGCTTAACCCCGTAGAAGCAGTGGAAACTGAATAACTAGAGAGAGGTAGGGGTAGAGGGAATTCCCGG	TACGGAGGATGCAAGCGTTATCCGGAATGATTGGGCGTAAAGAGTCCGTAGGTGGTTATTCAAGTCGATTGTTAAAGAGCGGGGCTTAACCCCGTAGAAGCAGTGGAAACTGAATAACTAGAGAGAGGTAGGGGTAGAGGGAATTCCCGG	0.0
TACGGAGGATGCAAGCGTTATCCGGAATTATTGGGCGTAAAGCGTCCGCAGGTGGCACTTCAAGTCTGCTGTCAAAGGTCGGGGCTTAACCCCGGGAAGGCAGTGGAAACTGAAGCGCTAGAGTGTCGTAGGGGTAGAGGGAATTCCCGG	TACGGAGGATGCAAGCGTTATCCGGAATTATTGGGCGTAAAGCGTCCGCAGGTGGCACTTCAAGTCTGCTGTCAAAGGTCGGGGCTTAACCCCGGGAAGGCAGTGGAAACTGAAGCGCTAGAGTGTCGTAGGGGTAGAGGGAATTCCCGG	0.0
TACGGAGGATGCAAGCGTTATCCGGAATTATTGGGCGTAAAGCGTCCGCAGGTGGCAGTTCAAGTCTGCTGTCAAAGGTCAGGGCTCAACCCTGAACAGGCAGTGGAAACTGAACAGCTAGAGTGCGGTAGGGGCAGAGGGAATTCCCAG	TACGGAGGATGCAAGCGTTATCCGGAATTATTGGGCGTAAAGCGTCCGCAGGTGGCAGTTCAAGTCTGCTGTCAAAGGTCAGGGCTCAACCCTGAACAGGCAGTGGAAACTGAACAGCTAGAGTGCGGTAGGGGCAGAGGGAATTCCCAG	0.0
TACGGAGGGAGCTAGCGTTGTTCGGAATTACTGGGCGTAAAGCGCACGTAGGCGGCTACACAAGTCAGGGGTGAAAGCCCGGGGCTCAACCCCGGAACTGCCTTTGAAACTGGGTGGCTAGAATCTTGGAGAGGCGAGTGGAATTCCGAG	TACGGAGGGAGCTAGCGTTGTTCGGAATTACTGGGCGTAAAGCGCACGTAGGCGGCTACACAAGTCAGGGGTGAAAGCCCGGGGCTCAACCCCGGAACTGCCTTTGAAACTGGGTGGCTAGAATCTTGGAGAGGCGAGTGGAATTCCGAG	0.0
TACGGAGGGAGCTAGCGTTGTTCGGAATTACTGGGCGTAAAGCGCACGTAGGCGGCTATTCAAGTCAGAGGTGAAAGCCCGGGGCTCAACCCCGGAACTGCCTTTGAAACTAGGTAGCTAGAATCTTGGAGAGGTCAGTGGAATTCCGAG	TACGGAGGGAGCTAGCGTTGTTCGGAATTACTGGGCGTAAAGCGCACGTAGGCGGCTATTCAAGTCAGAGGTGAAAGCCCGGGGCTCAACCCCGGAACTGCCTTTGAAACTAGGTAGCTAGAATCTTGGAGAGGTCAGTGGAATTCCGAG	0.0
TACGGAGGGAGCTAGCGTTGTTCGGAATTACTGGGCGTAAAGCGCACGTAGGCGGCTTTGTAAGTTAGAGGTGAAAGCCCGGGGCTCAACTCCGGAACTGCCTTTAAGACTGCATCGCTTGAATCCAGGAGAGGTGAGTGGAATTCCGAG	TACGGAGGGAGCTAGCGTTGTTCGGAATTACTGGGCGTAAAGCGCACGTAGGCGGCTTTGTAAGTTAGAGGTGAAAGCCCGGGGCTCAACTCCGGAACTGCCTTTAAGACTGCATCGCTTGAATCCAGGAGAGGTGAGTGGAATTCCGAG	0.0
TACGGAGGGAGCTAGCGTTGTTCGGAATTACTGGGCGTAAAGCGCACGTAGGCGGCTTTGTAAGTTAGGGGTGAAAGCCCGGTGCTCAACACCGGAACTGCCTTTAAGACTGCATCGCTTGAATCCAGGAGAGGTGAGTGGAATTCCGAG	TACGGAGGGAGCTAGCGTTGTTCGGAATTACTGGGCGTAAAGCGCACGTAGGCGGCTTTGTAAGTTAGGGGTGAAAGCCCGGTGCTCAACACCGGAACTGCCTTTAAGACTGCATCGCTTGAATCCAGGAGAGGTGAGTGGAATTCCGAG	0.0
TACGGAGGGAGCTAGCGTTGTTCGGAATTACTGGGCGTAAAGCGCGCGTAGGCGGCTATTCAAGTCAGAGGTGAAAGCCCGGGGCTCAACCCTGGAACTGCCTTTGAAACTAGGTAGCTAGAATCTTGGAGAGGCGAGTGGAATTCCGAG	TACGGAGGGAGCTAGCGTTGTTCGGAATTACTGGGCGTAAAGCGCGCGTAGGCGGCTATTCAAGTCAGAGGTGAAAGCCCGGGGCTCAACCCTGGAACTGCCTTTGAAACTAGGTAGCTAGAATCTTGGAGAGGCGAGTGGAATTCCGAG	0.0
TACGGAGGGAGCTAGCGTTGTTCGGAATTACTGGGCGTAAAGCGCGCGTAGGCGGTCTGCCAAGTCAGGGGTGAAATCCCGGGGCTCAACCCCGGAACTGCCCTTGAAACTATCAGACTGGAATCTTGGAGAGGTCAGTGGAATTCCGAG	TACGGAGGGAGCTAGCGTTGTTCGGAATTACTGGGCGTAAAGCGCGCGTAGGCGGTCTGCCAAGTCAGGGGTGAAATCCCGGGGCTCAACCCCGGAACTGCCCTTGAAACTATCAGACTGGAATCTTGGAGAGGTCAGTGGAATTCCGAG	0.0
TACGGAGGGGACTAGCGTTGTTCGGAATTACTGGGCGTAAAGCGCACGTAGGCGGGCTGTTAAGTCAGGGGTGAAATCCTGGGGCTCAACCCCAGAACTGCCCTTGATACTGGCAGCCTCGAGTCCGAGAGAGGTGAGTGGAATTCCGAG	TACGGAGGGGACTAGCGTTGTTCGGAATTACTGGGCGTAAAGCGCACGTAGGCGGGCTGTTAAGTCAGGGGTGAAATCCTGGGGCTCAACCCCAGAACTGCCCTTGATACTGGCAGCCTCGAGTCCGAGAGAGGTGAGTGGAATTCCGAG	0.0
TACGGAGGGGACTAGCGTTGTTCGGAATTACTGGGCGTAAAGCGCGCGTAGGCGGACTATTAAGTCAGGGGTGAAATCCCGGGGCTCAACCCCGGAACTGCCCTTGATACTGGTAGTCTGGAGTTCTGGAGAGGTGAGTGGAATTCCGAG	TACGGAGGGGACTAGCGTTGTTCGGAATTACTGGGCGTAAAGCGCGCGTAGGCGGACTATTAAGTCAGGGGTGAAATCCCGGGGCTCAACCCCGGAACTGCCCTTGATACTGGTAGTCTGGAGTTCTGGAGAGGTGAGTGGAATTCCGAG	0.0
TACGGAGGGGGCTAGCGTTGTTCGGAAATACTGGGCGTAAAGCGAACGTAGGCGGCTTAGCAAGTCAGGGGTGAAATCCCAGAGCTCAACTCTGGAACTGCCTTTGAAACTGCTTCGCTTGAATCCTGGAGAGGCGAGTGGAATTCCGAG	TACGGAGGGGGCTAGCGTTGTTCGGAAATACTGGGCGTAAAGCGAACGTAGGCGGCTTAGCAAGTCAGGGGTGAAATCCCAGAGCTCAACTCTGGAACTGCCTTTGAAACTGCTTCGCTTGAATCCTGGAGAGGCGAGTGGAATTCCGAG	0.0
TACGGAGGGGGCTAGCGTTGTTCGGAATGACTGGGCGTAAAGCGCGCGTAGGCGGATTGGCAAGTTGGGGGTGAAATCCCGGGGCTCAACCTCGGAATGGCCTTCAAGACTGCCGGTCTTGAGTTCGAGAGAGGTGAGTGGAATTCCGAG	TACGGAGGGGGCTAGCGTTGTTCGGAATGACTGGGCGTAAAGCGCGCGTAGGCGGATTGGCAAGTTGGGGGTGAAATCCCGGGGCTCAACCTCGGAATGGCCTTCAAGACTGCCGGTCTTGAGTTCGAGAGAGGTGAGTGGAATTCCGAG	0.0
TACGGAGGGGGCTAGCGTTGTTCGGAATGACTGGGCGTAAAGCGCGCGTAGGCGGATTGGCAAGTTGGGGGTGAAATCCCGGGGCTCAACCTCGGAATGGCCTTCAAGACTGCTGGTCTTGAGTTCGAGAGAGGTGAGTGGAATTCCGAG	TACGGAGGGGGCTAGCGTTGTTCGGAATGACTGGGCGTAAAGCGCGCGTAGGCGGATTGGCAAGTTGGGGGTGAAATCCCGGGGCTCAACCTCGGAATGGCCTTCAAGACTGCTGGTCTTGAGTTCGAGAGAGGTGAGTGGAATTCCGAG	0.0
TACGGAGGGGGCTAGCGTTGTTCGGAATTACTGGGCGTAAAGCGCACGTAGGCGGACATTTAAGTCAGGGGTGAAATCCCGGGGCTCAACCCCGGAACTGCCTTTGATACTGGATGTCTGGAGGTCGAGAGAGGCGAGTGGAATTCCGAG	TACGGAGGGGGCTAGCGTTGTTCGGAATTACTGGGCGTAAAGCGCACGTAGGCGGACATTTAAGTCAGGGGTGAAATCCCGGGGCTCAACCCCGGAACTGCCTTTGATACTGGATGTCTGGAGGTCGAGAGAGGCGAGTGGAATTCCGAG	0.0
TACGGAGGGGGCTAGCGTTGTTCGGAATTACTGGGCGTAAAGCGCACGTAGGCGGACTGGAAAGTCAGAGGTGAAATCCCAGGGCTCAACCTTGGAACTGCCTTTGAAACTATCGGTCTGGAGTTCGAGAGAGGTGAGTGGAATTCCGAG	TACGGAGGGGGCTAGCGTTGTTCGGAATTACTGGGCGTAAAGCGCACGTAGGCGGACTGGAAAGTCAGAGGTGAAATCCCAGGGCTCAACCTTGGAACTGCCTTTGAAACTATCGGTCTGGAGTTCGAGAGAGGTGAGTGGAATTCCGAG	0.0
TACGGAGGGGGCTAGCGTTGTTCGGAATTACTGGGCGTAAAGCGCACGTAGGCGGATCAGTCAGTCAGGGGTGAAATCCCGGGGCTCAACCCCGGAACTGCCTTTGATACTGCTGGTCTGGAGGATGAGAGAGGCGAGTGGAATTCCGAG	TACGGAGGGGGCTAGCGTTGTTCGGAATTACTGGGCGTAAAGCGCACGTAGGCGGATCAGTCAGTCAGGGGTGAAATCCCGGGGCTCAACCCCGGAACTGCCTTTGATACTGCTGGTCTGGAGGATGAGAGAGGCGAGTGGAATTCCGAG	0.0
TACGGAGGGGGCTAGCGTTGTTCGGAATTACTGGGCGTAAAGCGCACGTAGGCGGATCAGTCAGTCAGGGGTGAAATCCCGGGGCTCAACCCCGGAACTGCCTTTGATACTGCTGGTCTGGAGGTCGAGAGAGGTGAGTGGAATTCCGAG	TACGGAGGGGGCTAGCGTTGTTCGGAATTACTGGGCGTAAAGCGCACGTAGGCGGATCAGTCAGTCAGGGGTGAAATCCCGGGGCTCAACCCCGGAACTGCCTTTGATACTGCTGGTCTGGAGGTCGAGAGAGGTGAGTGGAATTCCGAG	0.0
TACGGAGGGGGCTAGCGTTGTTCGGAATTACTGGGCGTAAAGCGCACGTAGGCGGCTTTACAAGTCAGGGGTGAAAGCCCGCGGCTCAACCGCGGAATTGCCCTTGAGACTGTATCGCTTGAACACGGGAGAGGTGAGTGGAATTCCGAG	TACGGAGGGGGCTAGCGTTGTTCGGAATTACTGGGCGTAAAGCGCACGTAGGCGGCTTTACAAGTCAGGGGTGAAAGCCCGCGGCTCAACCGCGGAATTGCCCTTGAGACTGTATCGCTTGAACACGGGAGAGGTGAGTGGAATTCCGAG	0.0
TACGGAGGGGGCTAGCGTTGTTCGGAATTACTGGGCGTAAAGCGCACGTAGGCGGCTTTGTAAGTTAGAGGTGAAAGCCCAGGGCTCAACCTTGGAATTGCCTTTAAGACTGCATCGCTTGAACACGGGAGAGGTGAGTGGAATTCCGAG	TACGGAGGGGGCTAGCGTTGTTCGGAATTACTGGGCGTAAAGCGCACGTAGGCGGCTTTGTAAGTTAGAGGTGAAAGCCCAGGGCTCAACCTTGGAATTGCCTTTAAGACTGCATCGCTTGAACACGGGAGAGGTGAGTGGAATTCCGAG	0.0
TACGGAGGGGGCTAGCGTTGTTCGGAATTACTGGGCGTAAAGCGCATGTAGGCGGATCAGTTAGTCAGGGGTGAAATCCCGGGGCTCAACCCCGGAACTGCCTTTGATACTGCTGGTCTGGAGGTCGAGAGAGGTGAGTGGAATTCCGAG	TACGGAGGGGGCTAGCGTTGTTCGGAATTACTGGGCGTAAAGCGCATGTAGGCGGATCAGTTAGTCAGGGGTGAAATCCCGGGGCTCAACCCCGGAACTGCCTTTGATACTGCTGGTCTGGAGGTCGAGAGAGGTGAGTGGAATTCCGAG	0.0
TACGGAGGGGGCTAGCGTTGTTCGGAATTACTGGGCGTAAAGCGCGCGTAGGCGGCTTTGTAAGTTAGAGGTGAAAGCCCGAAGCTCAACTTCGGAATTGCCTTTAAGACTGCATCGCTAGAATCATGGAGAGGTTAGTGGAATTCCGAG	TACGGAGGGGGCTAGCGTTGTTCGGAATTACTGGGCGTAAAGCGCGCGTAGGCGGCTTTGTAAGTTAGAGGTGAAAGCCCGAAGCTCAACTTCGGAATTGCCTTTAAGACTGCATCGCTAGAATCATGGAGAGGTTAGTGGAATTCCGAG	0.0
TACGGAGGGGGCTAGCGTTGTTCGGAATTACTGGGCGTAAAGCGCGCGTAGGCGGCTTTGTAAGTTAGAGGTGAAAGCCCGGGGCTCAACTCCGGAATTGCCTTTAAGACTGCATCGCTAGAACGTCGGAGAGGTATGTGGAATTCCGAG	TACGGAGGGGGCTAGCGTTGTTCGGAATTACTGGGCGTAAAGCGCGCGTAGGCGGCTTTGTAAGTTAGAGGTGAAAGCCCGGGGCTCAACTCCGGAATTGCCTTTAAGACTGCATCGCTAGAACGTCGGAGAGGTATGTGGAATTCCGAG	0.0
TACGGAGGGGGCTAGCGTTGTTCGGAATTACTGGGCGTAAAGCGTACGTAGGCGGCTTCGCAAGTCAGAGGTGAAAGCCTGGAGCTCAACTCCAGAATTGCCTTTGAGACTGCGTCGCTTGATCACGGGAGAGGTGAGTGGAATTCCGAG	TACGGAGGGGGCTAGCGTTGTTCGGAATTACTGGGCGTAAAGCGTACGTAGGCGGCTTCGCAAGTCAGAGGTGAAAGCCTGGAGCTCAACTCCAGAATTGCCTTTGAGACTGCGTCGCTTGATCACGGGAGAGGTGAGTGGAATTCCGAG	0.0
TACGGAGGGGGCTAGCGTTGTTCGGAATTACTGGGCGTAAAGCGTACGTAGGCGGCTTGGTAAGTTAGAGGTGAAAGCCCGGAGCTCAACTTCGGAATTGCCTTTAAGACTGCTTGGCTTGAACGTCGGAGAGGTGAGTGGAATTCCGAG	TACGGAGGGGGCTAGCGTTGTTCGGAATTACTGGGCGTAAAGCGTACGTAGGCGGCTTGGTAAGTTAGAGGTGAAAGCCCGGAGCTCAACTTCGGAATTGCCTTTAAGACTGCTTGGCTTGAACGTCGGAGAGGTGAGTGGAATTCCGAG	0.0
TACGGAGGGGGCTAGCGTTGTTCGGAATTACTGGGCGTAAAGCGTACGTAGGCGGCTTTGTAAGTTAGAGGTGAAAGCCCAGAGCTCAACTCTGGAATTGCCTTTAAGACTGCATCGCTTGAATCGTGGAGAGGTTAGTGGAATTCCGAG	TACGGAGGGGGCTAGCGTTGTTCGGAATTACTGGGCGTAAAGCGTACGTAGGCGGCTTTGTAAGTTAGAGGTGAAAGCCCAGAGCTCAACTCTGGAATTGCCTTTAAGACTGCATCGCTTGAATCGTGGAGAGGTTAGTGGAATTCCGAG	0.0
TACGGAGGGGGCTAGCGTTGTTCGGAATTACTGGGCGTAAAGCGTACGTAGGCGGCTTTGTAAGTTAGAGGTGAAAGCCCGGGGCTCAACTCCGGAACTGCCTTTAAGACTGCATCGCTAGAACGTCGGAGAGGTGAGTGGAATTCCGAG	TACGGAGGGGGCTAGCGTTGTTCGGAATTACTGGGCGTAAAGCGTACGTAGGCGGCTTTGTAAGTTAGAGGTGAAAGCCCGGGGCTCAACTCCGGAACTGCCTTTAAGACTGCATCGCTAGAACGTCGGAGAGGTGAGTGGAATTCCGAG	0.0
TACGGAGGGGGTTAGCGTTGTTCGGAATGACTGGGCGTAAAGCGCGCGTAGGCGGATCAGGAAGTTGGGGGTGAAATCCCGGGGCTCAACCCCGGAATGGCCTTCAAAACTCCTGGTCTTGAGTTCGAGAGAGGTGAGTGGAATTCCGAG	TACGGAGGGGGTTAGCGTTGTTCGGAATGACTGGGCGTAAAGCGCGCGTAGGCGGATCAGGAAGTTGGGGGTGAAATCCCGGGGCTCAACCCCGGAATGGCCTTCAAAACTCCTGGTCTTGAGTTCGAGAGAGGTGAGTGGAATTCCGAG	0.0
TACGGAGGGGGTTAGCGTTGTTCGGAATGACTGGGCGTAAAGCGCGCGTAGGCGGATCATCAAGTCGGGGGTGAAATCCCGGGGCTCAACCCCGGAATGGCCTTCGAGACTGGTGGTCTTGAGTTCGAGAGAGGTGAGTGGAATTCCGAG	TACGGAGGGGGTTAGCGTTGTTCGGAATGACTGGGCGTAAAGCGCGCGTAGGCGGATCATCAAGTCGGGGGTGAAATCCCGGGGCTCAACCCCGGAATGGCCTTCGAGACTGGTGGTCTTGAGTTCGAGAGAGGTGAGTGGAATTCCGAG	0.0
TACGGAGGGGGTTAGCGTTGTTCGGAATGACTGGGCGTAAAGCGCGCGTAGGCGGATCGGAAAGTTGGGGGTGAAATCCCGGGGCTCAACCTCGGAATGGCCTTCAAAACTCCTGGTCTTGAGTTCGAGAGAGGTGAGTGGAATTCCGAG	TACGGAGGGGGTTAGCGTTGTTCGGAATGACTGGGCGTAAAGCGCGCGTAGGCGGATCGGAAAGTTGGGGGTGAAATCCCGGGGCTCAACCTCGGAATGGCCTTCAAAACTCCTGGTCTTGAGTTCGAGAGAGGTGAGTGGAATTCCGAG	0.0
TACGGAGGGGGTTAGCGTTGTTCGGAATGACTGGGCGTAAAGCGCGCGTAGGCGGGCTGGAAAGTCAGAGGTGAAAGCCCGGGGCTCAACCCCGGAATGGCCTTTGAAACTCCCAGCCTTGAGTTCGAGAGAGGTGAGTGGAATTCCGAG	TACGGAGGGGGTTAGCGTTGTTCGGAATGACTGGGCGTAAAGCGCGCGTAGGCGGGCTGGAAAGTCAGAGGTGAAAGCCCGGGGCTCAACCCCGGAATGGCCTTTGAAACTCCCAGCCTTGAGTTCGAGAGAGGTGAGTGGAATTCCGAG	0.0
TACGGAGGGGGTTAGCGTTGTTCGGAATGACTGGGCGTAAAGCGCGCGTAGGCGGGCTGGAAAGTTGGGGGTGAAATCCCGGGGCTCAACCCCGGAATGGCCTTCAAAACTCCCAGCCTAGAGTTCGAGAGAGGTGAGTGGAATTCCGAG	TACGGAGGGGGTTAGCGTTGTTCGGAATGACTGGGCGTAAAGCGCGCGTAGGCGGGCTGGAAAGTTGGGGGTGAAATCCCGGGGCTCAACCCCGGAATGGCCTTCAAAACTCCCAGCCTAGAGTTCGAGAGAGGTGAGTGGAATTCCGAG	0.0
TACGGAGGGTGCAAGCGTTAATCGGAATTACTGGGCGTAAAGGGCGCGTAGGCGGTTCAGTCAGTCGGATGTGAAAGCCCCGGGCTTAACCTGGGAACGGCATTCGATACTGCTGGGCTAGAGTATGGTAGAGGGAAGTGGAATTTCCGG	TACGGAGGGTGCAAGCGTTAATCGGAATTACTGGGCGTAAAGGGCGCGTAGGCGGTTCAGTCAGTCGGATGTGAAAGCCCCGGGCTTAACCTGGGAACGGCATTCGATACTGCTGGGCTAGAGTATGGTAGAGGGAAGTGGAATTTCCGG	0.0
TACGGAGGGTGCAAGCGTTACCCGGAATCACTGGGCGTAAAGGGCGTGTAGGCGGATCAGTAAGTCTGGTTTTAAAGACTGCGGCTCAACCGCAGGGATGGACTGGATACTGTTGATCTTGACCTCTGGAGAGGAAACCGGAATTCCTGG	TACGGAGGGTGCAAGCGTTACCCGGAATCACTGGGCGTAAAGGGCGTGTAGGCGGATCAGTAAGTCTGGTTTTAAAGACTGCGGCTCAACCGCAGGGATGGACTGGATACTGTTGATCTTGACCTCTGGAGAGGAAACCGGAATTCCTGG	0.0
TACGGAGGGTGCAAGCGTTACCCGGAATCACTGGGCGTAAAGGGCGTGTAGGCGGGATGTTAAGTCTGGTTTTAAAGACTGCGGCTCAACCGCAGGGATGGACTGGATACTGGCATTCTTGACCTCTGGAGAGGAAACCGGAATTCCTGG	TACGGAGGGTGCAAGCGTTACCCGGAATCACTGGGCGTAAAGGGCGTGTAGGCGGGATGTTAAGTCTGGTTTTAAAGACTGCGGCTCAACCGCAGGGATGGACTGGATACTGGCATTCTTGACCTCTGGAGAGGAAACCGGAATTCCTGG	0.0
TACGGAGGGTGCAAGCGTTATCCGGAATCACTGGGCGTAAAGGGCGCGTAGGCGGTTTGTTAAGTCCGATGTTAAAGCGTGAGGCTCAACCTCATCACGGCGTTGGATACTGGCAAGCTGGACGGTTGGAGAGGAAGGTAGAATTACCAG	TACGGAGGGTGCAAGCGTTATCCGGAATCACTGGGCGTAAAGGGCGCGTAGGCGGTTTGTTAAGTCCGATGTTAAAGCGTGAGGCTCAACCTCATCACGGCGTTGGATACTGGCAAGCTGGACGGTTGGAGAGGAAGGTAGAATTACCAG	0.0
TACGGAGGGTGCAAGCGTTATCCGGATTCACTGGGTTTAAAGGGAGCGTAGGAGGGCAGGTAAGTCAGTGGTGAAATCTTCGAGCTTAACTCGGAAACTGCCGTTGATACTATCTGTCTTGAATACCGTGGAGATGAGCGGAATATGTCA	TACGGAGGGTGCAAGCGTTATCCGGATTCACTGGGTTTAAAGGGAGCGTAGGAGGGCAGGTAAGTCAGTGGTGAAATCTTCGAGCTTAACTCGGAAACTGCCGTTGATACTATCTGTCTTGAATACCGTGGAGATGAGCGGAATATGTCA	0.0
TACGGAGGGTGCAAGCGTTATCCGGATTCACTGGGTTTAAAGGGTGCGTAGGAGGGCAGGGAAGTCAGTGGTGAAATCTCCGGGCTTAACTCGGAAACTGCCGTTGATACTCTCTGTCTTGAATACCGTGGAGATGAGCGGAATATGTCA	TACGGAGGGTGCAAGCGTTATCCGGATTCACTGGGTTTAAAGGGTGCGTAGGAGGGCAGGGAAGTCAGTGGTGAAATCTCCGGGCTTAACTCGGAAACTGCCGTTGATACTCTCTGTCTTGAATACCGTGGAGATGAGCGGAATATGTCA	0.0
TACGGAGGGTGCAAGCGTTATCCGGATTCACTGGGTTTAAAGGGTGCGTAGGAGGGCAGGGAAGTCAGTGGTGAAATCTCCGGGCTTAACTCGGAAACTGCCGTTGATACTCTCTGTCTTGAATCCCGTGGAGGTGAGCGGAATATGTCA	TACGGAGGGTGCAAGCGTTATCCGGATTCACTGGGTTTAAAGGGTGCGTAGGAGGGCAGGGAAGTCAGTGGTGAAATCTCCGGGCTTAACTCGGAAACTGCCGTTGATACTCTCTGTCTTGAATCCCGTGGAGGTGAGCGGAATATGTCA	0.0
TACGGAGGGTGCAAGCGTTATCCGGATTCACTGGGTTTAAAGGGTGCGTAGGAGGGTGTGTAAGTCAGTGGTGAAATCTTCGAGCTTAACTCGGAAACTGCCGTTGATACTACATGTCTTGAATATCGTGGAGGTGAGCGGAATATGTCA	TACGGAGGGTGCAAGCGTTATCCGGATTCACTGGGTTTAAAGGGTGCGTAGGAGGGTGTGTAAGTCAGTGGTGAAATCTTCGAGCTTAACTCGGAAACTGCCGTTGATACTACATGTCTTGAATATCGTGGAGGTGAGCGGAATATGTCA	0.0
TACGGAGGGTGCAAGCGTTATCCGGATTCACTGGGTTTAAAGGGTGCGTAGGCGGGCAGGTAAGTCAGTGGTGAAATCTTCGAGCTTAACTCGGAAACTGCCGTTGATACTATCTGTCTTGAATACTCGGGAGGTGAGCGGAATATGTCA	TACGGAGGGTGCAAGCGTTATCCGGATTCACTGGGTTTAAAGGGTGCGTAGGCGGGCAGGTAAGTCAGTGGTGAAATCTTCGAGCTTAACTCGGAAACTGCCGTTGATACTATCTGTCTTGAATACTCGGGAGGTGAGCGGAATATGTCA	0.0
TACGGAGGGTGCAAGCGTTATCCGGATTCACTGGGTTTAAAGGGTGCGTAGGTGGGAATGTAAGTCAGCGGTGAAATCTCTGAGCTTAACTCAGAAACTGCCATTGATACTATGTTTCTTGAATTTTCTGGAGGTCAGCGGAATATGTCA	TACGGAGGGTGCAAGCGTTATCCGGATTCACTGGGTTTAAAGGGTGCGTAGGTGGGAATGTAAGTCAGCGGTGAAATCTCTGAGCTTAACTCAGAAACTGCCATTGATACTATGTTTCTTGAATTTTCTGGAGGTCAGCGGAATATGTCA	0.0
TACGGAGGGTGCAAGCGTTATCCGGATTCACTGGGTTTAAAGGGTGCGTAGGTGGGAATGTAAGTCAGTGGTGAAATCTCCGTGCTTAACATGGAAACTGCCATTGATACTATGTTTCTTGAATTTTCCGGAGGTTAGCGGAATATGTCA	TACGGAGGGTGCAAGCGTTATCCGGATTCACTGGGTTTAAAGGGTGCGTAGGTGGGAATGTAAGTCAGTGGTGAAATCTCCGTGCTTAACATGGAAACTGCCATTGATACTATGTTTCTTGAATTTTCCGGAGGTTAGCGGAATATGTCA	0.0
TACGGAGGGTGCAAGCGTTATCCGGATTCACTGGGTTTAAAGGGTGCGTAGGTGGGAATGTAAGTCAGTGGTGAAATCTCCGTGCTTAACATGGAAACTGCCATTGATACTATGTTTCTTGAATTTTCTGGAGGTTAGCGGAATATGTCA	TACGGAGGGTGCAAGCGTTATCCGGATTCACTGGGTTTAAAGGGTGCGTAGGTGGGAATGTAAGTCAGTGGTGAAATCTCCGTGCTTAACATGGAAACTGCCATTGATACTATGTTTCTTGAATTTTCTGGAGGTTAGCGGAATATGTCA	0.0
TACGGAGGGTGCAAGCGTTATCCGGATTCACTGGGTTTAAAGGGTGCGTAGGTGGGAATGTAAGTCAGTGGTGAAATCTCTGAGCTTAACTCAGAAACTGCCATTGATACTATGTTTCTTGAATTTTCTGGAGGTCAGCGGAATATGTCA	TACGGAGGGTGCAAGCGTTATCCGGATTCACTGGGTTTAAAGGGTGCGTAGGTGGGAATGTAAGTCAGTGGTGAAATCTCTGAGCTTAACTCAGAAACTGCCATTGATACTATGTTTCTTGAATTTTCTGGAGGTCAGCGGAATATGTCA	0.0
TACGGAGGGTGCAAGCGTTATCCGGATTCACTGGGTTTAAAGGGTGCGTAGGTGGGTTGGTAAGTCAGTGGTGAAATCTCCGTGCTTAACATGGAAACTGCCATTGATACTACTGATCTTGAATTTTCTGGAGGTAAGCGGAATATGTCA	TACGGAGGGTGCAAGCGTTATCCGGATTCACTGGGTTTAAAGGGTGCGTAGGTGGGTTGGTAAGTCAGTGGTGAAATCTCCGTGCTTAACATGGAAACTGCCATTGATACTACTGATCTTGAATTTTCTGGAGGTAAGCGGAATATGTCA	0.0
TACGGAGGGTGCAAGCGTTGTCCGGATTTATTGGGTTTAAAGGGTGCGTAGGCGGCCCATTAAGTCAGCGGTGAAAGCCCGGGGCTCAACCCCGGAACCGCCGTTGATACTGGTGGGCTTGAGTATGGACGAGGTTGGCGGAATTGAGGG	TACGGAGGGTGCAAGCGTTGTCCGGATTTATTGGGTTTAAAGGGTGCGTAGGCGGCCCATTAAGTCAGCGGTGAAAGCCCGGGGCTCAACCCCGGAACCGCCGTTGATACTGGTGGGCTTGAGTATGGACGAGGTTGGCGGAATTGAGGG	0.0
TACGGAGGGTGCAAGCGTTGTCCGGATTTATTGGGTTTAAAGGGTGCGTAGGCGGCCCATTAAGTCAGTGGTGAAAGCCCGGGGCTCAACCCCGGAACCGCCATTGATACTGGTGGGCTTGAGTATGGACGAGGTTGGCGGAATTGAGGG	TACGGAGGGTGCAAGCGTTGTCCGGATTTATTGGGTTTAAAGGGTGCGTAGGCGGCCCATTAAGTCAGTGGTGAAAGCCCGGGGCTCAACCCCGGAACCGCCATTGATACTGGTGGGCTTGAGTATGGACGAGGTTGGCGGAATTGAGGG	0.0
TACGGAGGGTGCAAGCGTTGTCCGGATTTATTGGGTTTAAAGGGTGCGTAGGCGGCCCATTAAGTCCGTGGTGAAAGCCAACAGCTCAACTGTTGAACTGCCATGGATACTGATGGGCTTGAGTACAGACGAGGTAGGCGGAATGGATGC	TACGGAGGGTGCAAGCGTTGTCCGGATTTATTGGGTTTAAAGGGTGCGTAGGCGGCCCATTAAGTCCGTGGTGAAAGCCAACAGCTCAACTGTTGAACTGCCATGGATACTGATGGGCTTGAGTACAGACGAGGTAGGCGGAATGGATGC	0.0
TACGGAGGGTGCAAGCGTTGTCCGGATTTATTGGGTTTAAAGGGTGCGTAGGCGGCCCCTTAAGTCAGCGGTGAAAGCCCGGGGCTCAACCCCGGAACTGCCGTTGATACTGGGGGGCTTGAGTACAGACGAGGTAGGCGGAATTGAGGG	TACGGAGGGTGCAAGCGTTGTCCGGATTTATTGGGTTTAAAGGGTGCGTAGGCGGCCCCTTAAGTCAGCGGTGAAAGCCCGGGGCTCAACCCCGGAACTGCCGTTGATACTGGGGGGCTTGAGTACAGACGAGGTAGGCGGAATTGAGGG	0.0
TACGGAGGGTGCAAGCGTTGTCCGGATTTATTGGGTTTAAAGGGTGCGTAGGCGGCCCGGTAAGTCAGTGGTGAAAGCCCATCGCTCAACGATGGAACTGCCATTGATACTGCCGGGCTTGAGTACAGACGAGGTAGGCGGAATTGATAG	TACGGAGGGTGCAAGCGTTGTCCGGATTTATTGGGTTTAAAGGGTGCGTAGGCGGCCCGGTAAGTCAGTGGTGAAAGCCCATCGCTCAACGATGGAACTGCCATTGATACTGCCGGGCTTGAGTACAGACGAGGTAGGCGGAATTGATAG	0.0
TACGGAGGGTGCAAGCGTTGTCCGGATTTATTGGGTTTAAAGGGTGCGTAGGCGGCCCGTTAAGTCAGCGGTGAAATCCCACGGCTCAACCGTGGAACTGCCGTTGATACTGGCGGGCTTGAGTTCGGTCGAGGCGGGCGGAACTGGCGG	TACGGAGGGTGCAAGCGTTGTCCGGATTTATTGGGTTTAAAGGGTGCGTAGGCGGCCCGTTAAGTCAGCGGTGAAATCCCACGGCTCAACCGTGGAACTGCCGTTGATACTGGCGGGCTTGAGTTCGGTCGAGGCGGGCGGAACTGGCGG	0.0
TACGGAGGGTGCAAGCGTTGTCCGGATTTATTGGGTTTAAAGGGTGCGTAGGCGGCCCGTTAAGTCAGCGGTGAAATCCCACGGCTCAACCGTGGAACTGCCGTTGATACTGGCGGGCTTGAGTTCGGTCGAGGCGGGCGGAACTGGTGG	TACGGAGGGTGCAAGCGTTGTCCGGATTTATTGGGTTTAAAGGGTGCGTAGGCGGCCCGTTAAGTCAGCGGTGAAATCCCACGGCTCAACCGTGGAACTGCCGTTGATACTGGCGGGCTTGAGTTCGGTCGAGGCGGGCGGAACTGGTGG	0.0
TACGGAGGGTGCAAGCGTTGTCCGGATTTATTGGGTTTAAAGGGTGCGTAGGCGGCCCGTTAAGTCAGCGGTGAAATCCCAGGGCTCAACCCTGGAACTGCCGTTGATACTGGCGGGCTTGAGTTCGGTCGAGGCGGGCGGAACTGGTGG	TACGGAGGGTGCAAGCGTTGTCCGGATTTATTGGGTTTAAAGGGTGCGTAGGCGGCCCGTTAAGTCAGCGGTGAAATCCCAGGGCTCAACCCTGGAACTGCCGTTGATACTGGCGGGCTTGAGTTCGGTCGAGGCGGGCGGAACTGGTGG	0.0
TACGGAGGGTGCAAGCGTTGTCCGGATTTATTGGGTTTAAAGGGTGCGTAGGCGGCCCGTTAAGTCAGCGGTGAAATCCCGGGGCTCAACCCCGGAACTGCCGTTGATACTGGCGGGCTTGAGTTCGGTCGAGGCGGGCGGAACTGGCGG	TACGGAGGGTGCAAGCGTTGTCCGGATTTATTGGGTTTAAAGGGTGCGTAGGCGGCCCGTTAAGTCAGCGGTGAAATCCCGGGGCTCAACCCCGGAACTGCCGTTGATACTGGCGGGCTTGAGTTCGGTCGAGGCGGGCGGAACTGGCGG	0.0
TACGGAGGGTGCAAGCGTTGTCCGGATTTATTGGGTTTAAAGGGTGCGTAGGCGGCCCGTTAAGTCCGTGGTGAAAGCCAACAGCTCAACTGTTGAACTGCCATGGATACTGACGGGCTTGAGTACAGACGAGGTAGGCGGAATGGATGG	TACGGAGGGTGCAAGCGTTGTCCGGATTTATTGGGTTTAAAGGGTGCGTAGGCGGCCCGTTAAGTCCGTGGTGAAAGCCAACAGCTCAACTGTTGAACTGCCATGGATACTGACGGGCTTGAGTACAGACGAGGTAGGCGGAATGGATGG	0.0
TACGGAGGGTGCAAGCGTTGTCCGGATTTATTGGGTTTAAAGGGTGCGTAGGCGGCCCTGTAAGTCCGTGGTGAAAGCCAACAGCTCAACTGTTGAACTGCCATGGATACTGCAGGGCTTGAGTACAGACGAGGTAGGCGGAATGGATAG	TACGGAGGGTGCAAGCGTTGTCCGGATTTATTGGGTTTAAAGGGTGCGTAGGCGGCCCTGTAAGTCCGTGGTGAAAGCCAACAGCTCAACTGTTGAACTGCCATGGATACTGCAGGGCTTGAGTACAGACGAGGTAGGCGGAATGGATAG	0.0
TACGGAGGGTGCAAGCGTTGTCCGGATTTATTGGGTTTAAAGGGTGCGTAGGCGGCCCTGTAAGTCCGTGGTGAAATCCAACAGCTCAACTGTTGAACTGCCATGGATACTGCAGGGCTTGAGTACAGACGAGGTAGGCGGAATGGATAG	TACGGAGGGTGCAAGCGTTGTCCGGATTTATTGGGTTTAAAGGGTGCGTAGGCGGCCCTGTAAGTCCGTGGTGAAATCCAACAGCTCAACTGTTGAACTGCCATGGATACTGCAGGGCTTGAGTACAGACGAGGTAGGCGGAATGGATAG	0.0
TACGGAGGGTGCAAGCGTTGTCCGGATTTATTGGGTTTAAAGGGTGCGTAGGCGGCCGATTAAGTCAGTGGTGAAATCCCGGGGCTCAACCCCGGAACTGCCATTGATACTGGTTGGCTTGAGTTCGGTCGAGGCGGGCGGAACTGGTGG	TACGGAGGGTGCAAGCGTTGTCCGGATTTATTGGGTTTAAAGGGTGCGTAGGCGGCCGATTAAGTCAGTGGTGAAATCCCGGGGCTCAACCCCGGAACTGCCATTGATACTGGTTGGCTTGAGTTCGGTCGAGGCGGGCGGAACTGGTGG	0.0
TACGGAGGGTGCAAGCGTTGTCCGGATTTATTGGGTTTAAAGGGTGCGTAGGCGGCCGTTTAAGTCCGGGGTGAAAGCCCACTGCTCAACAGTGGAACTGCCCTGGAAACTGGACGGCTTGAGTACAGACGAGGGCGGCGGAATGGATGG	TACGGAGGGTGCAAGCGTTGTCCGGATTTATTGGGTTTAAAGGGTGCGTAGGCGGCCGTTTAAGTCCGGGGTGAAAGCCCACTGCTCAACAGTGGAACTGCCCTGGAAACTGGACGGCTTGAGTACAGACGAGGGCGGCGGAATGGATGG	0.0
TACGGAGGGTGCAAGCGTTGTCCGGATTTATTGGGTTTAAAGGGTGCGTAGGCGGCCTATTAAGTCAGCGGTGAAATCCCGGGGCTCAACCCCGGAACTGCCGTTGATACTGGTTGGCTTGAGTTCGGTAGAGGCGGGCGGAACTCATGG	TACGGAGGGTGCAAGCGTTGTCCGGATTTATTGGGTTTAAAGGGTGCGTAGGCGGCCTATTAAGTCAGCGGTGAAATCCCGGGGCTCAACCCCGGAACTGCCGTTGATACTGGTTGGCTTGAGTTCGGTAGAGGCGGGCGGAACTCATGG	0.0
TACGGAGGGTGCAAGCGTTGTCCGGATTTATTGGGTTTAAAGGGTGCGTAGGCGGCCTATTAAGTCAGGGGTGAAAGACTATTGCTCAACAATGGCAGTGCCTTTGATACTGATAGGCTTGAGTATAGATGAGGCCGGCGGAATGGGTGG	TACGGAGGGTGCAAGCGTTGTCCGGATTTATTGGGTTTAAAGGGTGCGTAGGCGGCCTATTAAGTCAGGGGTGAAAGACTATTGCTCAACAATGGCAGTGCCTTTGATACTGATAGGCTTGAGTATAGATGAGGCCGGCGGAATGGGTGG	0.0
TACGGAGGGTGCAAGCGTTGTCCGGATTTATTGGGTTTAAAGGGTGCGTAGGCGGCCTGTTAAGTCAGGGGTGAAAGACTGCAGCTCAACTGTAGCAGTGCCTTTGATACTGATGGGCTTGAGTCTAGATGAGGCCGGCGGAATGGGTGG	TACGGAGGGTGCAAGCGTTGTCCGGATTTATTGGGTTTAAAGGGTGCGTAGGCGGCCTGTTAAGTCAGGGGTGAAAGACTGCAGCTCAACTGTAGCAGTGCCTTTGATACTGATGGGCTTGAGTCTAGATGAGGCCGGCGGAATGGGTGG	0.0
TACGGAGGGTGCAAGCGTTGTCCGGATTTATTGGGTTTAAAGGGTGCGTAGGCGGCCTGTTAAGTCCGTGGTGAAAGCCAACAGCTCAACTGTTGAACTGCCATGGATACTGACAGGCTTGAGTACAGACGAGGTTGGCGGAATTGATGC	TACGGAGGGTGCAAGCGTTGTCCGGATTTATTGGGTTTAAAGGGTGCGTAGGCGGCCTGTTAAGTCCGTGGTGAAAGCCAACAGCTCAACTGTTGAACTGCCATGGATACTGACAGGCTTGAGTACAGACGAGGTTGGCGGAATTGATGC	0.0
TACGGAGGGTGCAAGCGTTGTCCGGATTTATTGGGTTTAAAGGGTGCGTAGGCGGCCTGTTAAGTCCGTGGTGAAAGCCAACAGCTCAACTGTTGAACTGCCATGGATACTGACCGGCTTGAGTACAGACGAGGTTGGCGGAATTGATGC	TACGGAGGGTGCAAGCGTTGTCCGGATTTATTGGGTTTAAAGGGTGCGTAGGCGGCCTGTTAAGTCCGTGGTGAAAGCCAACAGCTCAACTGTTGAACTGCCATGGATACTGACCGGCTTGAGTACAGACGAGGTTGGCGGAATTGATGC	0.0
TACGGAGGGTGCAAGCGTTGTCCGGATTTATTGGGTTTAAAGGGTGCGTAGGCGGCCTGTTAAGTCGATGTTGAAAGTTTGCCGCTTAACGGTAAAAATGGCAACGATACTGGCGGGCTTGAGTACAGACGAGGTAGGCGGAATTGATAA	TACGGAGGGTGCAAGCGTTGTCCGGATTTATTGGGTTTAAAGGGTGCGTAGGCGGCCTGTTAAGTCGATGTTGAAAGTTTGCCGCTTAACGGTAAAAATGGCAACGATACTGGCGGGCTTGAGTACAGACGAGGTAGGCGGAATTGATAA	0.0
TACGGAGGGTGCAAGCGTTGTCCGGATTTATTGGGTTTAAAGGGTGCGTAGGCGGCCTTATAAGTCAGTGGTGAAAGCCCATCGCTCAACGATGGAACTGCCATTGATACTGTAAGGCTTGAGTACAGACGAGGTAGGCGGAATTGATGG	TACGGAGGGTGCAAGCGTTGTCCGGATTTATTGGGTTTAAAGGGTGCGTAGGCGGCCTTATAAGTCAGTGGTGAAAGCCCATCGCTCAACGATGGAACTGCCATTGATACTGTAAGGCTTGAGTACAGACGAGGTAGGCGGAATTGATGG	0.0
TACGGAGGGTGCAAGCGTTGTCCGGATTTATTGGGTTTAAAGGGTGCGTAGGCGGCTCTATAAGTCCGTGGTGAAAGCCAACAGCTCAACTGTTGAACTGCCATGGATACTGTAGGGCTTGAGTACAGACGAGGTAGGCGGAATGGATGC	TACGGAGGGTGCAAGCGTTGTCCGGATTTATTGGGTTTAAAGGGTGCGTAGGCGGCTCTATAAGTCCGTGGTGAAAGCCAACAGCTCAACTGTTGAACTGCCATGGATACTGTAGGGCTTGAGTACAGACGAGGTAGGCGGAATGGATGC	0.0
TACGGAGGGTGCAAGCGTTGTCCGGATTTATTGGGTTTAAAGGGTGCGTAGGCGGCTTAATAAGTCCGTGGTGAAAGCCAACAGCTCAACTGTTGAACTGCCATGGATACTGTTAGGCTTGAGTACAGACGAGGTAGGCGGAATGGATCG	TACGGAGGGTGCAAGCGTTGTCCGGATTTATTGGGTTTAAAGGGTGCGTAGGCGGCTTAATAAGTCCGTGGTGAAAGCCAACAGCTCAACTGTTGAACTGCCATGGATACTGTTAGGCTTGAGTACAGACGAGGTAGGCGGAATGGATCG	0.0
TACGGAGGGTGCAAGCGTTGTCCGGATTTATTGGGTTTAAAGGGTGCGTAGGCGGCTTAATAAGTCCGTGGTGAAATCCAACAGCTCAACTGTTGAACTGCCATGGATACTGTTAGGCTTGAGTACAGACGAGGTAGGCGGAATGGATAG	TACGGAGGGTGCAAGCGTTGTCCGGATTTATTGGGTTTAAAGGGTGCGTAGGCGGCTTAATAAGTCCGTGGTGAAATCCAACAGCTCAACTGTTGAACTGCCATGGATACTGTTAGGCTTGAGTACAGACGAGGTAGGCGGAATGGATAG	0.0
TACGGAGGGTGCAAGCGTTGTCCGGATTTATTGGGTTTAAAGGGTGCGTAGGCGGCTTAGTAAGTCCGTGGTGAAAGCCAACAGCTCAACTGTTGAACTGCCATGGATACTGCTAGGCTTGAGTACAGACGAGGTAGGCGGAATTGATGG	TACGGAGGGTGCAAGCGTTGTCCGGATTTATTGGGTTTAAAGGGTGCGTAGGCGGCTTAGTAAGTCCGTGGTGAAAGCCAACAGCTCAACTGTTGAACTGCCATGGATACTGCTAGGCTTGAGTACAGACGAGGTAGGCGGAATTGATGG	0.0
TACGGAGGGTGCAAGCGTTGTCCGGATTTATTGGGTTTAAAGGGTGCGTAGGCGGCTTAGTAAGTCCGTGGTGAAATCCAACAGCTCAACTGTTGAACTGCCATGGATACTGCTAGGCTTGAGTACAGACGAGGTAGGCGGAATGGATAG	TACGGAGGGTGCAAGCGTTGTCCGGATTTATTGGGTTTAAAGGGTGCGTAGGCGGCTTAGTAAGTCCGTGGTGAAATCCAACAGCTCAACTGTTGAACTGCCATGGATACTGCTAGGCTTGAGTACAGACGAGGTAGGCGGAATGGATAG	0.0
TACGGAGGGTGCAAGCGTTGTCCGGATTTATTGGGTTTAAAGGGTGCGTAGGCGGCTTATTAAGTCAGGGGTGAAAGACTATTGCTTAACAATGGCAGTGCCTTTGATACTGATAAGCTTGAGTACAGCTGAGGCAGATGGAACGGGTGG	TACGGAGGGTGCAAGCGTTGTCCGGATTTATTGGGTTTAAAGGGTGCGTAGGCGGCTTATTAAGTCAGGGGTGAAAGACTATTGCTTAACAATGGCAGTGCCTTTGATACTGATAAGCTTGAGTACAGCTGAGGCAGATGGAACGGGTGG	0.0
TACGGAGGGTGCAAGCGTTGTCCGGATTTATTGGGTTTAAAGGGTGCGTAGGCGGCTTATTAAGTCAGGGGTGAAAGACTATTGCTTAACAATGGCAGTGCCTTTGATACTGATAGGCTTGAGTACAGTTGAGGCAGATGGAACGGGTGG	TACGGAGGGTGCAAGCGTTGTCCGGATTTATTGGGTTTAAAGGGTGCGTAGGCGGCTTATTAAGTCAGGGGTGAAAGACTATTGCTTAACAATGGCAGTGCCTTTGATACTGATAGGCTTGAGTACAGTTGAGGCAGATGGAACGGGTGG	0.0
TACGGAGGGTGCAAGCGTTGTCCGGATTTATTGGGTTTAAAGGGTGCGTAGGCGGCTTATTAAGTCAGGGGTGAAAGACTATTGCTTAACAATGGCAGTGCCTTTGATACTGATGAGCTTGAGTGTAGCTGAGGCAGATGGAACGGGTGG	TACGGAGGGTGCAAGCGTTGTCCGGATTTATTGGGTTTAAAGGGTGCGTAGGCGGCTTATTAAGTCAGGGGTGAAAGACTATTGCTTAACAATGGCAGTGCCTTTGATACTGATGAGCTTGAGTGTAGCTGAGGCAGATGGAACGGGTGG	0.0
TACGGAGGGTGCAAGCGTTGTCCGGATTTATTGGGTTTAAAGGGTGCGTAGGCGGCTTATTAAGTCAGTGGTGAAATCCAACAGCTCAACTGTTGAACTGCCATTGATACTGATAGGCTTGAGTACAGACGAGGTAGGCGGAATTGATGG	TACGGAGGGTGCAAGCGTTGTCCGGATTTATTGGGTTTAAAGGGTGCGTAGGCGGCTTATTAAGTCAGTGGTGAAATCCAACAGCTCAACTGTTGAACTGCCATTGATACTGATAGGCTTGAGTACAGACGAGGTAGGCGGAATTGATGG	0.0
TACGGAGGGTGCAAGCGTTGTCCGGATTTATTGGGTTTAAAGGGTGCGTAGGCGGCTTATTAAGTCAGTGGTGAAATCCAGCAGCTCAACTGTTGAACTGCCATTGATACTGATAGGCTTGAGTACAGACGAGGTAGGCGGAATTGATGG	TACGGAGGGTGCAAGCGTTGTCCGGATTTATTGGGTTTAAAGGGTGCGTAGGCGGCTTATTAAGTCAGTGGTGAAATCCAGCAGCTCAACTGTTGAACTGCCATTGATACTGATAGGCTTGAGTACAGACGAGGTAGGCGGAATTGATGG	0.0
TACGGAGGGTGCAAGCGTTGTCCGGATTTATTGGGTTTAAAGGGTGCGTAGGCGGCTTGATAAGTCCGTGGTGAAAGCCAACAGCTCAACTGTTGAACTGCCATGGATACTGTCAGGCTTGAGTACAGACGAGGTAGGCGGAATGGATCG	TACGGAGGGTGCAAGCGTTGTCCGGATTTATTGGGTTTAAAGGGTGCGTAGGCGGCTTGATAAGTCCGTGGTGAAAGCCAACAGCTCAACTGTTGAACTGCCATGGATACTGTCAGGCTTGAGTACAGACGAGGTAGGCGGAATGGATCG	0.0
TACGGAGGGTGCAAGCGTTGTCCGGATTTATTGGGTTTAAAGGGTGCGTAGGCGGCTTGTTAAGTCAGGGGTGAAAGACTGCAGCTCAACTGTAGCAGTGCCTTTGATACTGATGAGCTTGAGTATAGATGAGGCCGGCGGAATGGGTGG	TACGGAGGGTGCAAGCGTTGTCCGGATTTATTGGGTTTAAAGGGTGCGTAGGCGGCTTGTTAAGTCAGGGGTGAAAGACTGCAGCTCAACTGTAGCAGTGCCTTTGATACTGATGAGCTTGAGTATAGATGAGGCCGGCGGAATGGGTGG	0.0
TACGGAGGGTGCAAGCGTTGTCCGGATTTATTGGGTTTAAAGGGTGCGTAGGCGGCTTTATAAGTCCGTGGTGAAATCCAACAGCTCAACTGTTGAACTGCCATGGATACTGTAAGGCTTGAGTACAGACGAGGTAGGCGGAATGGATGG	TACGGAGGGTGCAAGCGTTGTCCGGATTTATTGGGTTTAAAGGGTGCGTAGGCGGCTTTATAAGTCCGTGGTGAAATCCAACAGCTCAACTGTTGAACTGCCATGGATACTGTAAGGCTTGAGTACAGACGAGGTAGGCGGAATGGATGG	0.0
TACGGAGGGTGCAAGCGTTGTCCGGATTTATTGGGTTTAAAGGGTGCGTAGGCGGGTTAATAAGTCAGTGGTGAAAGCCGGCAGCTCAACTGTCGAATTGCCATTGATACTGTTAGCCTTGAGTATAGTTGAGGTAGGCGGAATGGAAGG	TACGGAGGGTGCAAGCGTTGTCCGGATTTATTGGGTTTAAAGGGTGCGTAGGCGGGTTAATAAGTCAGTGGTGAAAGCCGGCAGCTCAACTGTCGAATTGCCATTGATACTGTTAGCCTTGAGTATAGTTGAGGTAGGCGGAATGGAAGG	0.0
TACGGAGGGTGCAAGCGTTGTCCGGATTTATTGGGTTTAAAGGGTGCGTAGGTGGCTTGTTAAGTCCGGGGTGAAAGCCCACAGCTCAACTGTGGAACTGCCCTGGATACTGGCAAGCTTGAGAGTAGTCGAGGGTGGCGGAATGGACGG	TACGGAGGGTGCAAGCGTTGTCCGGATTTATTGGGTTTAAAGGGTGCGTAGGTGGCTTGTTAAGTCCGGGGTGAAAGCCCACAGCTCAACTGTGGAACTGCCCTGGATACTGGCAAGCTTGAGAGTAGTCGAGGGTGGCGGAATGGACGG	0.0
TACGGAGGGTGCAAGCGTTGTTCGGAATTATTGGGCGTAAAGCGCACGTAGGCGGCTCTTTAAGTCTCGCTGTGAAAGCCTGCGGCTCAACCGCAGGAGGCCAGGGGATACTGGAGAGCTGGAGATAGGTAGAGGCGAGCGGAATTCCGG	TACGGAGGGTGCAAGCGTTGTTCGGAATTATTGGGCGTAAAGCGCACGTAGGCGGCTCTTTAAGTCTCGCTGTGAAAGCCTGCGGCTCAACCGCAGGAGGCCAGGGGATACTGGAGAGCTGGAGATAGGTAGAGGCGAGCGGAATTCCGG	0.0
TACGGAGGGTGCGAGCGTTAATCGGAATTACTGGGCGTAAAGCGCGCGTAGGCGGTTGAGCAAGTCGGATGTGAAAGCCCTGGGCTTAACCTGGGAATTGCATTCGAGACTGCTCGGCTAGAGTTTGGTAGAGGAAAGCGGAATTCCGGG	TACGGAGGGTGCGAGCGTTAATCGGAATTACTGGGCGTAAAGCGCGCGTAGGCGGTTGAGCAAGTCGGATGTGAAAGCCCTGGGCTTAACCTGGGAATTGCATTCGAGACTGCTCGGCTAGAGTTTGGTAGAGGAAAGCGGAATTCCGGG	0.0
TACGGAGGGTGCGAGCGTTACCCGGAATCACTGGGCGTAAAGGGCGCGTAGGCGGCCCGTCGAGTCTGGCCTTAAAGCCCGCGGCTCAACCGCGGACTGGGGCTGGGTACTGGCGGGCTGGACGGCTGGAGGGGCGGGTGGAATTCTCGG	TACGGAGGGTGCGAGCGTTACCCGGAATCACTGGGCGTAAAGGGCGCGTAGGCGGCCCGTCGAGTCTGGCCTTAAAGCCCGCGGCTCAACCGCGGACTGGGGCTGGGTACTGGCGGGCTGGACGGCTGGAGGGGCGGGTGGAATTCTCGG	0.0
TACGGAGGGTGCGAGCGTTATCCGGAATCACTGGGCGTAAAGGGCACGTAGGCGGTCTGCTAAGTCCGATGTTAAAGAGTGGGGCTCAACCCCATCACGGCGTTGGATACTGGCAGGCTTGACGACTGGAGAGGAAAGTAGAATTACCAG	TACGGAGGGTGCGAGCGTTATCCGGAATCACTGGGCGTAAAGGGCACGTAGGCGGTCTGCTAAGTCCGATGTTAAAGAGTGGGGCTCAACCCCATCACGGCGTTGGATACTGGCAGGCTTGACGACTGGAGAGGAAAGTAGAATTACCAG	0.0
TACGGAGGGTGCGAGCGTTATCCGGAATCACTGGGCGTAAAGGGCGCGTAGGCGGTTTGTCAAGTCCGATGTTAAAGACCGGGGCTCAACCCCGACACGGCGTTGGATACTGGCAAGCTTGACGACTGGAGAGGAAGGTAGAATTACCAG	TACGGAGGGTGCGAGCGTTATCCGGAATCACTGGGCGTAAAGGGCGCGTAGGCGGTTTGTCAAGTCCGATGTTAAAGACCGGGGCTCAACCCCGACACGGCGTTGGATACTGGCAAGCTTGACGACTGGAGAGGAAGGTAGAATTACCAG	0.0
TACGGAGGGTGCGAGCGTTATCCGGAATCACTGGGCGTAAAGGGCGCGTAGGCGGTTTGTCAAGTCCGATGTTAAAGCGTGAGGCTCAACCTCATATGAGCGTTGGATACTAGCAAGCTTGACGGTTGGAGAGGAAGGTAGAATTACCAG	TACGGAGGGTGCGAGCGTTATCCGGAATCACTGGGCGTAAAGGGCGCGTAGGCGGTTTGTCAAGTCCGATGTTAAAGCGTGAGGCTCAACCTCATATGAGCGTTGGATACTAGCAAGCTTGACGGTTGGAGAGGAAGGTAGAATTACCAG	0.0
TACGGAGGGTGCGAGCGTTATCCGGAATCACTGGGCGTAAAGGGCGCGTAGGCGGTTTGTCAAGTCCGATGTTAAAGCGTGAGGCTCAACCTCATCACGGCGTTGGATACTAGCAAGCTTGACGGTTGGAGAGGAAGGTAGAATTACCAG	TACGGAGGGTGCGAGCGTTATCCGGAATCACTGGGCGTAAAGGGCGCGTAGGCGGTTTGTCAAGTCCGATGTTAAAGCGTGAGGCTCAACCTCATCACGGCGTTGGATACTAGCAAGCTTGACGGTTGGAGAGGAAGGTAGAATTACCAG	0.0
TACGGAGGGTGCGAGCGTTATCCGGAATCACTGGGCGTAAAGGGCGCGTAGGCGGTTTGTTAAGTCCGATGTCAAAGCGTGAGGCTCAACCTCATAGAGGCGTTGGATACTGGCGAGCTGGACGGTTGGAGAGGAAGGTAGAATTACCAG	TACGGAGGGTGCGAGCGTTATCCGGAATCACTGGGCGTAAAGGGCGCGTAGGCGGTTTGTTAAGTCCGATGTCAAAGCGTGAGGCTCAACCTCATAGAGGCGTTGGATACTGGCGAGCTGGACGGTTGGAGAGGAAGGTAGAATTACCAG	0.0
TACGGAGGGTGCGAGCGTTATCCGGAATCACTGGGCGTAAAGGGCGCGTAGGCGGTTTGTTAAGTCCGATGTTAAAGCGTGAGGCTCAACCTCATATAAGCGTTGGATACTGGCGAGCTGGACGGTTGGAGAGGAAGGTAGAATTACCAG	TACGGAGGGTGCGAGCGTTATCCGGAATCACTGGGCGTAAAGGGCGCGTAGGCGGTTTGTTAAGTCCGATGTTAAAGCGTGAGGCTCAACCTCATATAAGCGTTGGATACTGGCGAGCTGGACGGTTGGAGAGGAAGGTAGAATTACCAG	0.0
TACGGAGGGTGCGAGCGTTATCCGGAATCACTGGGCGTAAAGGGCGCGTAGGCGGTTTGTTAAGTCCGATGTTAAAGCGTGAGGCTCAACCTCATATGAGCGTTGGATACTGGCGAGCTGGACGGTTGGAGAGGAAGGTAGAATTACCAG	TACGGAGGGTGCGAGCGTTATCCGGAATCACTGGGCGTAAAGGGCGCGTAGGCGGTTTGTTAAGTCCGATGTTAAAGCGTGAGGCTCAACCTCATATGAGCGTTGGATACTGGCGAGCTGGACGGTTGGAGAGGAAGGTAGAATTACCAG	0.0
TACGGAGGGTGCGAGCGTTATCCGGATTCACTGGGTTTAAAGGGTGCGTAGGTGGGAATGTAAGTCAGCGGTGAAATCTCTGAGCTTAACTCAGAAACTGCCATTGATACTATGTTTCTTGAATTTTCTGGAGGTCAGCGGAATATGTCA	TACGGAGGGTGCGAGCGTTATCCGGATTCACTGGGTTTAAAGGGTGCGTAGGTGGGAATGTAAGTCAGCGGTGAAATCTCTGAGCTTAACTCAGAAACTGCCATTGATACTATGTTTCTTGAATTTTCTGGAGGTCAGCGGAATATGTCA	0.0
TACGGAGGGTGCGAGCGTTATCCGGATTCACTGGGTTTAAAGGGTGCGTAGGTGGGGAAGTAAGTCAGTGGTGAAATCTCCGTGCTTAACATGGAAACTGCCATTGATACTATTTTTCTTGAATTTTCCGGAGGTTAGCGGAATATGTCA	TACGGAGGGTGCGAGCGTTATCCGGATTCACTGGGTTTAAAGGGTGCGTAGGTGGGGAAGTAAGTCAGTGGTGAAATCTCCGTGCTTAACATGGAAACTGCCATTGATACTATTTTTCTTGAATTTTCCGGAGGTTAGCGGAATATGTCA	0.0
TACGGAGGGTGCGAGCGTTATCCGGATTCACTGGGTTTAAAGGGTGCGTAGGTGGGTTTGTAAGTCAGTGGTGAAATCTCCGTGCTTAACATGGAAACTGCCATTGATACTACAGGTCTTGAATTTTCCGGAGGTTAGCGGAATATGTCA	TACGGAGGGTGCGAGCGTTATCCGGATTCACTGGGTTTAAAGGGTGCGTAGGTGGGTTTGTAAGTCAGTGGTGAAATCTCCGTGCTTAACATGGAAACTGCCATTGATACTACAGGTCTTGAATTTTCCGGAGGTTAGCGGAATATGTCA	0.0
TACGGAGGGTGCGAGCGTTGTCCGGAATCACTGGGCGTAAAGGGCGCGTAGGCGGCCCGGTAAGTCTGCGGTGAAAGCCCGGGGCTCAACCCCGGGTCGGCCGTGGGTACTGCGGGGCTCGAGCACTGTAGGGGCAGGCGGAATTCCGGG	TACGGAGGGTGCGAGCGTTGTCCGGAATCACTGGGCGTAAAGGGCGCGTAGGCGGCCCGGTAAGTCTGCGGTGAAAGCCCGGGGCTCAACCCCGGGTCGGCCGTGGGTACTGCGGGGCTCGAGCACTGTAGGGGCAGGCGGAATTCCGGG	0.0
TACGGAGGGTGCGAGCGTTGTCCGGAATCACTGGGCGTAAAGGGCGCGTAGGCGGCCTGATAAGTAGGGGGTGAAATCCTGCGGCTTAACCGCAGGGCTGCCTTCTAAACTGTCAGGCTCGAGCACAGTAGAGGCAGGTGGAATTCCCGG	TACGGAGGGTGCGAGCGTTGTCCGGAATCACTGGGCGTAAAGGGCGCGTAGGCGGCCTGATAAGTAGGGGGTGAAATCCTGCGGCTTAACCGCAGGGCTGCCTTCTAAACTGTCAGGCTCGAGCACAGTAGAGGCAGGTGGAATTCCCGG	0.0
TACGGAGGGTGCGAGCGTTGTCCGGAATCACTGGGCGTAAAGGGCGCGTAGGCGGCCTGATAAGTAGGGGGTGAAATCTTGCGGCTTAACCGCAAGGCTGCCTTCTAAACTGTCGGGCTCGAGCACAGTAGAGGCAGGTGGAATTCCCGG	TACGGAGGGTGCGAGCGTTGTCCGGAATCACTGGGCGTAAAGGGCGCGTAGGCGGCCTGATAAGTAGGGGGTGAAATCTTGCGGCTTAACCGCAAGGCTGCCTTCTAAACTGTCGGGCTCGAGCACAGTAGAGGCAGGTGGAATTCCCGG	0.0
TACGGAGGGTGCGAGCGTTGTCCGGAATCACTGGGCGTAAAGGGCGCGTAGGCGGCGCGGCAAGCGTGCGGTGAAAGCCCGGGGCTCAACCCCGGGTCGGCCGTGCGGACTGCCGGGCTCGAGCACTGTAGGGGCAGGCGGAATTCCGGG	TACGGAGGGTGCGAGCGTTGTCCGGAATCACTGGGCGTAAAGGGCGCGTAGGCGGCGCGGCAAGCGTGCGGTGAAAGCCCGGGGCTCAACCCCGGGTCGGCCGTGCGGACTGCCGGGCTCGAGCACTGTAGGGGCAGGCGGAATTCCGGG	0.0
TACGGAGGGTGCGAGCGTTGTCCGGAATCACTGGGCGTAAAGGGCGCGTAGGCGGCGCGGGAAGCGTGCGGTGAAAGCCCGGGGCTCAACCCCGGGTCGGCCGTGCGAACTCCCGGGCTCGAGCACTGTAGGGGCAGGCGGAATTCCGGG	TACGGAGGGTGCGAGCGTTGTCCGGAATCACTGGGCGTAAAGGGCGCGTAGGCGGCGCGGGAAGCGTGCGGTGAAAGCCCGGGGCTCAACCCCGGGTCGGCCGTGCGAACTCCCGGGCTCGAGCACTGTAGGGGCAGGCGGAATTCCGGG	0.0
TACGGAGGGTGCGAGCGTTGTCCGGAATCACTGGGCGTAAAGGGCGCGTAGGCGGCGGGCCAAGCGTGCGGTGAAAGCCCGGGGCTCAACCCCGGGTCGGCCGTGCGGACTGGTCGGCTGGAGCACTGTAGGGGCAGGCGGAATTCCGGG	TACGGAGGGTGCGAGCGTTGTCCGGAATCACTGGGCGTAAAGGGCGCGTAGGCGGCGGGCCAAGCGTGCGGTGAAAGCCCGGGGCTCAACCCCGGGTCGGCCGTGCGGACTGGTCGGCTGGAGCACTGTAGGGGCAGGCGGAATTCCGGG	0.0
TACGGAGGGTGCGAGCGTTGTCCGGAATCACTGGGCGTAAAGGGCGCGTAGGCGGCTTCTTAAGCGTGTGGTGAAAGCTCGGGGCTCAACCCCGAGTCGGCCGTGCGAACTGGGAAGCTTGAGCACTGTAGAGGCAGGTGGAATTCCGGG	TACGGAGGGTGCGAGCGTTGTCCGGAATCACTGGGCGTAAAGGGCGCGTAGGCGGCTTCTTAAGCGTGTGGTGAAAGCTCGGGGCTCAACCCCGAGTCGGCCGTGCGAACTGGGAAGCTTGAGCACTGTAGAGGCAGGTGGAATTCCGGG	0.0
TACGGAGGGTGCGAGCGTTGTCCGGAATCACTGGGCGTAAAGGGCGCGTAGGCGGTCTGCTAAGCGTGCGGTGAAAGCCTGGGGCTCAACCCCAGGTCGGCCGTGCGAACTGGTGGACTAGAGCACTGTAGAGGCAGGTGGAATTCCGGG	TACGGAGGGTGCGAGCGTTGTCCGGAATCACTGGGCGTAAAGGGCGCGTAGGCGGTCTGCTAAGCGTGCGGTGAAAGCCTGGGGCTCAACCCCAGGTCGGCCGTGCGAACTGGTGGACTAGAGCACTGTAGAGGCAGGTGGAATTCCGGG	0.0
TACGGAGGGTGCGAGCGTTGTCCGGAATCACTGGGCGTAAAGGGCGCGTAGGCGGTGGCTTAAGCGTGTGGTGAAAGTCCGGGGCTCAACCCCGGATCGGCCGTGCGAACTGGGTCACTTGAGCACTGTAGAGGCAGGTGGAATTCCGGG	TACGGAGGGTGCGAGCGTTGTCCGGAATCACTGGGCGTAAAGGGCGCGTAGGCGGTGGCTTAAGCGTGTGGTGAAAGTCCGGGGCTCAACCCCGGATCGGCCGTGCGAACTGGGTCACTTGAGCACTGTAGAGGCAGGTGGAATTCCGGG	0.0
TACGGAGGGTGCGAGCGTTGTCCGGAATCACTGGGCGTAAAGGGCGCGTAGGCGGTGGGGTAAGCGTGTGGTGAAAGTCCGGGGCTCAACCCCGGATCGGCCGTGCGAACTGCTTCACTTGAGCACTGTAGAGGCAGGTGGAATTCCGGG	TACGGAGGGTGCGAGCGTTGTCCGGAATCACTGGGCGTAAAGGGCGCGTAGGCGGTGGGGTAAGCGTGTGGTGAAAGTCCGGGGCTCAACCCCGGATCGGCCGTGCGAACTGCTTCACTTGAGCACTGTAGAGGCAGGTGGAATTCCGGG	0.0
TACGGAGGGTGCGAGCGTTGTCCGGAATCACTGGGCGTAAAGGGCGCGTAGGTGGCGCGGTGAGTCGGTGGTGAAAGCTCGGGGCTCAACCCCGAGTCGGCCATCGATACTGCCGGGCTCGAGCATCGTAGAGGCAGGTGGAATTCCGGG	TACGGAGGGTGCGAGCGTTGTCCGGAATCACTGGGCGTAAAGGGCGCGTAGGTGGCGCGGTGAGTCGGTGGTGAAAGCTCGGGGCTCAACCCCGAGTCGGCCATCGATACTGCCGGGCTCGAGCATCGTAGAGGCAGGTGGAATTCCGGG	0.0
TACGGAGGGTGCGAGCGTTGTCCGGATTTATTGGGTTTAAAGGGTGCGTAGGCGGCCCGTTAAGTCAGCGGTGAAATCCCACGGCTCAACCGTGGAACTGCCGTTGATACTGGCGGGCTTGAGTACAGACGAGGCAGGCGGAATTGATGG	TACGGAGGGTGCGAGCGTTGTCCGGATTTATTGGGTTTAAAGGGTGCGTAGGCGGCCCGTTAAGTCAGCGGTGAAATCCCACGGCTCAACCGTGGAACTGCCGTTGATACTGGCGGGCTTGAGTACAGACGAGGCAGGCGGAATTGATGG	0.0
TACGGAGGGTGCGAGCGTTGTTCGGAATTACTGGGCGTAAAGGGCGCGTAGGCGGCCGTTTAAGTCTACCTGTGAAAGGCCGGGGCTCAACCCCGTGCTGGCAGGAGATACTGGGCGGCTGGAGACACGCAGAGGCAGGTGGAATTCCGG	TACGGAGGGTGCGAGCGTTGTTCGGAATTACTGGGCGTAAAGGGCGCGTAGGCGGCCGTTTAAGTCTACCTGTGAAAGGCCGGGGCTCAACCCCGTGCTGGCAGGAGATACTGGGCGGCTGGAGACACGCAGAGGCAGGTGGAATTCCGG	0.0
TACGGAGGGTGCGAGCGTTGTTCGGAATTACTGGGCGTAAAGGGCGCGTAGGCGGCTTTTTAAGTCCACGGGTGAAAGGCCGGGGCTCAACCCCGTGCTGGCCCGGGATACTGGGGAGCTGGAGACAGGCAGAGGCGGGTGGAATTCCGG	TACGGAGGGTGCGAGCGTTGTTCGGAATTACTGGGCGTAAAGGGCGCGTAGGCGGCTTTTTAAGTCCACGGGTGAAAGGCCGGGGCTCAACCCCGTGCTGGCCCGGGATACTGGGGAGCTGGAGACAGGCAGAGGCGGGTGGAATTCCGG	0.0
TACGGGGGGAGCAAGCGTTGTTCGGATTTACTGGGCGTAAAGGGTGCGTAGGCGGCACCACAAGTCACTTGTGAAATCTTTGGGCTTAACCCAAAGCGGCCAAGTGATACTGTGGAGCTAGAGTGCAGAAGGGGCAACTGGAATTCTCGG	TACGGGGGGAGCAAGCGTTGTTCGGATTTACTGGGCGTAAAGGGTGCGTAGGCGGCACCACAAGTCACTTGTGAAATCTTTGGGCTTAACCCAAAGCGGCCAAGTGATACTGTGGAGCTAGAGTGCAGAAGGGGCAACTGGAATTCTCGG	0.0
TACGTAGGAGGCGAGCGTTGTCCGGAGTTACTGGGCGTAAAGCGCGCGCAGGCGGGCGCCAGGGTCTCCCGTGAAAGCCCCCAGCTCAACTGGGGAGGGTCGGGGGAAACCGGGCGCCTGGAGGCTGGGAGAGGCCGGTGGAATTCGGGG	TACGTAGGAGGCGAGCGTTGTCCGGAGTTACTGGGCGTAAAGCGCGCGCAGGCGGGCGCCAGGGTCTCCCGTGAAAGCCCCCAGCTCAACTGGGGAGGGTCGGGGGAAACCGGGCGCCTGGAGGCTGGGAGAGGCCGGTGGAATTCGGGG	0.0
TACGTAGGCAGCGAGCGTTGTTCGGAGTTACTGGGCGTAAAGAGTGCGTAGGCGGTTGTCTAAGTTTGGTGTGAAATCTCCCGGCTTAACCGGGAGGGTGCGCCGAAGACTGGAGAGCTGGAGTATGGGAGAGGTAAGCGGAATTCCTGG	TACGTAGGCAGCGAGCGTTGTTCGGAGTTACTGGGCGTAAAGAGTGCGTAGGCGGTTGTCTAAGTTTGGTGTGAAATCTCCCGGCTTAACCGGGAGGGTGCGCCGAAGACTGGAGAGCTGGAGTATGGGAGAGGTAAGCGGAATTCCTGG	0.0
TACGTAGGCAGCGAGCGTTGTTCGGAGTTACTGGGCGTAAAGAGTGCGTAGGCGGTTTTCTAAGTTTGGTGTGAAATCTCCCGGCTCAACTGGGAGGGTGCGCCGAAGACTGGGAGGCTAGAGTATGGGAGAGGTAAGCGGAATTCCTGG	TACGTAGGCAGCGAGCGTTGTTCGGAGTTACTGGGCGTAAAGAGTGCGTAGGCGGTTTTCTAAGTTTGGTGTGAAATCTCCCGGCTCAACTGGGAGGGTGCGCCGAAGACTGGGAGGCTAGAGTATGGGAGAGGTAAGCGGAATTCCTGG	0.0
TACGTAGGCAGCGAGCGTTGTTCGGAGTTACTGGGCGTAAAGAGTGCGTAGGCGGTTTTCTAAGTTTGGTGTGAAATCTCCCGGCTTAACTGGGAGGGTGCGCCGAAGACTGGAAGGCTTGAGTATGGGAGAGGTAAGCGGAATTCCTGG	TACGTAGGCAGCGAGCGTTGTTCGGAGTTACTGGGCGTAAAGAGTGCGTAGGCGGTTTTCTAAGTTTGGTGTGAAATCTCCCGGCTTAACTGGGAGGGTGCGCCGAAGACTGGAAGGCTTGAGTATGGGAGAGGTAAGCGGAATTCCTGG	0.0
TACGTAGGGACCAAGCGTTGTTCGGATTTACTGGGCGTAAAGGGCGCGTAGGCGGCGTGTCAAGTCAATTGTGAAATCTCCGAGCTTAACTCGGAACGGTCAATTGATACTGATGTGCTAGAGTGCAGAAGGGGCAATCGGAATTCTTGG	TACGTAGGGACCAAGCGTTGTTCGGATTTACTGGGCGTAAAGGGCGCGTAGGCGGCGTGTCAAGTCAATTGTGAAATCTCCGAGCTTAACTCGGAACGGTCAATTGATACTGATGTGCTAGAGTGCAGAAGGGGCAATCGGAATTCTTGG	0.0
TACGTAGGGAGCAAGCGTTGTCCGGATTTATTGGGCGTAAAGAGCTCGTAGGCGGTTCGGTAAGTCGGGTGTGAAAACTCTGGGCTCAACCCGGAGAGGCCACTCGATACTGCCGTGACTTGAGTCTGGTAGGGGAGCACGGAATTCCTG	TACGTAGGGAGCAAGCGTTGTCCGGATTTATTGGGCGTAAAGAGCTCGTAGGCGGTTCGGTAAGTCGGGTGTGAAAACTCTGGGCTCAACCCGGAGAGGCCACTCGATACTGCCGTGACTTGAGTCTGGTAGGGGAGCACGGAATTCCTG	0.0
TACGTAGGGCCCGAGCGTTGTCCGGAGTTACTGGGCGTAAAGCGCGCGCAGGCGGCTCACTAAGCCCGGCGTGAAAGCCCCCGGCTCAACCGGGGAGGGTCGTCGGGGACTGGTGGGCTTGAGGGCGGCAGGGGCAGGTGGAATTCCCGG	TACGTAGGGCCCGAGCGTTGTCCGGAGTTACTGGGCGTAAAGCGCGCGCAGGCGGCTCACTAAGCCCGGCGTGAAAGCCCCCGGCTCAACCGGGGAGGGTCGTCGGGGACTGGTGGGCTTGAGGGCGGCAGGGGCAGGTGGAATTCCCGG	0.0
TACGTAGGGCCCGAGCGTTGTCCGGAGTTACTGGGCGTAAAGCGCGCGCAGGCGGCTGGCTAAGCCCGGCGTGAAAGCCCCCGGCTCAACCGGGGAGGGTCGTCGGGGACTGGTCGGCTTGAGGGCGGCAGGGGCAGGTGGAATTCCCGG	TACGTAGGGCCCGAGCGTTGTCCGGAGTTACTGGGCGTAAAGCGCGCGCAGGCGGCTGGCTAAGCCCGGCGTGAAAGCCCCCGGCTCAACCGGGGAGGGTCGTCGGGGACTGGTCGGCTTGAGGGCGGCAGGGGCAGGTGGAATTCCCGG	0.0
TACGTAGGGCGCAAGCGTTATCCGGAATTATTGGGCGTAAAGAGCTCGTAGGCGGTTTGTCGCGTCTGCCGTGAAAGTCCGGGGCTCAACTCCGGATCTGCGGTGGGTACGGGCAGACTAGAGTGATGTAGGGGAGACTGGAATTCCTGG	TACGTAGGGCGCAAGCGTTATCCGGAATTATTGGGCGTAAAGAGCTCGTAGGCGGTTTGTCGCGTCTGCCGTGAAAGTCCGGGGCTCAACTCCGGATCTGCGGTGGGTACGGGCAGACTAGAGTGATGTAGGGGAGACTGGAATTCCTGG	0.0
TACGTAGGGCGCAAGCGTTATCCGGAATTATTGGGCGTAAAGAGCTCGTAGGCGGTTTGTCGCGTCTGCCGTGAAAGTCCGGGGCTTAACCCCGGATCTGCGGTGGGTACGGGCAGACTAGAGTGCAGTAGGGGAGACTGGAATTCCTGG	TACGTAGGGCGCAAGCGTTATCCGGAATTATTGGGCGTAAAGAGCTCGTAGGCGGTTTGTCGCGTCTGCCGTGAAAGTCCGGGGCTTAACCCCGGATCTGCGGTGGGTACGGGCAGACTAGAGTGCAGTAGGGGAGACTGGAATTCCTGG	0.0
TACGTAGGGCGCAAGCGTTATCCGGAATTATTGGGCGTAAAGAGCTCGTAGGCGGTTTGTCGCGTCTGCCGTGAAAGTCCGGGGCTTAACTCCGGATCTGCGGTGGGTACGGGCAGACTAGAGTGCAGTAGGGGAGACTGGAATTCCTGG	TACGTAGGGCGCAAGCGTTATCCGGAATTATTGGGCGTAAAGAGCTCGTAGGCGGTTTGTCGCGTCTGCCGTGAAAGTCCGGGGCTTAACTCCGGATCTGCGGTGGGTACGGGCAGACTAGAGTGCAGTAGGGGAGACTGGAATTCCTGG	0.0
TACGTAGGGCGCAAGCGTTGTCCGGAATTATTGGGCGTAAAGAGCTCGTAGGCGGCTTGTCACGTCGGATGTGAAAGCCCGGGGCTTAACCCCGGGTCTGCATTCGATACGGGCAGGCTAGAGTGTGGTAGGGGAGATCGGAATTCCTGG	TACGTAGGGCGCAAGCGTTGTCCGGAATTATTGGGCGTAAAGAGCTCGTAGGCGGCTTGTCACGTCGGATGTGAAAGCCCGGGGCTTAACCCCGGGTCTGCATTCGATACGGGCAGGCTAGAGTGTGGTAGGGGAGATCGGAATTCCTGG	0.0
TACGTAGGGCGCAAGCGTTGTCCGGAATTATTGGGCGTAAAGAGCTCGTAGGCGGTCTGTCGCGTCTGGTGTGAAATCCCATGGCTCAACTGTGGGCTTGCATCGGGTACGGGCAGACTAGAGTGCTGTAGGGGAGACTGGAATTCCTGG	TACGTAGGGCGCAAGCGTTGTCCGGAATTATTGGGCGTAAAGAGCTCGTAGGCGGTCTGTCGCGTCTGGTGTGAAATCCCATGGCTCAACTGTGGGCTTGCATCGGGTACGGGCAGACTAGAGTGCTGTAGGGGAGACTGGAATTCCTGG	0.0
TACGTAGGGCGCAAGCGTTGTCCGGAATTATTGGGCGTAAAGAGCTCGTAGGCGGTTTGTCGCGTCTGCTGTGAAAACCCGAGGCTCAACCTCGGGCCTGCAGTGGGTACGGGCAGACTAGAGTGCGGTAGGGGAGACTGGAATTCCTGG	TACGTAGGGCGCAAGCGTTGTCCGGAATTATTGGGCGTAAAGAGCTCGTAGGCGGTTTGTCGCGTCTGCTGTGAAAACCCGAGGCTCAACCTCGGGCCTGCAGTGGGTACGGGCAGACTAGAGTGCGGTAGGGGAGACTGGAATTCCTGG	0.0
TACGTAGGGCGCAAGCGTTGTCCGGAATTATTGGGCGTAAAGAGCTCGTAGGCGGTTTGTCGCGTCTGCTGTGAAAACCTAAGGCTCAACCTTGGGCTTGCAGTGGGTACGGGCAGACTAGAGTGCGGTAGGGGTGACTGGAATTCCTGG	TACGTAGGGCGCAAGCGTTGTCCGGAATTATTGGGCGTAAAGAGCTCGTAGGCGGTTTGTCGCGTCTGCTGTGAAAACCTAAGGCTCAACCTTGGGCTTGCAGTGGGTACGGGCAGACTAGAGTGCGGTAGGGGTGACTGGAATTCCTGG	0.0
TACGTAGGGCGCAAGCGTTGTCCGGAATTATTGGGCGTAAAGAGCTCGTAGGCGGTTTGTCGCGTCTGCTGTGAAAACCTCAGGCTCAACCTGGGGCTTGCAGTGGGTACGGGCAGACTAGAGTGCGGTAGGGGTGACTGGAATTCCTGG	TACGTAGGGCGCAAGCGTTGTCCGGAATTATTGGGCGTAAAGAGCTCGTAGGCGGTTTGTCGCGTCTGCTGTGAAAACCTCAGGCTCAACCTGGGGCTTGCAGTGGGTACGGGCAGACTAGAGTGCGGTAGGGGTGACTGGAATTCCTGG	0.0
TACGTAGGGCGCAAGCGTTGTCCGGAATTATTGGGCGTAAAGAGCTCGTAGGCGGTTTGTCGCGTCTGCTGTGAAAACTTCAGGCTCAACCTGGGGCTTGCAGTGGGTACGGGCAGACTAGAGTGCGGTAGGGGTGACTGGAATTCCTGG	TACGTAGGGCGCAAGCGTTGTCCGGAATTATTGGGCGTAAAGAGCTCGTAGGCGGTTTGTCGCGTCTGCTGTGAAAACTTCAGGCTCAACCTGGGGCTTGCAGTGGGTACGGGCAGACTAGAGTGCGGTAGGGGTGACTGGAATTCCTGG	0.0
TACGTAGGGGCCGAGCGTTGTCCGGAATTACTGGGCGTGAAGCGCGCGCAGGCGGCCCTCTGCGCCCGGCGTGAAAGCCCCCGGCTCAACCGGGGAGCGTCGTCGGGGACGGGAGGGCTTGAGGGCGAGAGGGGCCGGTGGAATCCCTGG	TACGTAGGGGCCGAGCGTTGTCCGGAATTACTGGGCGTGAAGCGCGCGCAGGCGGCCCTCTGCGCCCGGCGTGAAAGCCCCCGGCTCAACCGGGGAGCGTCGTCGGGGACGGGAGGGCTTGAGGGCGAGAGGGGCCGGTGGAATCCCTGG	0.0
TACGTAGGGGCCGAGCGTTGTCCGGAGTTACTGGGCGTAAAGCGCGCGCAGGCGGCCCGCTGCGCCCGGCGTGAAAGCCCCCGGCTCAACCGGGGAACGGCGTCGGGGACGGGCGGGCTTGAGGGCGGCAGGGGCTGGTGGAATGCCCGG	TACGTAGGGGCCGAGCGTTGTCCGGAGTTACTGGGCGTAAAGCGCGCGCAGGCGGCCCGCTGCGCCCGGCGTGAAAGCCCCCGGCTCAACCGGGGAACGGCGTCGGGGACGGGCGGGCTTGAGGGCGGCAGGGGCTGGTGGAATGCCCGG	0.0
TACGTAGGGGGCAAGCGTTGTCCGGAATCACTGGGCGTAAAGCGCGCGCAGGCGGCTGTCTACGTCCGGGGTGAAAGCCCAGAGCTCAACTCTGGGATTGCCTTGGATACGGGATGGCTTGAGGATCGGAGAGGCAAGGGGAATTCCACG	TACGTAGGGGGCAAGCGTTGTCCGGAATCACTGGGCGTAAAGCGCGCGCAGGCGGCTGTCTACGTCCGGGGTGAAAGCCCAGAGCTCAACTCTGGGATTGCCTTGGATACGGGATGGCTTGAGGATCGGAGAGGCAAGGGGAATTCCACG	0.0
TACGTAGGGGGCAAGCGTTGTCCGGAATCATTGGGCGTAAAGAGCGCGTAGGCGGTCCGATAAGTCTGCCGTGAAAGCCAAGGGCTCAACCCTTGGATGCCGGTGGATACTGTCGGGCTAGAGTCCGGAAGAGGCGAGTGGAATTCCTGG	TACGTAGGGGGCAAGCGTTGTCCGGAATCATTGGGCGTAAAGAGCGCGTAGGCGGTCCGATAAGTCTGCCGTGAAAGCCAAGGGCTCAACCCTTGGATGCCGGTGGATACTGTCGGGCTAGAGTCCGGAAGAGGCGAGTGGAATTCCTGG	0.0
TACGTAGGGGGCAAGCGTTGTCCGGAATCATTGGGCGTAAAGAGCGCGTAGGCGGTCCGGTAAGTCTGCCGTGAAAGCCAGGGGCTCAACCCTTGGATGCCGGTGGATACTGTCGGGCTAGAGTCCGGAAGAGGCGAGTGGAATTCCTGG	TACGTAGGGGGCAAGCGTTGTCCGGAATCATTGGGCGTAAAGAGCGCGTAGGCGGTCCGGTAAGTCTGCCGTGAAAGCCAGGGGCTCAACCCTTGGATGCCGGTGGATACTGTCGGGCTAGAGTCCGGAAGAGGCGAGTGGAATTCCTGG	0.0
TACGTAGGGGGCAAGCGTTGTCCGGAATCATTGGGCGTAAAGAGCGTGTAGGCGGCCCGATAAGTCCGCTGTGAAAGTCCAGGGCTCAACCCTGGAATGCCGGTGGATACTGTCGGGCTCGAATCCGGAAGAGGTGAGTGGAATTCCTGG	TACGTAGGGGGCAAGCGTTGTCCGGAATCATTGGGCGTAAAGAGCGTGTAGGCGGCCCGATAAGTCCGCTGTGAAAGTCCAGGGCTCAACCCTGGAATGCCGGTGGATACTGTCGGGCTCGAATCCGGAAGAGGTGAGTGGAATTCCTGG	0.0
TACGTAGGGGGCAAGCGTTGTCCGGAATCATTGGGCGTAAAGAGCGTGTAGGCGGCCCGGTAAGTCCGCTGTGAAAGTCAGGGGCTCAACCCTTGAATGCCGGCGGATACTGTCGGGCTAGAGTCCGGAAGAGGCGAGTGGAATTCCTGG	TACGTAGGGGGCAAGCGTTGTCCGGAATCATTGGGCGTAAAGAGCGTGTAGGCGGCCCGGTAAGTCCGCTGTGAAAGTCAGGGGCTCAACCCTTGAATGCCGGCGGATACTGTCGGGCTAGAGTCCGGAAGAGGCGAGTGGAATTCCTGG	0.0
TACGTAGGGGGCAAGCGTTGTCCGGAATCATTGGGCGTAAAGAGCGTGTAGGCGGCCCGGTAAGTCCGCTGTGAAAGTCGAGGGCTCAACCCTCGAATGCCGGCGGATACTGTCGGGCTAGAGTCCGGAAGAGGCGAGTGGAATTCCTGG	TACGTAGGGGGCAAGCGTTGTCCGGAATCATTGGGCGTAAAGAGCGTGTAGGCGGCCCGGTAAGTCCGCTGTGAAAGTCGAGGGCTCAACCCTCGAATGCCGGCGGATACTGTCGGGCTAGAGTCCGGAAGAGGCGAGTGGAATTCCTGG	0.0
TACGTAGGGGGCAAGCGTTGTCCGGAATCATTGGGCGTAAAGCGCGTGTAGGCGGCCAAGTAAGTCCGCTCTGAAAGCCCGGGGCTCAACCCCGGGAGGCGGGTGGATACTGTTTGGCTCGAGTCCGGAAGAGGCGAGTGGAATTCCTGG	TACGTAGGGGGCAAGCGTTGTCCGGAATCATTGGGCGTAAAGCGCGTGTAGGCGGCCAAGTAAGTCCGCTCTGAAAGCCCGGGGCTCAACCCCGGGAGGCGGGTGGATACTGTTTGGCTCGAGTCCGGAAGAGGCGAGTGGAATTCCTGG	0.0
TACGTAGGGGGCAAGCGTTGTCCGGAATCATTGGGCGTAAAGCGCGTGTAGGCGGCCTCGTAAGTCCGCTCTGAAAGCCTGGGGCTCAACCCCAGGAGGCGGGTGGATACTGCGAGGCTCGAGTACGGAAGAGGCGAGTGGAATTCCCGG	TACGTAGGGGGCAAGCGTTGTCCGGAATCATTGGGCGTAAAGCGCGTGTAGGCGGCCTCGTAAGTCCGCTCTGAAAGCCTGGGGCTCAACCCCAGGAGGCGGGTGGATACTGCGAGGCTCGAGTACGGAAGAGGCGAGTGGAATTCCCGG	0.0
TACGTAGGGGGCAAGCGTTGTCCGGAATCATTGGGCGTAAAGCGCGTGTAGGCGGCTTGGTAAGTCCGTTCTGAAAGTCCGAGGCTCAACCTCGGGAGGCGGATGGATACTGTCAAGCTCGAGTCCGGAAGAGGCGAGTGGAATTCCAGG	TACGTAGGGGGCAAGCGTTGTCCGGAATCATTGGGCGTAAAGCGCGTGTAGGCGGCTTGGTAAGTCCGTTCTGAAAGTCCGAGGCTCAACCTCGGGAGGCGGATGGATACTGTCAAGCTCGAGTCCGGAAGAGGCGAGTGGAATTCCAGG	0.0
TACGTAGGGGGCAAGCGTTGTCCGGAATCATTGGGCGTAAAGCGCGTGTAGGCGGGTCGGTCAGTCTGCTCTGAAAGTCCAAGGCTCAACCTTGGGATGCGGGTGGATACTGCCGACCTAGAGTCCGGAAGAGGCGAGTGGAATTCCTGG	TACGTAGGGGGCAAGCGTTGTCCGGAATCATTGGGCGTAAAGCGCGTGTAGGCGGGTCGGTCAGTCTGCTCTGAAAGTCCAAGGCTCAACCTTGGGATGCGGGTGGATACTGCCGACCTAGAGTCCGGAAGAGGCGAGTGGAATTCCTGG	0.0
TACGTAGGGGGCAAGCGTTGTCCGGAATCATTGGGCGTAAAGCGCGTGTAGGCGGTCCGGTAAGTCCGCTCTGAAAGTCGGGGGCTCAACCCTCGGATGCGGGTGGATACTGTCGGGCTAGAGTGCGGAAGAGGCGAGTGGAATTCCTGG	TACGTAGGGGGCAAGCGTTGTCCGGAATCATTGGGCGTAAAGCGCGTGTAGGCGGTCCGGTAAGTCCGCTCTGAAAGTCGGGGGCTCAACCCTCGGATGCGGGTGGATACTGTCGGGCTAGAGTGCGGAAGAGGCGAGTGGAATTCCTGG	0.0
TACGTAGGGGGCAAGCGTTGTCCGGAATCATTGGGCGTAAAGCGCGTGTAGGCGGTTTGGTAAGTCCGCTCTGAAAGTCCGGGGCTCAACCCCGGAAGGCGGGTGGATACTGTCAGACTAGAGTGCGGAAGAGGCGAGTGGAATTCCCGG	TACGTAGGGGGCAAGCGTTGTCCGGAATCATTGGGCGTAAAGCGCGTGTAGGCGGTTTGGTAAGTCCGCTCTGAAAGTCCGGGGCTCAACCCCGGAAGGCGGGTGGATACTGTCAGACTAGAGTGCGGAAGAGGCGAGTGGAATTCCCGG	0.0
TACGTAGGGGGCAAGCGTTGTCCGGAATTATTGGGCGTAAAGCGCGCGCAGGCGGCCTATTAAGTCTGATGTGAAAGCCCACGGCTCAACCGTGGAGGGCCATTGGAAACTGGTAGGCTTGAGTGCAGGAGAGGAGAGCGGAATTCCCGG	TACGTAGGGGGCAAGCGTTGTCCGGAATTATTGGGCGTAAAGCGCGCGCAGGCGGCCTATTAAGTCTGATGTGAAAGCCCACGGCTCAACCGTGGAGGGCCATTGGAAACTGGTAGGCTTGAGTGCAGGAGAGGAGAGCGGAATTCCCGG	0.0
TACGTAGGGGGCAAGCGTTGTCCGGAATTATTGGGCGTAAAGCGCGCGCAGGCGGCCTTGTAAGTCTGTTGTTTAAACTCGGGGCTCAACCCCGAGTCGCAATGGAAACTGCAAAGCTTGAGTGCAGAAGAGGAAAGTGGAATTCCACGT	TACGTAGGGGGCAAGCGTTGTCCGGAATTATTGGGCGTAAAGCGCGCGCAGGCGGCCTTGTAAGTCTGTTGTTTAAACTCGGGGCTCAACCCCGAGTCGCAATGGAAACTGCAAAGCTTGAGTGCAGAAGAGGAAAGTGGAATTCCACGT	0.0
TACGTAGGGGGCAAGCGTTGTCCGGAATTATTGGGCGTAAAGCGCGCGCAGGCGGCTTACTAAGTCTGGTGTGAAAGCCCACGGCTCAACCGTGGAGGGCCATTGGAAACTGGTAAGCTTGAGTGCAGGAGAGGAGAGCGGAATTCCCGG	TACGTAGGGGGCAAGCGTTGTCCGGAATTATTGGGCGTAAAGCGCGCGCAGGCGGCTTACTAAGTCTGGTGTGAAAGCCCACGGCTCAACCGTGGAGGGCCATTGGAAACTGGTAAGCTTGAGTGCAGGAGAGGAGAGCGGAATTCCCGG	0.0
TACGTAGGGGGCAAGCGTTGTCCGGAATTATTGGGCGTAAAGCGCGCGCAGGCGGTCCTTTAAGTCTTGTGTTTAAGCCCAGAGCTCAACTCTGGTACGCATGGGAAACTGGGGGACTGGAGTGCAGGAGAGGAAAGTGGAATTCCACGT	TACGTAGGGGGCAAGCGTTGTCCGGAATTATTGGGCGTAAAGCGCGCGCAGGCGGTCCTTTAAGTCTTGTGTTTAAGCCCAGAGCTCAACTCTGGTACGCATGGGAAACTGGGGGACTGGAGTGCAGGAGAGGAAAGTGGAATTCCACGT	0.0
TACGTAGGGGGCAAGCGTTGTCCGGAATTATTGGGCGTAAAGCGCGCGCAGGCGGTTCATTAAGTTTGGTGTTTAAGCCCGGGGCTCAACCCCGGTTCGCACTGAAAACTGGTGAACTTGAGTGCAGGAGAGGAAAGCGGAATTCCACGT	TACGTAGGGGGCAAGCGTTGTCCGGAATTATTGGGCGTAAAGCGCGCGCAGGCGGTTCATTAAGTTTGGTGTTTAAGCCCGGGGCTCAACCCCGGTTCGCACTGAAAACTGGTGAACTTGAGTGCAGGAGAGGAAAGCGGAATTCCACGT	0.0
TACGTAGGGGGCAAGCGTTGTCCGGATTTATTGGGCGTAAAGAGCTCGTAGGCGGCTCGGTAAGTCGGATGTGAAACCTCCAGGCTCAACCTGGAGACGCCATCTGATACTGCCGTGGCTTGAGTCCGGTAGAGGAGCAGGGAATTCCTG	TACGTAGGGGGCAAGCGTTGTCCGGATTTATTGGGCGTAAAGAGCTCGTAGGCGGCTCGGTAAGTCGGATGTGAAACCTCCAGGCTCAACCTGGAGACGCCATCTGATACTGCCGTGGCTTGAGTCCGGTAGAGGAGCAGGGAATTCCTG	0.0
TACGTAGGGGGCAAGCGTTGTCCGGATTTATTGGGCGTAAAGCGCGCGCAGGCGGCTTACTAAGTCTGATGTGAAAGCCCACGGCTCAACCGTGGAGGGCCATTGGAAACTGGTAAGCTTGAGTGTAGGAGAGGAGAGCGGAATTCCTGG	TACGTAGGGGGCAAGCGTTGTCCGGATTTATTGGGCGTAAAGCGCGCGCAGGCGGCTTACTAAGTCTGATGTGAAAGCCCACGGCTCAACCGTGGAGGGCCATTGGAAACTGGTAAGCTTGAGTGTAGGAGAGGAGAGCGGAATTCCTGG	0.0
TACGTAGGGGGCAAGCGTTGTCCGGATTTATTGGGCGTAAAGCGTTCGCAGGTGGTGCAGGAAGTGATGTGTGAAAGCGCCTGGCTTAACTGGGCGAGGCCATGTCAAACTCCTGGACTTGAGGGTCGGAGAGGCAGACGGAATTCCGGG	TACGTAGGGGGCAAGCGTTGTCCGGATTTATTGGGCGTAAAGCGTTCGCAGGTGGTGCAGGAAGTGATGTGTGAAAGCGCCTGGCTTAACTGGGCGAGGCCATGTCAAACTCCTGGACTTGAGGGTCGGAGAGGCAGACGGAATTCCGGG	0.0
TACGTAGGGGGCGAGCGTTGTCCGAAGTTACTGGGCGTAAAGCGCGCGTAGGCGGCCACTCAAGTCTGAGGTGAAAGGTTCAACGCTCAACGTGAACAGTGCCTTGGAGACTGGGCGGCTTGAGGACGGAAGAGGAAAGCGGAATTCCGG	TACGTAGGGGGCGAGCGTTGTCCGAAGTTACTGGGCGTAAAGCGCGCGTAGGCGGCCACTCAAGTCTGAGGTGAAAGGTTCAACGCTCAACGTGAACAGTGCCTTGGAGACTGGGCGGCTTGAGGACGGAAGAGGAAAGCGGAATTCCGG	0.0
TACGTAGGGGGCGAGCGTTGTCCGAAGTTACTGGGCGTAAAGCGCGCGTAGGCGGCCACTCAAGTCTGAGGTGAAAGGTTCAACGCTCAACGTGAACAGTGCCTTGGATACTGGGTGGCTTGAGGACGGAAGAGGAAAGCGGAATTCCGG	TACGTAGGGGGCGAGCGTTGTCCGAAGTTACTGGGCGTAAAGCGCGCGTAGGCGGCCACTCAAGTCTGAGGTGAAAGGTTCAACGCTCAACGTGAACAGTGCCTTGGATACTGGGTGGCTTGAGGACGGAAGAGGAAAGCGGAATTCCGG	0.0
TACGTAGGGGGCGAGCGTTGTCCGAAGTTACTGGGCGTAAAGCGCGCGTAGGCGGCTTTTTAAGTCTGGCGTGAAAGGTTCAGGGCTCAACCCGAACAGTGCGCTGGATACTGGGAAGCTTGAGTGCGGAAGAGGAGAGCGGAATTCCGG	TACGTAGGGGGCGAGCGTTGTCCGAAGTTACTGGGCGTAAAGCGCGCGTAGGCGGCTTTTTAAGTCTGGCGTGAAAGGTTCAGGGCTCAACCCGAACAGTGCGCTGGATACTGGGAAGCTTGAGTGCGGAAGAGGAGAGCGGAATTCCGG	0.0
TACGTAGGGGGCGAGCGTTGTCCGAAGTTACTGGGCGTAAAGCGCGCGTAGGCGGTTGCCTAAGTCTGGGGTGAAAGGTTCAGGGCTTAACCCGAACAGTGCCTTGGATACTGGGCGACTTGAGTGCCGAAGAGGAAAGCGGAATTCCTG	TACGTAGGGGGCGAGCGTTGTCCGAAGTTACTGGGCGTAAAGCGCGCGTAGGCGGTTGCCTAAGTCTGGGGTGAAAGGTTCAGGGCTTAACCCGAACAGTGCCTTGGATACTGGGCGACTTGAGTGCCGAAGAGGAAAGCGGAATTCCTG	0.0
TACGTAGGGGGCGAGCGTTGTCCGGAATCATTGGGCGTAAAGAGCGTGTAGGCGGCTTGGTAGGTCTCGTGTTAAATCTTGCGGCTCAACCGCAAACTGTCACGGGAAACCCCCTCGCTAGAGTCCGGAAGAGGAGAGCGGAATTCCTGG	TACGTAGGGGGCGAGCGTTGTCCGGAATCATTGGGCGTAAAGAGCGTGTAGGCGGCTTGGTAGGTCTCGTGTTAAATCTTGCGGCTCAACCGCAAACTGTCACGGGAAACCCCCTCGCTAGAGTCCGGAAGAGGAGAGCGGAATTCCTGG	0.0
TACGTAGGGGGCGAGCGTTGTCCGGAATTATTGGGCGTAAAGAGCGTGTAGGCGGCCTGGTAAGTCTGCTGTGAAACCTTGGGGCTCAACCCCAAGCGTGCAGTGGATACTGCTAGGCTAGAGGATGGTAGAGGCGAGTGGAATTCCCGG	TACGTAGGGGGCGAGCGTTGTCCGGAATTATTGGGCGTAAAGAGCGTGTAGGCGGCCTGGTAAGTCTGCTGTGAAACCTTGGGGCTCAACCCCAAGCGTGCAGTGGATACTGCTAGGCTAGAGGATGGTAGAGGCGAGTGGAATTCCCGG	0.0
TACGTAGGGGGCGAGCGTTGTCCGGAATTATTGGGCGTAAAGAGCGTGTAGGCGGTTCGGTAAGTCTGCCGTGAAAACCCAGGGCTCAACCCTGGGCGTGCGGTGGATACTGCCGGGCTAGAGGGTGGTAGAGGCGAGTGGAATTCCCGG	TACGTAGGGGGCGAGCGTTGTCCGGAATTATTGGGCGTAAAGAGCGTGTAGGCGGTTCGGTAAGTCTGCCGTGAAAACCCAGGGCTCAACCCTGGGCGTGCGGTGGATACTGCCGGGCTAGAGGGTGGTAGAGGCGAGTGGAATTCCCGG	0.0
TACGTAGGGGGCGAGCGTTGTCCGGAATTATTGGGCGTAAAGAGCGTGTAGGCGGTTCGGTAAGTCTGCCGTGAAAACCTGAGGCTCAACCTCGGGCGTGCGGTGGATACTGCCGGGCTAGAGGACGGTAGAGGCGAGTGGAATTCCCGG	TACGTAGGGGGCGAGCGTTGTCCGGAATTATTGGGCGTAAAGAGCGTGTAGGCGGTTCGGTAAGTCTGCCGTGAAAACCTGAGGCTCAACCTCGGGCGTGCGGTGGATACTGCCGGGCTAGAGGACGGTAGAGGCGAGTGGAATTCCCGG	0.0
TACGTAGGGGGCGAGCGTTGTCCGGAATTATTGGGCGTAAAGAGCGTGTAGGCGGTTCGGTAAGTCTGCCGTGAAAACCTGGGGCTCAACCCCGGGCGTGCGGTGGAAACTGCCGGGCTAGAGGATGGTAGAGGCGAGTGGAATTCCCGG	TACGTAGGGGGCGAGCGTTGTCCGGAATTATTGGGCGTAAAGAGCGTGTAGGCGGTTCGGTAAGTCTGCCGTGAAAACCTGGGGCTCAACCCCGGGCGTGCGGTGGAAACTGCCGGGCTAGAGGATGGTAGAGGCGAGTGGAATTCCCGG	0.0
TACGTAGGGGGCGAGCGTTGTCCGGAATTATTGGGCGTAAAGAGCGTGTAGGCGGTTCGGTAAGTCTGCTGTGAAAACCCAGGGCTCAACCCTGGGCGTGCAGTGGATACTGCCGGGCTAGAGGGTGGTAGAGGCGAGTGGAATTCCCAG	TACGTAGGGGGCGAGCGTTGTCCGGAATTATTGGGCGTAAAGAGCGTGTAGGCGGTTCGGTAAGTCTGCTGTGAAAACCCAGGGCTCAACCCTGGGCGTGCAGTGGATACTGCCGGGCTAGAGGGTGGTAGAGGCGAGTGGAATTCCCAG	0.0
TACGTAGGGGGCGAGCGTTGTCCGGAATTATTGGGCGTAAAGAGCGTGTAGGCGGTTCGGTAAGTCTGCTGTGAAATCCTGGGGCTCAACCCCGGGCGTGCAGCGGATACTGCCGGGCTAGAGGGTGGTAGAGGCGAGTGGAATTCCCGG	TACGTAGGGGGCGAGCGTTGTCCGGAATTATTGGGCGTAAAGAGCGTGTAGGCGGTTCGGTAAGTCTGCTGTGAAATCCTGGGGCTCAACCCCGGGCGTGCAGCGGATACTGCCGGGCTAGAGGGTGGTAGAGGCGAGTGGAATTCCCGG	0.0
TACGTAGGGGGCGAGCGTTGTCCGGAATTATTGGGCGTAAAGAGCGTGTAGGCGGTTCGGTAAGTCTGCTGTGAAATCCTGGGGCTCAACCCTGGGCGTGCAGCGGATACTGCCGGGCTAGAGGGTGGTAGAGGCGAGTGGAATTCCGAG	TACGTAGGGGGCGAGCGTTGTCCGGAATTATTGGGCGTAAAGAGCGTGTAGGCGGTTCGGTAAGTCTGCTGTGAAATCCTGGGGCTCAACCCTGGGCGTGCAGCGGATACTGCCGGGCTAGAGGGTGGTAGAGGCGAGTGGAATTCCGAG	0.0
TACGTAGGGGGCGAGCGTTGTCCGGAATTATTGGGCGTAAAGAGCGTGTAGGCGGTTCGGTAAGTCTGTCGTGAAAACCCAGGGCTCAACCCTGGGCGTGCGATGGATACTGCCGGGCTAGAGGGTGGTAGAGGCAAGTGGAATTCCGAG	TACGTAGGGGGCGAGCGTTGTCCGGAATTATTGGGCGTAAAGAGCGTGTAGGCGGTTCGGTAAGTCTGTCGTGAAAACCCAGGGCTCAACCCTGGGCGTGCGATGGATACTGCCGGGCTAGAGGGTGGTAGAGGCAAGTGGAATTCCGAG	0.0
TACGTAGGGGGCGAGCGTTGTCCGGAATTATTGGGCGTAAAGAGCGTGTAGGCGGTTCGGTAAGTCTGTCGTGAAAACCTGAGGCTCAACCTTGGGCGTGCGGTGGATACTGCCGGGCTAGAGGGTGGTAGAGGCGAGTGGAATTCCCGG	TACGTAGGGGGCGAGCGTTGTCCGGAATTATTGGGCGTAAAGAGCGTGTAGGCGGTTCGGTAAGTCTGTCGTGAAAACCTGAGGCTCAACCTTGGGCGTGCGGTGGATACTGCCGGGCTAGAGGGTGGTAGAGGCGAGTGGAATTCCCGG	0.0
TACGTAGGGGGCGAGCGTTGTCCGGAATTATTGGGCGTAAAGAGCGTGTAGGCGGTTCGGTAAGTCTGTCGTGAAATCCTGGGGCTCAACCCCGGGCGTGCGATGGATACTGCCGGGCTAGAGGGTGGTAGAGGCGAGTGGAATTCCCGG	TACGTAGGGGGCGAGCGTTGTCCGGAATTATTGGGCGTAAAGAGCGTGTAGGCGGTTCGGTAAGTCTGTCGTGAAATCCTGGGGCTCAACCCCGGGCGTGCGATGGATACTGCCGGGCTAGAGGGTGGTAGAGGCGAGTGGAATTCCCGG	0.0
TACGTAGGGGGCGAGCGTTGTCCGGAATTATTGGGCGTAAAGAGCGTGTAGGCGGTTCGGTAAGTCTGTCGTGAAATCCTGGGGCTCAACCCTGGGCGTGCGATGGATACTGCCGGGCTAGAGGGTGGTAGAGGCGAGTGGAATTCCCGG	TACGTAGGGGGCGAGCGTTGTCCGGAATTATTGGGCGTAAAGAGCGTGTAGGCGGTTCGGTAAGTCTGTCGTGAAATCCTGGGGCTCAACCCTGGGCGTGCGATGGATACTGCCGGGCTAGAGGGTGGTAGAGGCGAGTGGAATTCCCGG	0.0
TACGTAGGGGGCGAGCGTTGTCCGGAATTATTGGGCGTAAAGAGCGTGTAGGCGGTTCGGTAAGTCTGTTGTGAAATCCTGGGGCTCAACCCCGGGCGTGCAACGGATACTGCCGGGCTAGAGGGTGGTAGAGGCAAGTGGAATTCCGAG	TACGTAGGGGGCGAGCGTTGTCCGGAATTATTGGGCGTAAAGAGCGTGTAGGCGGTTCGGTAAGTCTGTTGTGAAATCCTGGGGCTCAACCCCGGGCGTGCAACGGATACTGCCGGGCTAGAGGGTGGTAGAGGCAAGTGGAATTCCGAG	0.0
TACGTAGGGGGCGAGCGTTGTCCGGATTTATTGGGCGTAAAGAGCGCGCAGGCGGCCCGCCAAGTCACCACGTGAAATCCCCCGGCTCAACCGGGGAGGGTCGGGTGAAACTGGCGGACTTGAGGATGGGAGAGGGGTGCGGAATTCCCG	TACGTAGGGGGCGAGCGTTGTCCGGATTTATTGGGCGTAAAGAGCGCGCAGGCGGCCCGCCAAGTCACCACGTGAAATCCCCCGGCTCAACCGGGGAGGGTCGGGTGAAACTGGCGGACTTGAGGATGGGAGAGGGGTGCGGAATTCCCG	0.0
TACGTAGGGGGCGAGCGTTGTCCGGATTTATTGGGCGTAAAGAGCTCGTAGGCGGCTTGGCAAGTCGGGTGTGAAACCTCCAGGCTCAACCTGGAGACGCCACTCGATACTGCCATGGCTAGAGTCCGGTAGGGGACCACGGAATTCCTG	TACGTAGGGGGCGAGCGTTGTCCGGATTTATTGGGCGTAAAGAGCTCGTAGGCGGCTTGGCAAGTCGGGTGTGAAACCTCCAGGCTCAACCTGGAGACGCCACTCGATACTGCCATGGCTAGAGTCCGGTAGGGGACCACGGAATTCCTG	0.0
TACGTAGGGGGCGAGCGTTGTCCGGATTTATTGGGCGTAAAGAGCTCGTAGGCGGCTTGGCAAGTCGGGTGTGAAACCTCCAGGCTCAACCTGGAGACGCCACTCGATACTGCTATGGCTAGAGTCCGGTAGGGGACCACGGAATTCCTG	TACGTAGGGGGCGAGCGTTGTCCGGATTTATTGGGCGTAAAGAGCTCGTAGGCGGCTTGGCAAGTCGGGTGTGAAACCTCCAGGCTCAACCTGGAGACGCCACTCGATACTGCTATGGCTAGAGTCCGGTAGGGGACCACGGAATTCCTG	0.0
TACGTAGGGGGCTAGCGTTGTCCGGAATCATTGGGCGTAAAGAGCGTGTAGGCGGTTCGATAAGTCCGCTGTAAAAGTCGGGGGCTCAACCCTCGAAAGCCGGTGGATACTGTTGGGCTAGAGTGCGGAAGAGGCGAGTGGAATTCCTGG	TACGTAGGGGGCTAGCGTTGTCCGGAATCATTGGGCGTAAAGAGCGTGTAGGCGGTTCGATAAGTCCGCTGTAAAAGTCGGGGGCTCAACCCTCGAAAGCCGGTGGATACTGTTGGGCTAGAGTGCGGAAGAGGCGAGTGGAATTCCTGG	0.0
TACGTAGGGGGCTAGCGTTGTCCGGAATCATTGGGCGTAAAGAGCGTGTAGGCGGTTCGATCAGTCCGCTGTAAAAGTCAGGGGCTCAACCCTTGAAAGCCGGTGGATACTGTCGGGCTAGAGTGCGGAAGAGGCGAGTGGAATTCCTGG	TACGTAGGGGGCTAGCGTTGTCCGGAATCATTGGGCGTAAAGAGCGTGTAGGCGGTTCGATCAGTCCGCTGTAAAAGTCAGGGGCTCAACCCTTGAAAGCCGGTGGATACTGTCGGGCTAGAGTGCGGAAGAGGCGAGTGGAATTCCTGG	0.0
TACGTAGGGGGCTAGCGTTGTCCGGAATCATTGGGCGTAAAGCGCGTGTAGGCGGCTCGGTAAGTCCGCTCTGAAAGTCGGGGGCTCAACCCTCGGATGCGGGTGGATACTGTCGGGCTAGAGTGCGGAAGAGGCGAGTGGAATTCCTGG	TACGTAGGGGGCTAGCGTTGTCCGGAATCATTGGGCGTAAAGCGCGTGTAGGCGGCTCGGTAAGTCCGCTCTGAAAGTCGGGGGCTCAACCCTCGGATGCGGGTGGATACTGTCGGGCTAGAGTGCGGAAGAGGCGAGTGGAATTCCTGG	0.0
TACGTAGGGGGCTAGCGTTGTCCGGAATCATTGGGCGTAAAGCGCGTGTAGGCGGTTCGATAAGTCCGCTGTAAAAGTCGGGGGCTCAACCCTCGAAAGCCGGTGGATACTGTCGGGCTAGAGTGCGGAAGAGGCGAGTGGAATTCCTGG	TACGTAGGGGGCTAGCGTTGTCCGGAATCATTGGGCGTAAAGCGCGTGTAGGCGGTTCGATAAGTCCGCTGTAAAAGTCGGGGGCTCAACCCTCGAAAGCCGGTGGATACTGTCGGGCTAGAGTGCGGAAGAGGCGAGTGGAATTCCTGG	0.0
TACGTAGGGGGCTAGCGTTGTCCGGAATCATTGGGCGTAAAGCGCGTGTAGGCGGTTCGGTAAGTCCGCTGTAAAAGTCGGGGGCTCAACCCTCGAAAGCCGGTGGATACTGTCGGGCTAGAGTGCGGAAGAGGCGAGTGGAATTCCTGG	TACGTAGGGGGCTAGCGTTGTCCGGAATCATTGGGCGTAAAGCGCGTGTAGGCGGTTCGGTAAGTCCGCTGTAAAAGTCGGGGGCTCAACCCTCGAAAGCCGGTGGATACTGTCGGGCTAGAGTGCGGAAGAGGCGAGTGGAATTCCTGG	0.0
TACGTAGGGGGCTAGCGTTGTCCGGAATTACTGGGCGTAAAGAGCGCGCAGGTGGTCTGATAAGTCACACGTGAAAGCCCCCGGCTCAACTGGGGAGGGTCGAGTGATACTGTTGGACTTGAGGTTGGGAGAGGAGTGTGGAATTCCCGG	TACGTAGGGGGCTAGCGTTGTCCGGAATTACTGGGCGTAAAGAGCGCGCAGGTGGTCTGATAAGTCACACGTGAAAGCCCCCGGCTCAACTGGGGAGGGTCGAGTGATACTGTTGGACTTGAGGTTGGGAGAGGAGTGTGGAATTCCCGG	0.0
TACGTAGGGGTCGAGCGTTGTCCGGAGTTACTGGGCGTAAAGCGCGCGCAGGTGGCTCATTACGCCCGGCGTGAAAGCCCCCGGCTCAACCGGGGAGGGTCGTCGGGTACGGGTGAGCTTGAGGGTATCAGGGGCTGGTGGAATTCCCGG	TACGTAGGGGTCGAGCGTTGTCCGGAGTTACTGGGCGTAAAGCGCGCGCAGGTGGCTCATTACGCCCGGCGTGAAAGCCCCCGGCTCAACCGGGGAGGGTCGTCGGGTACGGGTGAGCTTGAGGGTATCAGGGGCTGGTGGAATTCCCGG	0.0
TACGTAGGGGTCGAGCGTTGTCCGGAGTTACTGGGCGTAAAGCGTGCGCAGGCGGCTCATTGCGCCCGGCGTGAAAGCCCCCGGCTCAACCGGGGAGGGTCGTCGGGGACGGGTGAGCTTGAGGGTCGCAGGGGCTGGTGGAATTCCCGG	TACGTAGGGGTCGAGCGTTGTCCGGAGTTACTGGGCGTAAAGCGTGCGCAGGCGGCTCATTGCGCCCGGCGTGAAAGCCCCCGGCTCAACCGGGGAGGGTCGTCGGGGACGGGTGAGCTTGAGGGTCGCAGGGGCTGGTGGAATTCCCGG	0.0
TACGTAGGGGTCGAGCGTTGTCCGGAGTTACTGGGCGTAAAGCGTGTGCAGGCGGCGCACTGCGCCCGGCGTGAAAGCCCCCGGCCTAACCGGGGAGGGTCGTCGGGGACGGGTGCGCTTGAGGGTATCAGGGGCTGGTGGAATTCCCGG	TACGTAGGGGTCGAGCGTTGTCCGGAGTTACTGGGCGTAAAGCGTGTGCAGGCGGCGCACTGCGCCCGGCGTGAAAGCCCCCGGCCTAACCGGGGAGGGTCGTCGGGGACGGGTGCGCTTGAGGGTATCAGGGGCTGGTGGAATTCCCGG	0.0
TACGTAGGGTCCAAGCGTTGTCCGGAATTATTGGGCGTAAAGAGCTCGTAGGCGGCGTGTCGCGTCGGATGTGAAAGCCCGGGGCTTAACTCCGGGTCTGCATTCGGTACGGGCATGCTGGAGTTCGGTAGGGGAGACTGGAATTCCTGG	TACGTAGGGTCCAAGCGTTGTCCGGAATTATTGGGCGTAAAGAGCTCGTAGGCGGCGTGTCGCGTCGGATGTGAAAGCCCGGGGCTTAACTCCGGGTCTGCATTCGGTACGGGCATGCTGGAGTTCGGTAGGGGAGACTGGAATTCCTGG	0.0
TACGTAGGGTCCAAGCGTTGTCCGGAATTATTGGGCGTAAAGAGCTCGTAGGCGGTCCATTAAGTCCGATGTGAAATCTCAGGGCTCAACCCTGAAATCGCATTCGATACTGGTGGACTTGAGGCAGGTAGGGGAAGGTGGAATTCCTGG	TACGTAGGGTCCAAGCGTTGTCCGGAATTATTGGGCGTAAAGAGCTCGTAGGCGGTCCATTAAGTCCGATGTGAAATCTCAGGGCTCAACCCTGAAATCGCATTCGATACTGGTGGACTTGAGGCAGGTAGGGGAAGGTGGAATTCCTGG	0.0
TACGTAGGGTCCAAGCGTTGTCCGGAATTATTGGGCGTAAAGAGCTCGTAGGTGGCGTGTCGCGTCTGATGTGAAAGCCCGGGGCTTAACTCCGGGTCTGCATTAGGTACGGGCATGCTGGAGTTCGGTAGGGGAGACTGGAATTCCTGG	TACGTAGGGTCCAAGCGTTGTCCGGAATTATTGGGCGTAAAGAGCTCGTAGGTGGCGTGTCGCGTCTGATGTGAAAGCCCGGGGCTTAACTCCGGGTCTGCATTAGGTACGGGCATGCTGGAGTTCGGTAGGGGAGACTGGAATTCCTGG	0.0
TACGTAGGGTCCAAGCGTTGTCCGGAGTTACTGGGCGTAAAGCGCGCGCAGGCGGTGGCGTGTGCCCGGCGTGAAAGCCCCCGGCTCAACCGGGGAGGGTCGTCGGGGACTGCGTCACTTGAGGTCGGCAGGGGCTGGTGGAATGCCCGG	TACGTAGGGTCCAAGCGTTGTCCGGAGTTACTGGGCGTAAAGCGCGCGCAGGCGGTGGCGTGTGCCCGGCGTGAAAGCCCCCGGCTCAACCGGGGAGGGTCGTCGGGGACTGCGTCACTTGAGGTCGGCAGGGGCTGGTGGAATGCCCGG	0.0
TACGTAGGGTCCAAGCGTTGTCCGGATTTATTGGGCGTAAAGAGCTCGTAGGCGGCTCAGTAAGTCGGATGTGAAAACTCCAGGCTCAACCTGGAGACGCCATTCGATACTGCTGTGGCTTGAGTCTGGTAGGGGAGCACGGAATTCCTG	TACGTAGGGTCCAAGCGTTGTCCGGATTTATTGGGCGTAAAGAGCTCGTAGGCGGCTCAGTAAGTCGGATGTGAAAACTCCAGGCTCAACCTGGAGACGCCATTCGATACTGCTGTGGCTTGAGTCTGGTAGGGGAGCACGGAATTCCTG	0.0
TACGTAGGGTCCAAGCGTTGTCCGGATTTATTGGGCGTAAAGAGCTCGTAGGTGGCTCCGTAAGTCGGGTGTGAAAACCCCAGGCTCAACCTGGGGACGCCACTCGATACTGCGGTAGCTAGAGTCTGGTAGGGGATCTCGGAATTCCTG	TACGTAGGGTCCAAGCGTTGTCCGGATTTATTGGGCGTAAAGAGCTCGTAGGTGGCTCCGTAAGTCGGGTGTGAAAACCCCAGGCTCAACCTGGGGACGCCACTCGATACTGCGGTAGCTAGAGTCTGGTAGGGGATCTCGGAATTCCTG	0.0
TACGTAGGGTCCGAGCGTTGTCCGGAGTTACTGGGCGTAAAGCGCGCGCAGGCGGCGGTATAAGCATGGCGTGAAAGCCCCAGGCTCAACCTGGGAGGGTCGTCGTGGACTGTACCGCTTGAGGGCGGTAGGGGCTGGTGGAATGCCTGG	TACGTAGGGTCCGAGCGTTGTCCGGAGTTACTGGGCGTAAAGCGCGCGCAGGCGGCGGTATAAGCATGGCGTGAAAGCCCCAGGCTCAACCTGGGAGGGTCGTCGTGGACTGTACCGCTTGAGGGCGGTAGGGGCTGGTGGAATGCCTGG	0.0
TACGTAGGGTCCGAGCGTTGTCCGGAGTTACTGGGCGTAAAGCGCGCGCAGGCGGCGGTGCTGGCCCGGCGTGAAAGCCCCCGGCTCAACCGGGGAGGGTCGTCGGGGACCGCACCGCTTGAGGGCGGTAGGGGCTGGTGGAATGCCTGG	TACGTAGGGTCCGAGCGTTGTCCGGAGTTACTGGGCGTAAAGCGCGCGCAGGCGGCGGTGCTGGCCCGGCGTGAAAGCCCCCGGCTCAACCGGGGAGGGTCGTCGGGGACCGCACCGCTTGAGGGCGGTAGGGGCTGGTGGAATGCCTGG	0.0
TACGTAGGGTCCGAGCGTTGTCCGGAGTTACTGGGCGTAAAGCGCGCGCAGGCGGCGGTGTAAGCATGGCGTGAAAGCCCCAGGCTCAACCTGGGAGGGTCGTCGTGGACTGCACCGCTTGAGGGCGGTAGGGGCTGGTGGAATGCCTGG	TACGTAGGGTCCGAGCGTTGTCCGGAGTTACTGGGCGTAAAGCGCGCGCAGGCGGCGGTGTAAGCATGGCGTGAAAGCCCCAGGCTCAACCTGGGAGGGTCGTCGTGGACTGCACCGCTTGAGGGCGGTAGGGGCTGGTGGAATGCCTGG	0.0
TACGTAGGGTCCGAGCGTTGTCCGGAGTTACTGGGCGTAAAGCGCGCGCAGGCGGTCCCGCGCGCCCGGCGTGAAAGCCCCCGGCTCAACCGGGGAGGGTCGTCGGGGACGGCGGGACTTGAGGGCGGTAGGGGCCGGTGGAATCCCTGG	TACGTAGGGTCCGAGCGTTGTCCGGAGTTACTGGGCGTAAAGCGCGCGCAGGCGGTCCCGCGCGCCCGGCGTGAAAGCCCCCGGCTCAACCGGGGAGGGTCGTCGGGGACGGCGGGACTTGAGGGCGGTAGGGGCCGGTGGAATCCCTGG	0.0
TACGTAGGGTCCGAGCGTTGTCCGGATTTATTGGGCGTAAAGAGCTCGTAGGTGGCTCCGTAAGTCGGGTGTGAAAACCCCAGGCTCAACCTGGGGACGCCACTCGATACTGCGGTAGCTAGAGTCTGGTAGGGGATCTCGGAATTCCTG	TACGTAGGGTCCGAGCGTTGTCCGGATTTATTGGGCGTAAAGAGCTCGTAGGTGGCTCCGTAAGTCGGGTGTGAAAACCCCAGGCTCAACCTGGGGACGCCACTCGATACTGCGGTAGCTAGAGTCTGGTAGGGGATCTCGGAATTCCTG	0.0
TACGTAGGGTCCGAGCGTTGTCCGGATTTATTGGGCGTAAAGAGCTCGTAGGTGGCTCCGTAAGTCGGGTGTGAAAACCCCAGGCTCAACCTGGGGACGCCACTTGATACTGCGGTAGCTTGAGTCTGGTAGGGGATCTCGGAATTCCTG	TACGTAGGGTCCGAGCGTTGTCCGGATTTATTGGGCGTAAAGAGCTCGTAGGTGGCTCCGTAAGTCGGGTGTGAAAACCCCAGGCTCAACCTGGGGACGCCACTTGATACTGCGGTAGCTTGAGTCTGGTAGGGGATCTCGGAATTCCTG	0.0
TACGTAGGGTCCGAGCGTTGTCCGGATTTATTGGGCGTAAAGAGCTCGTAGGTGGCTTCGTAAGTCGGGTGTGAAAACCCCAGGCTCAACCTGGGGACGCCACTCGATACTGCGGTGGCTTGAGTCTGGTAGGGGATCACGGAATTCCTG	TACGTAGGGTCCGAGCGTTGTCCGGATTTATTGGGCGTAAAGAGCTCGTAGGTGGCTTCGTAAGTCGGGTGTGAAAACCCCAGGCTCAACCTGGGGACGCCACTCGATACTGCGGTGGCTTGAGTCTGGTAGGGGATCACGGAATTCCTG	0.0
TACGTAGGGTGCAAGCGTTAATCGGAATTACTGGGCGTAAAGCGTGCGCAGGCGGCTTTGCAAGACAGATGTGAAATCCCCGGGCTCAACCTGGGAACTGCATTTGTGACTGCATGGCTGGAGTGCGGCAGAGGGGGATGGAATTCCGCG	TACGTAGGGTGCAAGCGTTAATCGGAATTACTGGGCGTAAAGCGTGCGCAGGCGGCTTTGCAAGACAGATGTGAAATCCCCGGGCTCAACCTGGGAACTGCATTTGTGACTGCATGGCTGGAGTGCGGCAGAGGGGGATGGAATTCCGCG	0.0
TACGTAGGGTGCAAGCGTTAATCGGAATTACTGGGCGTAAAGCGTGCGCAGGCGGTGATGTAAGACAGATGTGAAATCCCCGGGCTCAACCTGGGAACTGCATTTGTGACTGCATCGCTGGAGTGCGGCAGAGGGGGATGGAATTCCGCG	TACGTAGGGTGCAAGCGTTAATCGGAATTACTGGGCGTAAAGCGTGCGCAGGCGGTGATGTAAGACAGATGTGAAATCCCCGGGCTCAACCTGGGAACTGCATTTGTGACTGCATCGCTGGAGTGCGGCAGAGGGGGATGGAATTCCGCG	0.0
TACGTAGGGTGCAAGCGTTAATCGGAATTACTGGGCGTAAAGCGTGCGCAGGCGGTTATGTAAGACAGGTGTGAAATCCCCGGGCTTAACCTGGGAACTGCATTTGTGACTGCATAGCTAGAGTACGGTAGAGGGGGATGGAATTCCGCG	TACGTAGGGTGCAAGCGTTAATCGGAATTACTGGGCGTAAAGCGTGCGCAGGCGGTTATGTAAGACAGGTGTGAAATCCCCGGGCTTAACCTGGGAACTGCATTTGTGACTGCATAGCTAGAGTACGGTAGAGGGGGATGGAATTCCGCG	0.0
TACGTAGGGTGCAAGCGTTAATCGGAATTACTGGGCGTAAAGCGTGCGCAGGCGGTTGTGCAAGACAGATGTGAAATCCCCGGGCTCAACCTGGGAACTGCATTTGTGACTGCACGGCTAGAGTGTGTCAGAGGGGGGTAGAATTCCACG	TACGTAGGGTGCAAGCGTTAATCGGAATTACTGGGCGTAAAGCGTGCGCAGGCGGTTGTGCAAGACAGATGTGAAATCCCCGGGCTCAACCTGGGAACTGCATTTGTGACTGCACGGCTAGAGTGTGTCAGAGGGGGGTAGAATTCCACG	0.0
TACGTAGGGTGCAAGCGTTAATCGGAATTACTGGGCGTAAAGCGTGCGCAGGCGGTTGTGCAAGACAGATGTGAAATCCCCGGGCTTAACCTGGGAACTGCATTTGTGACTGCACGGCTAGAGTGTGTCAGAGGGGGGTAGAATTCCACG	TACGTAGGGTGCAAGCGTTAATCGGAATTACTGGGCGTAAAGCGTGCGCAGGCGGTTGTGCAAGACAGATGTGAAATCCCCGGGCTTAACCTGGGAACTGCATTTGTGACTGCACGGCTAGAGTGTGTCAGAGGGGGGTAGAATTCCACG	0.0
TACGTAGGGTGCAAGCGTTAATCGGAATTACTGGGCGTAAAGCGTGCGCAGGCGGTTTCGTAAGACAGATGTGAAATCCCCGGGCTTAACCTGGGAACTGCATTTGTGACTGCGAGGCTAGAGTGTGTCAGAGGGAGGTGGAATTCCGCG	TACGTAGGGTGCAAGCGTTAATCGGAATTACTGGGCGTAAAGCGTGCGCAGGCGGTTTCGTAAGACAGATGTGAAATCCCCGGGCTTAACCTGGGAACTGCATTTGTGACTGCGAGGCTAGAGTGTGTCAGAGGGAGGTGGAATTCCGCG	0.0
TACGTAGGGTGCAAGCGTTAATCGGAATTACTGGGCGTAAAGCGTGCGCAGGCGGTTTCGTAAGACCGATGTGAAAGCCCCGGGCTTAACCTGGGAACTGCATTGGTGACTGCGAGGCTAGAGTGTGTCAGAGGGAGGTGGAATTCCGCG	TACGTAGGGTGCAAGCGTTAATCGGAATTACTGGGCGTAAAGCGTGCGCAGGCGGTTTCGTAAGACCGATGTGAAAGCCCCGGGCTTAACCTGGGAACTGCATTGGTGACTGCGAGGCTAGAGTGTGTCAGAGGGAGGTGGAATTCCGCG	0.0
TACGTAGGGTGCAAGCGTTAATCGGAATTACTGGGCGTAAAGCGTGCGCAGGCGGTTTTGTAAGTCTGACGTGAAAGCCCCGGGCTCAACCTGGGAATTGCGTTGGAGACTGCAAGGCTTGAATCTGGCAGAGGGGGGTAGAATTCCACG	TACGTAGGGTGCAAGCGTTAATCGGAATTACTGGGCGTAAAGCGTGCGCAGGCGGTTTTGTAAGTCTGACGTGAAAGCCCCGGGCTCAACCTGGGAATTGCGTTGGAGACTGCAAGGCTTGAATCTGGCAGAGGGGGGTAGAATTCCACG	0.0
TACGTAGGGTGCAAGCGTTGTCCGGAATCATTGGGCGTAAAGGGCTCGTAGGCGGTCCATCACGTCGGGAGTGAAAAGCTGGGGCTTAACCCCAGTCCTGCTTCCGATACGGGTGGACTAGAGGTAGGCAGGGGAGAACGGAATTCCTGG	TACGTAGGGTGCAAGCGTTGTCCGGAATCATTGGGCGTAAAGGGCTCGTAGGCGGTCCATCACGTCGGGAGTGAAAAGCTGGGGCTTAACCCCAGTCCTGCTTCCGATACGGGTGGACTAGAGGTAGGCAGGGGAGAACGGAATTCCTGG	0.0
TACGTAGGGTGCAAGCGTTGTCCGGAATTATTGGGCGTAAAGAGCTCGTAGGCGGCGTGTCACGTCGGCTGTGAAAACCCGAGGCTCAACCTCGGGCCTGCAGTCGATACGGGCGGGCTAGAGTTCGGTAGGGGAGACTGGAATTCCTGG	TACGTAGGGTGCAAGCGTTGTCCGGAATTATTGGGCGTAAAGAGCTCGTAGGCGGCGTGTCACGTCGGCTGTGAAAACCCGAGGCTCAACCTCGGGCCTGCAGTCGATACGGGCGGGCTAGAGTTCGGTAGGGGAGACTGGAATTCCTGG	0.0
TACGTAGGGTGCAAGCGTTGTCCGGAATTATTGGGCGTAAAGAGCTCGTAGGCGGCGTGTCGCGTCGGCTGTGAAAACCCGAGGCTCAACCTCGGGCCTGCAGTCGATACGGGCAGGCTAGAGTTCGGTAGGGGAGACTGGAATTCCTGG	TACGTAGGGTGCAAGCGTTGTCCGGAATTATTGGGCGTAAAGAGCTCGTAGGCGGCGTGTCGCGTCGGCTGTGAAAACCCGAGGCTCAACCTCGGGCCTGCAGTCGATACGGGCAGGCTAGAGTTCGGTAGGGGAGACTGGAATTCCTGG	0.0
TACGTAGGGTGCAAGCGTTGTCCGGAATTATTGGGCGTAAAGAGCTCGTAGGCGGCTCGTCGCGTCTGCTGTGAAAGCCTAGGGCTTAACCCTGGGTCTGCAGTGGGTACGGGCGAGCTAGAGTGCGGTAGGGGAGACTGGAATTCCTGG	TACGTAGGGTGCAAGCGTTGTCCGGAATTATTGGGCGTAAAGAGCTCGTAGGCGGCTCGTCGCGTCTGCTGTGAAAGCCTAGGGCTTAACCCTGGGTCTGCAGTGGGTACGGGCGAGCTAGAGTGCGGTAGGGGAGACTGGAATTCCTGG	0.0
TACGTAGGGTGCAAGCGTTGTCCGGAATTATTGGGCGTAAAGAGCTCGTAGGCGGTCTGTCACGTCGGCTGTGAAATCCCGAGGCTCAACCTCGGGTCTGCAGTCGATACGGGCAAACTAGAGTGTTGCAGGGGAGACTGGAATTCCTGG	TACGTAGGGTGCAAGCGTTGTCCGGAATTATTGGGCGTAAAGAGCTCGTAGGCGGTCTGTCACGTCGGCTGTGAAATCCCGAGGCTCAACCTCGGGTCTGCAGTCGATACGGGCAAACTAGAGTGTTGCAGGGGAGACTGGAATTCCTGG	0.0
TACGTAGGGTGCAAGCGTTGTCCGGAATTATTGGGCGTAAAGAGCTCGTAGGCGGTCTGTCGCGTCGGATGTGAAAATCCAGGGCTCAACCCTGGACCTGCATTCGATACGGGCAGACTAGAGTTCGGTAGGGGAGACTGGAATTCCTGG	TACGTAGGGTGCAAGCGTTGTCCGGAATTATTGGGCGTAAAGAGCTCGTAGGCGGTCTGTCGCGTCGGATGTGAAAATCCAGGGCTCAACCCTGGACCTGCATTCGATACGGGCAGACTAGAGTTCGGTAGGGGAGACTGGAATTCCTGG	0.0
TACGTAGGGTGCAAGCGTTGTCCGGAATTATTGGGCGTAAAGAGCTCGTAGGCGGTCTGTCGCGTCGGCTGTGAAAACCCGAGGCTCAACCTCGGGCCTGCAGTCGATACGGGCAAACTAGAGTGTTGCAGGGGAGACTGGAATTCCTGG	TACGTAGGGTGCAAGCGTTGTCCGGAATTATTGGGCGTAAAGAGCTCGTAGGCGGTCTGTCGCGTCGGCTGTGAAAACCCGAGGCTCAACCTCGGGCCTGCAGTCGATACGGGCAAACTAGAGTGTTGCAGGGGAGACTGGAATTCCTGG	0.0
TACGTAGGGTGCAAGCGTTGTCCGGAATTATTGGGCGTAAAGAGCTCGTAGGCGGTCTGTCGCGTCGGCTGTGAAAACTCGGGGCTCAACCCCGAGCCTGCAGTCGATACGGGCAGACTAGAGTGCTGTAGGGGAGACTGGAATTCCTGG	TACGTAGGGTGCAAGCGTTGTCCGGAATTATTGGGCGTAAAGAGCTCGTAGGCGGTCTGTCGCGTCGGCTGTGAAAACTCGGGGCTCAACCCCGAGCCTGCAGTCGATACGGGCAGACTAGAGTGCTGTAGGGGAGACTGGAATTCCTGG	0.0
TACGTAGGGTGCAAGCGTTGTCCGGAATTATTGGGCGTAAAGAGCTCGTAGGCGGTCTGTCGCGTCGGCTGTGAAAACTCGGGGCTCAACTCCGAGCCTGCAGTCGATACGGGCAGACTAGAGTGCTGTAGGGGAGACTGGAATTCCTGG	TACGTAGGGTGCAAGCGTTGTCCGGAATTATTGGGCGTAAAGAGCTCGTAGGCGGTCTGTCGCGTCGGCTGTGAAAACTCGGGGCTCAACTCCGAGCCTGCAGTCGATACGGGCAGACTAGAGTGCTGTAGGGGAGACTGGAATTCCTGG	0.0
TACGTAGGGTGCAAGCGTTGTCCGGAATTATTGGGCGTAAAGAGCTCGTAGGCGGTCTGTCGCGTCGGCTGTGAAAACTCGGGGCTCAACTCCGAGCCTGCAGTCGATACGGGCAGACTTGAGTGCTGTAGGGGAGACTGGAATTCCTGG	TACGTAGGGTGCAAGCGTTGTCCGGAATTATTGGGCGTAAAGAGCTCGTAGGCGGTCTGTCGCGTCGGCTGTGAAAACTCGGGGCTCAACTCCGAGCCTGCAGTCGATACGGGCAGACTTGAGTGCTGTAGGGGAGACTGGAATTCCTGG	0.0
TACGTAGGGTGCAAGCGTTGTCCGGAATTATTGGGCGTAAAGAGCTCGTAGGCGGTCTGTCGCGTCGGCTGTGAAAACTTGGGGCTCAACCCCAAGCCTGCAGTCGATACGGGCAGACTAGAGTGCGGTAGGGGAGACTGGAATTCCTGG	TACGTAGGGTGCAAGCGTTGTCCGGAATTATTGGGCGTAAAGAGCTCGTAGGCGGTCTGTCGCGTCGGCTGTGAAAACTTGGGGCTCAACCCCAAGCCTGCAGTCGATACGGGCAGACTAGAGTGCGGTAGGGGAGACTGGAATTCCTGG	0.0
TACGTAGGGTGCAAGCGTTGTCCGGAATTATTGGGCGTAAAGAGCTCGTAGGCGGTCTGTCGCGTCGGCTGTGAAAACTTGGGGCTCAACTCCGAGCTTGCAGTCGATACGGGCAGGCTAGAGTTCGGCAGGGGAGACTGGAATTCCTGG	TACGTAGGGTGCAAGCGTTGTCCGGAATTATTGGGCGTAAAGAGCTCGTAGGCGGTCTGTCGCGTCGGCTGTGAAAACTTGGGGCTCAACTCCGAGCTTGCAGTCGATACGGGCAGGCTAGAGTTCGGCAGGGGAGACTGGAATTCCTGG	0.0
TACGTAGGGTGCAAGCGTTGTCCGGAATTATTGGGCGTAAAGAGCTCGTAGGCGGTCTGTCGCGTCTGCTGTGAAAACCCGGGGCTCAACCCTGGGCTGGCAGTGGGTACGGGCGGACTGGAGTGCAGTAGGGGAGACTGGAATTCCTGG	TACGTAGGGTGCAAGCGTTGTCCGGAATTATTGGGCGTAAAGAGCTCGTAGGCGGTCTGTCGCGTCTGCTGTGAAAACCCGGGGCTCAACCCTGGGCTGGCAGTGGGTACGGGCGGACTGGAGTGCAGTAGGGGAGACTGGAATTCCTGG	0.0
TACGTAGGGTGCAAGCGTTGTCCGGAATTATTGGGCGTAAAGAGCTCGTAGGCGGTGTGTCGCGTCTGCTGTGAAAACTCAGGGCTCAACTCTGAGCTTGCAGTGGGTACGGGCACACTTGAGTGCTGTAGGGGAGACTGGAATTCCTGG	TACGTAGGGTGCAAGCGTTGTCCGGAATTATTGGGCGTAAAGAGCTCGTAGGCGGTGTGTCGCGTCTGCTGTGAAAACTCAGGGCTCAACTCTGAGCTTGCAGTGGGTACGGGCACACTTGAGTGCTGTAGGGGAGACTGGAATTCCTGG	0.0
TACGTAGGGTGCAAGCGTTGTCCGGAATTATTGGGCGTAAAGAGCTCGTAGGCGGTTCGTCGCGTCGGCTGTGAAAACCCGGAGCTCAACTCCGGGCCTGCAGTCGATACGGGCGGACTCGAGTTCGGCAGGGGAGACTGGAATTCCTGG	TACGTAGGGTGCAAGCGTTGTCCGGAATTATTGGGCGTAAAGAGCTCGTAGGCGGTTCGTCGCGTCGGCTGTGAAAACCCGGAGCTCAACTCCGGGCCTGCAGTCGATACGGGCGGACTCGAGTTCGGCAGGGGAGACTGGAATTCCTGG	0.0
TACGTAGGGTGCAAGCGTTGTCCGGAATTATTGGGCGTAAAGAGCTCGTAGGCGGTTCGTCGCGTCGGCTGTGAAAACCCGGAGCTCAACTCCGGGCCTGCAGTCGATACGGGCGGACTGGAGTGTTGCAGGGGAGACTGGAATTCCTGG	TACGTAGGGTGCAAGCGTTGTCCGGAATTATTGGGCGTAAAGAGCTCGTAGGCGGTTCGTCGCGTCGGCTGTGAAAACCCGGAGCTCAACTCCGGGCCTGCAGTCGATACGGGCGGACTGGAGTGTTGCAGGGGAGACTGGAATTCCTGG	0.0
TACGTAGGGTGCAAGCGTTGTCCGGAATTATTGGGCGTAAAGAGCTCGTAGGCGGTTCGTCGCGTCGGCTGTGAAAACCCGGAGCTCAACTCCGGGCCTGCAGTCGATACGGGCGGACTTGAGTTCGGCAGGGGAGACTGGAATTCCTGG	TACGTAGGGTGCAAGCGTTGTCCGGAATTATTGGGCGTAAAGAGCTCGTAGGCGGTTCGTCGCGTCGGCTGTGAAAACCCGGAGCTCAACTCCGGGCCTGCAGTCGATACGGGCGGACTTGAGTTCGGCAGGGGAGACTGGAATTCCTGG	0.0
TACGTAGGGTGCAAGCGTTGTCCGGAATTATTGGGCGTAAAGAGCTCGTAGGCGGTTCGTCGCGTCGGCTGTGAAAACCTGAGGCTCAACCTCAGGCCTGCAGTCGATACGGGCGGACTAGAGTTCGGCAGGGGAGACTGGAATTCCTGG	TACGTAGGGTGCAAGCGTTGTCCGGAATTATTGGGCGTAAAGAGCTCGTAGGCGGTTCGTCGCGTCGGCTGTGAAAACCTGAGGCTCAACCTCAGGCCTGCAGTCGATACGGGCGGACTAGAGTTCGGCAGGGGAGACTGGAATTCCTGG	0.0
TACGTAGGGTGCAAGCGTTGTCCGGAATTATTGGGCGTAAAGAGCTCGTAGGCGGTTCGTCGCGTCGGCTGTGAAAACCTGAGGCTCAACCTCAGGCCTGCAGTCGATACGGGCGGACTCGAGTTCGGCAGGGGAGACTGGAATTCCTGG	TACGTAGGGTGCAAGCGTTGTCCGGAATTATTGGGCGTAAAGAGCTCGTAGGCGGTTCGTCGCGTCGGCTGTGAAAACCTGAGGCTCAACCTCAGGCCTGCAGTCGATACGGGCGGACTCGAGTTCGGCAGGGGAGACTGGAATTCCTGG	0.0
TACGTAGGGTGCAAGCGTTGTCCGGAATTATTGGGCGTAAAGAGCTCGTAGGCGGTTCGTCGCGTCGGCTGTGAAAACCTGAGGCTCAACCTCAGGCCTGCAGTCGATACGGGCGGACTTGAGTACTGCAGGGGAGACTGGAATTCCTGG	TACGTAGGGTGCAAGCGTTGTCCGGAATTATTGGGCGTAAAGAGCTCGTAGGCGGTTCGTCGCGTCGGCTGTGAAAACCTGAGGCTCAACCTCAGGCCTGCAGTCGATACGGGCGGACTTGAGTACTGCAGGGGAGACTGGAATTCCTGG	0.0
TACGTAGGGTGCAAGCGTTGTCCGGAATTATTGGGCGTAAAGAGCTCGTAGGCGGTTCGTCGCGTCGGCTGTGAAATCCCGAGGCTCAACCTCGGGCCTGCAGTCGATACGGGCGGACTTGAGTTCGGCAGGGGAGACTGGAATTCCTGG	TACGTAGGGTGCAAGCGTTGTCCGGAATTATTGGGCGTAAAGAGCTCGTAGGCGGTTCGTCGCGTCGGCTGTGAAATCCCGAGGCTCAACCTCGGGCCTGCAGTCGATACGGGCGGACTTGAGTTCGGCAGGGGAGACTGGAATTCCTGG	0.0
TACGTAGGGTGCAAGCGTTGTCCGGAATTATTGGGCGTAAAGAGCTCGTAGGCGGTTGGTCGCGTCGGCTGTGAAAACCCGGAGCTCAACTCCGGGCCTGCAGTCGATACGGGCCGACTTGAGTGTTGCAGGGGAGACTGGAATTCCTGG	TACGTAGGGTGCAAGCGTTGTCCGGAATTATTGGGCGTAAAGAGCTCGTAGGCGGTTGGTCGCGTCGGCTGTGAAAACCCGGAGCTCAACTCCGGGCCTGCAGTCGATACGGGCCGACTTGAGTGTTGCAGGGGAGACTGGAATTCCTGG	0.0
TACGTAGGGTGCAAGCGTTGTCCGGAATTATTGGGCGTAAAGAGCTCGTAGGCGGTTTGTCGCGTCGACTGTGAAAACTCAGGGGCTCAACTCCGAGCTTGCAGTCGATACGGGCAGACTAGAGTTCGGCAGGGGAGACTGGAATTCCTG	TACGTAGGGTGCAAGCGTTGTCCGGAATTATTGGGCGTAAAGAGCTCGTAGGCGGTTTGTCGCGTCGACTGTGAAAACTCAGGGGCTCAACTCCGAGCTTGCAGTCGATACGGGCAGACTAGAGTTCGGCAGGGGAGACTGGAATTCCTG	0.0
TACGTAGGGTGCAAGCGTTGTCCGGAATTATTGGGCGTAAAGAGCTCGTAGGCGGTTTGTCGCGTCGGCTGTGAAAACCTGAGGCTCAACCTCAGGCCTGCAGTCGATACGGGCAGACTTGAGTGTTGCAGGGGAGACTGGAATTCCTGG	TACGTAGGGTGCAAGCGTTGTCCGGAATTATTGGGCGTAAAGAGCTCGTAGGCGGTTTGTCGCGTCGGCTGTGAAAACCTGAGGCTCAACCTCAGGCCTGCAGTCGATACGGGCAGACTTGAGTGTTGCAGGGGAGACTGGAATTCCTGG	0.0
TACGTAGGGTGCAAGCGTTGTCCGGAATTATTGGGCGTAAAGAGCTCGTAGGCGGTTTGTCGCGTCTGCTGTGAAAACCGGAGGCTCAACCTCCGGCCTGCAGTGGGTACGGGCAGACTAGAGTGCGGTAGGGGAGATTGGAATTCCTGG	TACGTAGGGTGCAAGCGTTGTCCGGAATTATTGGGCGTAAAGAGCTCGTAGGCGGTTTGTCGCGTCTGCTGTGAAAACCGGAGGCTCAACCTCCGGCCTGCAGTGGGTACGGGCAGACTAGAGTGCGGTAGGGGAGATTGGAATTCCTGG	0.0
TACGTAGGGTGCAAGCGTTGTCCGGAATTATTGGGCGTAAAGAGCTCGTAGGCGGTTTGTCGCGTCTGCTGTGAAAACGCGAGGCTCAACCTCGCGCCTGCAGTGGGTACGGGCAAACTAGAGTGCGGTAGGGGAGATTGGAATTCCTGG	TACGTAGGGTGCAAGCGTTGTCCGGAATTATTGGGCGTAAAGAGCTCGTAGGCGGTTTGTCGCGTCTGCTGTGAAAACGCGAGGCTCAACCTCGCGCCTGCAGTGGGTACGGGCAAACTAGAGTGCGGTAGGGGAGATTGGAATTCCTGG	0.0
TACGTAGGGTGCAAGCGTTGTCCGGAATTATTGGGCGTAAAGAGCTCGTAGGCGGTTTGTCGCGTCTGCTGTGAAAACTCAGGGCTTAACCCTGAGCTTGCAGTGGGTACGGGCAGACTAGAGTGCGGTAGGGGAGACTGGAATTCCTGG	TACGTAGGGTGCAAGCGTTGTCCGGAATTATTGGGCGTAAAGAGCTCGTAGGCGGTTTGTCGCGTCTGCTGTGAAAACTCAGGGCTTAACCCTGAGCTTGCAGTGGGTACGGGCAGACTAGAGTGCGGTAGGGGAGACTGGAATTCCTGG	0.0
TACGTAGGGTGCAAGCGTTGTCCGGAATTATTGGGCGTAAAGAGCTCGTAGGCGGTTTGTTGCGTCGGCTGTGAAATCCCGAGGCTCAACCTCGGGTCTGCAGTCGATACGAGCAAACTAGAGTGTTGCAGGGGAGACTGGAATTCCTGG	TACGTAGGGTGCAAGCGTTGTCCGGAATTATTGGGCGTAAAGAGCTCGTAGGCGGTTTGTTGCGTCGGCTGTGAAATCCCGAGGCTCAACCTCGGGTCTGCAGTCGATACGAGCAAACTAGAGTGTTGCAGGGGAGACTGGAATTCCTGG	0.0
TACGTAGGGTGCAAGCGTTGTCCGGAATTATTGGGCGTAAAGGGCTCGTAGGCGGTCTGTCGCGTCGGGAGTGAAAACTCAGGGCTCAACCCTGAGCGTGCTCCCGATACGGGCAGACTAGAGGTAGGTAGGGGAGAATGGAATTCCTGG	TACGTAGGGTGCAAGCGTTGTCCGGAATTATTGGGCGTAAAGGGCTCGTAGGCGGTCTGTCGCGTCGGGAGTGAAAACTCAGGGCTCAACCCTGAGCGTGCTCCCGATACGGGCAGACTAGAGGTAGGTAGGGGAGAATGGAATTCCTGG	0.0
TACGTAGGGTGCAAGCGTTGTCCGGAATTATTGGGCGTAAAGGGCTCGTAGGCGGTCTGTTACGTCGGGAGTGAAAACTCGGGGCTCAACCCCGAGCCTGCTTCCGATACGGGCAGACTAGAGGTATGCAGGGGAGAATGGAATTCCTGG	TACGTAGGGTGCAAGCGTTGTCCGGAATTATTGGGCGTAAAGGGCTCGTAGGCGGTCTGTTACGTCGGGAGTGAAAACTCGGGGCTCAACCCCGAGCCTGCTTCCGATACGGGCAGACTAGAGGTATGCAGGGGAGAATGGAATTCCTGG	0.0
TACGTAGGGTGCGAGCGTTAATCGGAATTACTGGGCGTAAAGCGTGCGCAGGCGGTTTTGTAAGTCAGATGTGAAATCCCCGGGCTTAACCTGGGAACTGCGTTTGAAACTACAAGGCTAGAGTGTGGCAGAGGGGGGTGGAATTCCACG	TACGTAGGGTGCGAGCGTTAATCGGAATTACTGGGCGTAAAGCGTGCGCAGGCGGTTTTGTAAGTCAGATGTGAAATCCCCGGGCTTAACCTGGGAACTGCGTTTGAAACTACAAGGCTAGAGTGTGGCAGAGGGGGGTGGAATTCCACG	0.0
TACGTAGGGTGCGAGCGTTAATCGGAATTACTGGGCGTAAAGGGTGCGCAGGCGGTTCTGTAAGTCAGATGTGAAATCCCCGGGCTTAACCTGGGAATTGCGTTTGAAACTACAGGGCTAGAGTGTAGCAGAGGGGGGTGGAATTCCATG	TACGTAGGGTGCGAGCGTTAATCGGAATTACTGGGCGTAAAGGGTGCGCAGGCGGTTCTGTAAGTCAGATGTGAAATCCCCGGGCTTAACCTGGGAATTGCGTTTGAAACTACAGGGCTAGAGTGTAGCAGAGGGGGGTGGAATTCCATG	0.0
TACGTAGGGTGCGAGCGTTGTCCGGAATTATTGGGCGTAAAGAGCTCGTAGGCGGTGTGTCACGTCGGCCGTGAAAACCTGGGGCTCAACTCTGGGCGTGCGGTCGATACGGGCATCACTAGAGTTCGGCAGGGGAGACTGGAATTCCTG	TACGTAGGGTGCGAGCGTTGTCCGGAATTATTGGGCGTAAAGAGCTCGTAGGCGGTGTGTCACGTCGGCCGTGAAAACCTGGGGCTCAACTCTGGGCGTGCGGTCGATACGGGCATCACTAGAGTTCGGCAGGGGAGACTGGAATTCCTG	0.0
TACGTAGGGTGCGAGCGTTGTCCGGAATTATTGGGCGTAAAGAGCTTGTAGGCGGTTTGTCGCGTCTGCTGTGAAATTTCGGGGCTCAACCCCGAACTTGCAGTGGGTACGGGCAGACTAGAGTGTGGTAGGGGAGACTGGAATTCCTGG	TACGTAGGGTGCGAGCGTTGTCCGGAATTATTGGGCGTAAAGAGCTTGTAGGCGGTTTGTCGCGTCTGCTGTGAAATTTCGGGGCTCAACCCCGAACTTGCAGTGGGTACGGGCAGACTAGAGTGTGGTAGGGGAGACTGGAATTCCTGG	0.0
TACGTAGGGTGCGAGCGTTGTCCGGAATTATTGGGCGTAAAGGGCTCGTAGGCGGTCCGTCACGTCGGGAGTGAAAACTCGGGGCTCAACCCCGAGCCTGCTTCCGATACGGGCGGACTAGAGGTATGCAGGGGAGAATGGAATTCCTGG	TACGTAGGGTGCGAGCGTTGTCCGGAATTATTGGGCGTAAAGGGCTCGTAGGCGGTCCGTCACGTCGGGAGTGAAAACTCGGGGCTCAACCCCGAGCCTGCTTCCGATACGGGCGGACTAGAGGTATGCAGGGGAGAATGGAATTCCTGG	0.0
TACGTAGGGTGCGAGCGTTGTCCGGAATTATTGGGCGTAAAGGGCTCGTAGGCGGTCCGTCACGTCGGGAGTGAAAACTCGGGGCTTAACCCCGAGCCTGCTTCCGATACGGGCGGACTAGAGGTATGCAGGGGAGAATGGAATTCCTGG	TACGTAGGGTGCGAGCGTTGTCCGGAATTATTGGGCGTAAAGGGCTCGTAGGCGGTCCGTCACGTCGGGAGTGAAAACTCGGGGCTTAACCCCGAGCCTGCTTCCGATACGGGCGGACTAGAGGTATGCAGGGGAGAATGGAATTCCTGG	0.0
TACGTAGGGTGCGAGCGTTGTCCGGAATTATTGGGCGTAAAGGGCTCGTAGGCGGTCTGTTGCGTCGGAAGTGAAAACTCGGGGCTTAACCCCGAGCCTGCTCCCGATACGGGCAGACTAGAGGTATGCAGGGGAGAACGGAATTCCTGG	TACGTAGGGTGCGAGCGTTGTCCGGAATTATTGGGCGTAAAGGGCTCGTAGGCGGTCTGTTGCGTCGGAAGTGAAAACTCGGGGCTTAACCCCGAGCCTGCTCCCGATACGGGCAGACTAGAGGTATGCAGGGGAGAACGGAATTCCTGG	0.0
TACGTAGGGTGCGAGCGTTGTCCGGAATTATTGGGCGTAAAGGGCTCGTAGGCGGTTTGTCGCGTCAGGAGTGAAAACTCGGGGCTTAACCCCGAGCCTGCTTCTGATACGGGCAGACTAGAGGTATGCAGGGGAGAACGGAATTCCTGG	TACGTAGGGTGCGAGCGTTGTCCGGAATTATTGGGCGTAAAGGGCTCGTAGGCGGTTTGTCGCGTCAGGAGTGAAAACTCGGGGCTTAACCCCGAGCCTGCTTCTGATACGGGCAGACTAGAGGTATGCAGGGGAGAACGGAATTCCTGG	0.0
TACGTAGGGTGCGAGCGTTGTCCGGAATTATTGGGCGTAAAGGGCTCGTAGGCGGTTTGTCGCGTCGGGAGTGAAAACCATGAGCTTAACTCATGGCTTGCTTTCGATACGGGCAGACTAGAGGTATGCAGGGGAGAACGGAATTCCTGG	TACGTAGGGTGCGAGCGTTGTCCGGAATTATTGGGCGTAAAGGGCTCGTAGGCGGTTTGTCGCGTCGGGAGTGAAAACCATGAGCTTAACTCATGGCTTGCTTTCGATACGGGCAGACTAGAGGTATGCAGGGGAGAACGGAATTCCTGG	0.0
TACGTAGGGTGCGAGCGTTGTCCGGAATTATTGGGCGTAAAGGGCTCGTAGGCGGTTTGTCGCGTCGGGAGTGAAAACGCCGTGCTTAACACGGCGCTTGCTTTCGATACGGGCAGACTGGAGGTATGCAGGGGAGAACGGAATTCCTGG	TACGTAGGGTGCGAGCGTTGTCCGGAATTATTGGGCGTAAAGGGCTCGTAGGCGGTTTGTCGCGTCGGGAGTGAAAACGCCGTGCTTAACACGGCGCTTGCTTTCGATACGGGCAGACTGGAGGTATGCAGGGGAGAACGGAATTCCTGG	0.0
TACGTAGGGTGCGAGCGTTGTCCGGAATTATTGGGCGTAAAGGGCTCGTAGGCGGTTTGTCGCGTCGGGAGTGAAAACTCAGGGCTTAACCCTGAGCCTGCTTCCGATACGGGCAGACTAGAGGTATGCAGGGGAGAACGGAATTCCTGG	TACGTAGGGTGCGAGCGTTGTCCGGAATTATTGGGCGTAAAGGGCTCGTAGGCGGTTTGTCGCGTCGGGAGTGAAAACTCAGGGCTTAACCCTGAGCCTGCTTCCGATACGGGCAGACTAGAGGTATGCAGGGGAGAACGGAATTCCTGG	0.0
TACGTAGGTGGCAAGCGTTGTCCGGAATCACTGGGCGTAAAGCGCGCGCAGGCGGCGATCTACGTCTGGGGTGAAAGCCCGGAGCTCAACTCCGGGACTGCCTTGGATACGGGATCGCTTGAGAATTGGAGAGGCAAGGGGAATTCCACG	TACGTAGGTGGCAAGCGTTGTCCGGAATCACTGGGCGTAAAGCGCGCGCAGGCGGCGATCTACGTCTGGGGTGAAAGCCCGGAGCTCAACTCCGGGACTGCCTTGGATACGGGATCGCTTGAGAATTGGAGAGGCAAGGGGAATTCCACG	0.0
TACGTAGGTGGCAAGCGTTGTCCGGAATTATTGGGCGTAAAGCGCGCGCAGGCGGCCTTTTAAGTCTGATGTGAAAGCCCCCGGCTCAACCGGGGAGGGTCATTGGAAACTGGAAGGCTTGAGTGCAGAAGAGAAGAGCGGAATTCCACG	TACGTAGGTGGCAAGCGTTGTCCGGAATTATTGGGCGTAAAGCGCGCGCAGGCGGCCTTTTAAGTCTGATGTGAAAGCCCCCGGCTCAACCGGGGAGGGTCATTGGAAACTGGAAGGCTTGAGTGCAGAAGAGAAGAGCGGAATTCCACG	0.0
TACGTAGGTGGCAAGCGTTGTCCGGAATTATTGGGCGTAAAGCGCGCGCAGGCGGTCCTTTAAGTCTGATGTGAAAGCCCACGGCTCAACCGTGGAGGGTCATTGGAAACTGGGGGACTTGAGTACAGAAGAGAAGAGTGGAATTCCACG	TACGTAGGTGGCAAGCGTTGTCCGGAATTATTGGGCGTAAAGCGCGCGCAGGCGGTCCTTTAAGTCTGATGTGAAAGCCCACGGCTCAACCGTGGAGGGTCATTGGAAACTGGGGGACTTGAGTACAGAAGAGAAGAGTGGAATTCCACG	0.0
TACGTAGGTGGCAAGCGTTGTCCGGAATTATTGGGCGTAAAGCGCGCGCAGGCGGTCCTTTAAGTCTGATGTGAAAGCCCACGGCTCAACCGTGGAGGGTCATTGGAAACTGGGGGACTTGAGTACAGAAGAGGAAAGCGGAATTCCACG	TACGTAGGTGGCAAGCGTTGTCCGGAATTATTGGGCGTAAAGCGCGCGCAGGCGGTCCTTTAAGTCTGATGTGAAAGCCCACGGCTCAACCGTGGAGGGTCATTGGAAACTGGGGGACTTGAGTACAGAAGAGGAAAGCGGAATTCCACG	0.0
TACGTAGGTGGCAAGCGTTGTCCGGAATTATTGGGCGTAAAGCGCGCGCAGGCGGTCCTTTAAGTCTGATGTGAAAGCCCACGGCTCAACCGTGGAGGGTCATTGGAAACTGGGGGACTTGAGTACAGAAGAGGAAAGTGGAATTCCACG	TACGTAGGTGGCAAGCGTTGTCCGGAATTATTGGGCGTAAAGCGCGCGCAGGCGGTCCTTTAAGTCTGATGTGAAAGCCCACGGCTCAACCGTGGAGGGTCATTGGAAACTGGGGGACTTGAGTACAGAAGAGGAAAGTGGAATTCCACG	0.0
TACGTAGGTGGCAAGCGTTGTCCGGAATTATTGGGCGTAAAGCGCGCGCAGGCGGTCCTTTAAGTCTGATGTGAAAGCCCACGGCTCAACCGTGGAGGGTCATTGGAAACTGGGGGACTTGAGTGCAGGAGAGAAGAGTGGAATTCCACG	TACGTAGGTGGCAAGCGTTGTCCGGAATTATTGGGCGTAAAGCGCGCGCAGGCGGTCCTTTAAGTCTGATGTGAAAGCCCACGGCTCAACCGTGGAGGGTCATTGGAAACTGGGGGACTTGAGTGCAGGAGAGAAGAGTGGAATTCCACG	0.0
TACGTAGGTGGCAAGCGTTGTCCGGAATTATTGGGCGTAAAGCGCGCGCAGGCGGTCCTTTAAGTCTGATGTGAAAGCCCTCGGCTCAACCGAGGAGGGTCATTGGAAACTGGAGGACTTGAGTGCAGAAGAGGAAAGTGGAATTCCAAG	TACGTAGGTGGCAAGCGTTGTCCGGAATTATTGGGCGTAAAGCGCGCGCAGGCGGTCCTTTAAGTCTGATGTGAAAGCCCTCGGCTCAACCGAGGAGGGTCATTGGAAACTGGAGGACTTGAGTGCAGAAGAGGAAAGTGGAATTCCAAG	0.0
TACGTAGGTGGCAAGCGTTGTCCGGAATTATTGGGCGTAAAGCGCGCGCAGGCGGTCTCTTAAGTCTGATGTGAAAGCCCCCGGCTCAACCGGGGAGGGCCATTGGAAACTGGGAGACTTGAGTACAGAAGAGGAGAGTGGAATTCCACG	TACGTAGGTGGCAAGCGTTGTCCGGAATTATTGGGCGTAAAGCGCGCGCAGGCGGTCTCTTAAGTCTGATGTGAAAGCCCCCGGCTCAACCGGGGAGGGCCATTGGAAACTGGGAGACTTGAGTACAGAAGAGGAGAGTGGAATTCCACG	0.0
TACGTAGGTGGCAAGCGTTGTCCGGAATTATTGGGCGTAAAGCGCGCGCAGGCGGTCTCTTAAGTCTGATGTGAAAGCCCCCGGCTCAACCGGGGAGGGTCATTGGAAACTGGGAGACTTGAGTGCAGAAGAGAAGAGTGGAATTCCACG	TACGTAGGTGGCAAGCGTTGTCCGGAATTATTGGGCGTAAAGCGCGCGCAGGCGGTCTCTTAAGTCTGATGTGAAAGCCCCCGGCTCAACCGGGGAGGGTCATTGGAAACTGGGAGACTTGAGTGCAGAAGAGAAGAGTGGAATTCCACG	0.0
TACGTAGGTGGCAAGCGTTGTCCGGAATTATTGGGCGTAAAGCGCGCGCAGGCGGTCTTTTAAGTCTGATGTGAAAGCCCACGGCTCAACCGTGGAGGGTCATTGGAAACTGGAAGACTTGAGTGCAGAAGAGAAGAGCGGAATTCCACG	TACGTAGGTGGCAAGCGTTGTCCGGAATTATTGGGCGTAAAGCGCGCGCAGGCGGTCTTTTAAGTCTGATGTGAAAGCCCACGGCTCAACCGTGGAGGGTCATTGGAAACTGGAAGACTTGAGTGCAGAAGAGAAGAGCGGAATTCCACG	0.0
TACGTAGGTGGCAAGCGTTGTCCGGAATTATTGGGCGTAAAGCGCGCGCAGGCGGTCTTTTAAGTCTGATGTGAAATCTCGGGGCTCAACCCCGAGCGGCCATTGGAAACTGGGAGACTTGAGTACAGAAGAGGAGAGTGGAATTCCACG	TACGTAGGTGGCAAGCGTTGTCCGGAATTATTGGGCGTAAAGCGCGCGCAGGCGGTCTTTTAAGTCTGATGTGAAATCTCGGGGCTCAACCCCGAGCGGCCATTGGAAACTGGGAGACTTGAGTACAGAAGAGGAGAGTGGAATTCCACG	0.0
TACGTAGGTGGCAAGCGTTGTCCGGAATTATTGGGCGTAAAGCGCGCGCAGGCGGTCTTTTAAGTCTGATGTGAAATCTCGGGGCTCAACCCCGAGCGGTCATTGGAAACTGGGAGACTTGAGTACAGAAGAGGAGAGTGGAATTCCACG	TACGTAGGTGGCAAGCGTTGTCCGGAATTATTGGGCGTAAAGCGCGCGCAGGCGGTCTTTTAAGTCTGATGTGAAATCTCGGGGCTCAACCCCGAGCGGTCATTGGAAACTGGGAGACTTGAGTACAGAAGAGGAGAGTGGAATTCCACG	0.0
TACGTAGGTGGCAAGCGTTGTCCGGAATTATTGGGCGTAAAGCGCGCGCAGGCGGTTCCTTAAGTCTGATGTGAAAGCCCACGGCTCAACCGTGGAGGGTCATTGGAAACTGGGGAACTTGAGTGCAGGAGAGAAGAGTGGAATTCCACG	TACGTAGGTGGCAAGCGTTGTCCGGAATTATTGGGCGTAAAGCGCGCGCAGGCGGTTCCTTAAGTCTGATGTGAAAGCCCACGGCTCAACCGTGGAGGGTCATTGGAAACTGGGGAACTTGAGTGCAGGAGAGAAGAGTGGAATTCCACG	0.0
TACGTAGGTGGCAAGCGTTGTCCGGAATTATTGGGCGTAAAGCGCGCGCAGGTGGTCTCTTAAGTCTGATGTGAAAGCCCCCGGCTCAACCGGGGAGGGTCATTGGAAACTGGGAGACTTGAGTGCAGGAGAGAAGAGTGGAATTCCACG	TACGTAGGTGGCAAGCGTTGTCCGGAATTATTGGGCGTAAAGCGCGCGCAGGTGGTCTCTTAAGTCTGATGTGAAAGCCCCCGGCTCAACCGGGGAGGGTCATTGGAAACTGGGAGACTTGAGTGCAGGAGAGAAGAGTGGAATTCCACG	0.0
TACGTAGGTGGCAAGCGTTGTCCGGAATTATTGGGCGTAAAGCGCGCGCAGGTGGTTCCTTAAGTCTGATGTGAAAGCCCACGGCTCAACCGTGGAGGGTCATTGGAAACTGGGGAACTTGAGTGCAGAAGAGGAAAGTGGAATTCCAAG	TACGTAGGTGGCAAGCGTTGTCCGGAATTATTGGGCGTAAAGCGCGCGCAGGTGGTTCCTTAAGTCTGATGTGAAAGCCCACGGCTCAACCGTGGAGGGTCATTGGAAACTGGGGAACTTGAGTGCAGAAGAGGAAAGTGGAATTCCAAG	0.0
TACGTAGGTGGCAAGCGTTGTCCGGAATTATTGGGCGTAAAGCGCGCGCAGGTGGTTCTTTAAGTCTGATGTGAAAGCCCACGGCTCAACCGTGGAGGGTCATTGGAAACTGGGGAACTTGAGTGCAGAAGAGGAAAGTGGAATTCCACG	TACGTAGGTGGCAAGCGTTGTCCGGAATTATTGGGCGTAAAGCGCGCGCAGGTGGTTCTTTAAGTCTGATGTGAAAGCCCACGGCTCAACCGTGGAGGGTCATTGGAAACTGGGGAACTTGAGTGCAGAAGAGGAAAGTGGAATTCCACG	0.0
TACGTAGGTGGCAAGCGTTGTCCGGAATTATTGGGCGTAAAGCGCGCGCAGGTGGTTTCTTAAGTCTGATGTGAAAGCCCACGGCTCAACCGTGGAGGGTCATTGGAAACTGGGGAACTTGAGTGCAGAAGAGGAAAGTGGAATTCCACG	TACGTAGGTGGCAAGCGTTGTCCGGAATTATTGGGCGTAAAGCGCGCGCAGGTGGTTTCTTAAGTCTGATGTGAAAGCCCACGGCTCAACCGTGGAGGGTCATTGGAAACTGGGGAACTTGAGTGCAGAAGAGGAAAGTGGAATTCCACG	0.0
TACGTAGGTGGCAAGCGTTGTCCGGAATTATTGGGCGTAAAGCGTACGCAGGCGGTTTCTTAAGTCTGATGTGAAAGCCCACGGCTCAACCGTGGAGGGTCATTGGAAACTGGGGAACTTGAGTACAGAAGAGGAGAGTGGAATTCCACG	TACGTAGGTGGCAAGCGTTGTCCGGAATTATTGGGCGTAAAGCGTACGCAGGCGGTTTCTTAAGTCTGATGTGAAAGCCCACGGCTCAACCGTGGAGGGTCATTGGAAACTGGGGAACTTGAGTACAGAAGAGGAGAGTGGAATTCCACG	0.0
TACGTAGGTGGCAAGCGTTGTCCGGAATTATTGGGCGTAAAGGGCTCGCAGGCGGTCTTCTAAGTCTGATGTGAAATCTTGCGGCTTAACCGCAAGCGGTCATTGGAAACTGGAGGACTTGAGTACAGAAGAGGAGAGTGGAATTCCACG	TACGTAGGTGGCAAGCGTTGTCCGGAATTATTGGGCGTAAAGGGCTCGCAGGCGGTCTTCTAAGTCTGATGTGAAATCTTGCGGCTTAACCGCAAGCGGTCATTGGAAACTGGAGGACTTGAGTACAGAAGAGGAGAGTGGAATTCCACG	0.0
TACGTAGGTGGCAAGCGTTGTCCGGATTTACTGGGCGTAAAGAGCGCGCAGGCGGTCGTTCAAGTCGAGTGTGAAAGCCCCCGGCTCAACTGGGGAGGGTCACTCGATACTGATCGACTCGAAGGCAGGAGAGGGAAGTGGAATTCCCGG	TACGTAGGTGGCAAGCGTTGTCCGGATTTACTGGGCGTAAAGAGCGCGCAGGCGGTCGTTCAAGTCGAGTGTGAAAGCCCCCGGCTCAACTGGGGAGGGTCACTCGATACTGATCGACTCGAAGGCAGGAGAGGGAAGTGGAATTCCCGG	0.0
TACGTAGGTGGCAAGCGTTGTCCGGATTTACTGGGCGTAAAGAGCGCGCAGGCGGTCGTTCAAGTCGAGTGTGAAAGCCCCCGGCTCAACTGGGGAGGGTCACTCGATACTGATCGACTTGAAGGCAGGAGAGGGTAGTGGAATTCCCGG	TACGTAGGTGGCAAGCGTTGTCCGGATTTACTGGGCGTAAAGAGCGCGCAGGCGGTCGTTCAAGTCGAGTGTGAAAGCCCCCGGCTCAACTGGGGAGGGTCACTCGATACTGATCGACTTGAAGGCAGGAGAGGGTAGTGGAATTCCCGG	0.0
TACGTAGGTGGCAAGCGTTGTCCGGATTTACTGGGCGTAAAGAGCGCGCAGGCGGTCGTTCAAGTCGCGTGTGAAAGCCCCCGGCTCAACTGGGGAGGGTCACGCGATACTGATCGACTCGAAGGCAGGAGAGGGTAGTGGAATTCCCGG	TACGTAGGTGGCAAGCGTTGTCCGGATTTACTGGGCGTAAAGAGCGCGCAGGCGGTCGTTCAAGTCGCGTGTGAAAGCCCCCGGCTCAACTGGGGAGGGTCACGCGATACTGATCGACTCGAAGGCAGGAGAGGGTAGTGGAATTCCCGG	0.0
TACGTAGGTGGCAAGCGTTGTCCGGATTTATTGGGCGTAAAGCGCGCGCAGGCGGTCCTTTAAGTCTGATGTGAAATCTTGCGGCTCAACCGCAAGCGGTCATTGGAAACTGGGGGACTTGAGTACAGAAGAGGAAAGTGGAATTCCACG	TACGTAGGTGGCAAGCGTTGTCCGGATTTATTGGGCGTAAAGCGCGCGCAGGCGGTCCTTTAAGTCTGATGTGAAATCTTGCGGCTCAACCGCAAGCGGTCATTGGAAACTGGGGGACTTGAGTACAGAAGAGGAAAGTGGAATTCCACG	0.0
TACGTAGGTGGCAAGCGTTGTCCGGATTTATTGGGCGTAAAGCGCGCGCAGGCGGTTTCTTAAGTCTGATGTGAAAGCCCCCGGCTTAACCGGGGAGGGTCATTGGAAACTGGGAGACTTGAGTGCAGAAGAGGAAAGTGGAATTCCAAG	TACGTAGGTGGCAAGCGTTGTCCGGATTTATTGGGCGTAAAGCGCGCGCAGGCGGTTTCTTAAGTCTGATGTGAAAGCCCCCGGCTTAACCGGGGAGGGTCATTGGAAACTGGGAGACTTGAGTGCAGAAGAGGAAAGTGGAATTCCAAG	0.0
TACGTAGGTGGCAAGCGTTGTCCGGATTTATTGGGCGTAAAGCGCTCGCAGGCGGTCTTTTAAGTCTGATGTGAAATCTCGCGGCTCAACCGCGAACGGTCATTGGAAACTGGAGGACTTGAGTGCAGAAGAGGAGAGTGGAATTCCACG	TACGTAGGTGGCAAGCGTTGTCCGGATTTATTGGGCGTAAAGCGCTCGCAGGCGGTCTTTTAAGTCTGATGTGAAATCTCGCGGCTCAACCGCGAACGGTCATTGGAAACTGGAGGACTTGAGTGCAGAAGAGGAGAGTGGAATTCCACG	0.0
TACggggggggCAAGCGTTGTTCGGAATTACTGGGCGTAAAGGGCTCGTAGGCGGCCAACTAAGTCGGATGTGAAATCCCCAGGCTCAACCTGGGAACTGCATCCGATACTGGATGGCTTGAATTCGGGAGAGGGATGCAGAATTCCAGG	TACggggggggCAAGCGTTGTTCGGAATTACTGGGCGTAAAGGGCTCGTAGGCGGCCAACTAAGTCGGATGTGAAATCCCCAGGCTCAACCTGGGAACTGCATCCGATACTGGATGGCTTGAATTCGGGAGAGGGATGCAGAATTCCAGG	0.0
TACggggggggCAAGCGTTGTTCGGAATTACTGGGCGTAAAGGGCTCGTAGGCGGCCTGCGAAGTCAGACGTGAAATCCCCCGGCTCAACCGGGGAACTGCGTCTGATACTGGCGGGCTTGAATCCGGGAGAGGGATGCAGAATTCCAGG	TACggggggggCAAGCGTTGTTCGGAATTACTGGGCGTAAAGGGCTCGTAGGCGGCCTGCGAAGTCAGACGTGAAATCCCCCGGCTCAACCGGGGAACTGCGTCTGATACTGGCGGGCTTGAATCCGGGAGAGGGATGCAGAATTCCAGG	0.0
