	sequence	group
GACGAAGGATCCAAGCGTTGTCCGGATTTACTGGGTTTAAAGGGTGCGTAGGCGGAAAATTAAGTCAGTGGTGAAAGCCCGCAGCTCAACTGTGGAACTGCCATTGAAACTGGTTTTCTTGAATATAGCTGAGGCAGATGGAATATAACA	GACGAAGGATCCAAGCGTTGTCCGGATTTACTGGGTTTAAAGGGTGCGTAGGCGGAAAATTAAGTCAGTGGTGAAAGCCCGCAGCTCAACTGTGGAACTGCCATTGAAACTGGTTTTCTTGAATATAGCTGAGGCAGATGGAATATAACA	1.0
TACATAGGGTGCAAGCGTTGTCCGGAATTATTGGGCGTAAAGAGCTCGTAGGTGGTTAGATACGTCGGATGTGAAAATCAGGGGCTCAACCCCTGACCTGCATTCGATACGGTCTAGCTAGAGTGTGGTAGGGGAGACTGGAATTCCTGG	TACATAGGGTGCAAGCGTTGTCCGGAATTATTGGGCGTAAAGAGCTCGTAGGTGGTTAGATACGTCGGATGTGAAAATCAGGGGCTCAACCCCTGACCTGCATTCGATACGGTCTAGCTAGAGTGTGGTAGGGGAGACTGGAATTCCTGG	1.0
TACATAGGGTGCAAGCGTTGTCCGGAATTATTGGGCGTAAAGAGCTCGTAGGTGGTTCGATACGTCGGATGTGAAAATCAGGGGCTCAACCCCTGACCTGCATCCGATACGGTCGAGCTAGAGTTTGGTAGGGGAGACTGGAATTCCTGG	TACATAGGGTGCAAGCGTTGTCCGGAATTATTGGGCGTAAAGAGCTCGTAGGTGGTTCGATACGTCGGATGTGAAAATCAGGGGCTCAACCCCTGACCTGCATCCGATACGGTCGAGCTAGAGTTTGGTAGGGGAGACTGGAATTCCTGG	1.0
TACATAGGGTGCAAGCGTTGTCCGGAATTATTGGGCGTAAAGAGCTCGTAGGTGGTTCGATACGTCGGATGTGAAAATCAGGGGCTCAACCCCTGACCTGCATTCGATACGGTCGAGCTAGAGTGTGGTAGGGGAGACTGGAATTCCTGG	TACATAGGGTGCAAGCGTTGTCCGGAATTATTGGGCGTAAAGAGCTCGTAGGTGGTTCGATACGTCGGATGTGAAAATCAGGGGCTCAACCCCTGACCTGCATTCGATACGGTCGAGCTAGAGTGTGGTAGGGGAGACTGGAATTCCTGG	1.0
TACATAGGGTGCAAGCGTTGTCCGGAATTATTGGGCGTAAAGAGCTCGTAGGTGGTTCGTCACGTCGGATGTGAAACTCTGGGGCTTAACCCCAGACCTGCATTCGATACGGGCGAGCTTGAGTATGGTAGGGGAGTCTGGAATTCCTGG	TACATAGGGTGCAAGCGTTGTCCGGAATTATTGGGCGTAAAGAGCTCGTAGGTGGTTCGTCACGTCGGATGTGAAACTCTGGGGCTTAACCCCAGACCTGCATTCGATACGGGCGAGCTTGAGTATGGTAGGGGAGTCTGGAATTCCTGG	1.0
TACATAGGGTGCAAGCGTTGTCCGGAATTATTGGGCGTAAAGAGCTCGTAGGTGGTTTGATACGTCGGGTGTGAAATTCAGGGGCTCAACCCCTGACCTGCATTCGATACGGTCAAGCTAGAGTTTGGTAGGGGAGACTGGAATTCCTGG	TACATAGGGTGCAAGCGTTGTCCGGAATTATTGGGCGTAAAGAGCTCGTAGGTGGTTTGATACGTCGGGTGTGAAATTCAGGGGCTCAACCCCTGACCTGCATTCGATACGGTCAAGCTAGAGTTTGGTAGGGGAGACTGGAATTCCTGG	1.0
TACATAGGGTGCAAGCGTTGTCCGGAATTATTGGGCGTAAAGAGCTCGTAGGTGGTTTGTTACGTCGGATGTGAAATTCAGGGGCTCAACCCCTGACTTGCATCCGATACGGGCAAGCTAGAGTTTGGTAGGGGAGACTGGAATTCCTGG	TACATAGGGTGCAAGCGTTGTCCGGAATTATTGGGCGTAAAGAGCTCGTAGGTGGTTTGTTACGTCGGATGTGAAATTCAGGGGCTCAACCCCTGACTTGCATCCGATACGGGCAAGCTAGAGTTTGGTAGGGGAGACTGGAATTCCTGG	1.0
TACATAGGGTGCAAGCGTTGTCCGGAATTATTGGGCGTAAAGAGCTCGTAGGTGGTTTGTTACGTCGGTTGTGAAATTCAGGGGCTCAACCCCTGACTTGCAGCCGATACGGGCAAGCTAGAGTTTGGTAGGGGAGACTGGAATTCCTGG	TACATAGGGTGCAAGCGTTGTCCGGAATTATTGGGCGTAAAGAGCTCGTAGGTGGTTTGTTACGTCGGTTGTGAAATTCAGGGGCTCAACCCCTGACTTGCAGCCGATACGGGCAAGCTAGAGTTTGGTAGGGGAGACTGGAATTCCTGG	1.0
TACGAAAGGTGCAAGCGTTGTTCGGATTTACTGGGCGTAAAGCGAGTGTAGGTTGTTTATTAAGTCGGATGTGAAATCCCGGGGCTCAACCCCGGAACTGCATTCGATACTGATAGGCTAGAGTTCGGGAGGGGTAAGCGGAATTCCGTG	TACGAAAGGTGCAAGCGTTGTTCGGATTTACTGGGCGTAAAGCGAGTGTAGGTTGTTTATTAAGTCGGATGTGAAATCCCGGGGCTCAACCCCGGAACTGCATTCGATACTGATAGGCTAGAGTTCGGGAGGGGTAAGCGGAATTCCGTG	1.0
TACGGAGGATCCAAGCGTTATCCGGAATCATTGGGTTTAAAGGGTCCGTAGGCGGTCTTATAAGTCAGTGGTGAAATCCCATCGCTCAACGATGGAACTGCCATTGATACTGTAAGACTTGAATACTTAGGAAGTAACTAGAATATGTAG	TACGGAGGATCCAAGCGTTATCCGGAATCATTGGGTTTAAAGGGTCCGTAGGCGGTCTTATAAGTCAGTGGTGAAATCCCATCGCTCAACGATGGAACTGCCATTGATACTGTAAGACTTGAATACTTAGGAAGTAACTAGAATATGTAG	1.0
TACGGAGGATCCAAGCGTTATCCGGATTTATTGGGTTTAAAGGGTGCGTAGGCGGCGTTGTAAGTCAGTGGTGAAAGTTTGCAGCTTAACTGTAAAATTGCCATTGATACTGCAGTGCTTGAGTACAGATGAGGTGGGCGGAATGTGTCA	TACGGAGGATCCAAGCGTTATCCGGATTTATTGGGTTTAAAGGGTGCGTAGGCGGCGTTGTAAGTCAGTGGTGAAAGTTTGCAGCTTAACTGTAAAATTGCCATTGATACTGCAGTGCTTGAGTACAGATGAGGTGGGCGGAATGTGTCA	1.0
TACGGAGGATCCAAGCGTTATCCGGATTTATTGGGTTTAAAGGGTGCGTAGGCGGCGTTGTAAGTCAGTGGTGAAAGTTTTCAGCTTAACTGGAAAATTGCCATTGATACTGCAGTGCTTGAGTATAGATGAGGTGGGCGGAATGTGTCA	TACGGAGGATCCAAGCGTTATCCGGATTTATTGGGTTTAAAGGGTGCGTAGGCGGCGTTGTAAGTCAGTGGTGAAAGTTTTCAGCTTAACTGGAAAATTGCCATTGATACTGCAGTGCTTGAGTATAGATGAGGTGGGCGGAATGTGTCA	1.0
TACGGAGGATGCAAGCGTTATCCGGATTTATTGGGTTTAAAGGGTCCGTAGGCGGATCTTTAAGTCAGTGGTGAAAGCCCACAGCTCAACTGTGGAACTGCCATTGATACTGGAGATCTTGAGTGTAGTAGAAGTAGGCGGAATAGGGCA	TACGGAGGATGCAAGCGTTATCCGGATTTATTGGGTTTAAAGGGTCCGTAGGCGGATCTTTAAGTCAGTGGTGAAAGCCCACAGCTCAACTGTGGAACTGCCATTGATACTGGAGATCTTGAGTGTAGTAGAAGTAGGCGGAATAGGGCA	1.0
TACGGAGGGAGCTAGCGTTGTTCGGAATCACTGGGCGTAAAGCGTGCGTAGGCGGTGACTCAAGTCAGAGGTGAAAGCCTGGAGCTCAACTCCAGAACTGCCTTTGAAACTAGGTCGCTAGAACATCGGAGAGGTGAGTGGAATTCCGAG	TACGGAGGGAGCTAGCGTTGTTCGGAATCACTGGGCGTAAAGCGTGCGTAGGCGGTGACTCAAGTCAGAGGTGAAAGCCTGGAGCTCAACTCCAGAACTGCCTTTGAAACTAGGTCGCTAGAACATCGGAGAGGTGAGTGGAATTCCGAG	1.0
TACGGAGGGAGCTAGCGTTGTTCGGAATTACTGGGCGTAAAGAGTACGTAGGCGGTGATTCAAGTCAGAGGTGAAAGCCTGGAGCTCAACTCCAGAACTGCCTTTGAAACTAGATCGCTAGAATTATGGAGAGGTTAGTGGAATTCCGAG	TACGGAGGGAGCTAGCGTTGTTCGGAATTACTGGGCGTAAAGAGTACGTAGGCGGTGATTCAAGTCAGAGGTGAAAGCCTGGAGCTCAACTCCAGAACTGCCTTTGAAACTAGATCGCTAGAATTATGGAGAGGTTAGTGGAATTCCGAG	1.0
TACGGAGGGAGCTAGCGTTGTTCGGAATTACTGGGCGTAAAGAGTACGTAGGCGGTTATTCAAGTCAGAGGTGAAAGCCTGGAGCTCAACTCCAGAACTGCCTTTGAAACTAGATAGCTAGAATCTTGGAGAGGTGAGTGGAATTCCGAG	TACGGAGGGAGCTAGCGTTGTTCGGAATTACTGGGCGTAAAGAGTACGTAGGCGGTTATTCAAGTCAGAGGTGAAAGCCTGGAGCTCAACTCCAGAACTGCCTTTGAAACTAGATAGCTAGAATCTTGGAGAGGTGAGTGGAATTCCGAG	1.0
TACGGAGGGGGCTAGCGTTATTCGGAATTACTGGGCGTAAAGCGCACGTAGGCGGACCAGAAAGTCAGAGGTGAAAGCCCGGGGCTCAACCCCGGAACTGCCTTTGAAACTCCTGGTCTTGAGGTCGAGAGAGGTGAGTGGAATTCCGAG	TACGGAGGGGGCTAGCGTTATTCGGAATTACTGGGCGTAAAGCGCACGTAGGCGGACCAGAAAGTCAGAGGTGAAAGCCCGGGGCTCAACCCCGGAACTGCCTTTGAAACTCCTGGTCTTGAGGTCGAGAGAGGTGAGTGGAATTCCGAG	1.0
TACGGAGGGTGCAAGCGTTATCCGGAATCATTGGGTTTAAAGGGTCCGCAGGCGGATTTATAAGTCAGTGGTGAAATCCTATCGCTTAACGATAGAACTGCCATTGATACTGTAAGTCTTGAATTCGGTCGGAGTGGGCGGAATGTGTAG	TACGGAGGGTGCAAGCGTTATCCGGAATCATTGGGTTTAAAGGGTCCGCAGGCGGATTTATAAGTCAGTGGTGAAATCCTATCGCTTAACGATAGAACTGCCATTGATACTGTAAGTCTTGAATTCGGTCGGAGTGGGCGGAATGTGTAG	1.0
TACGGAGGGTGCAAGCGTTATCCGGATTCACTGGGTTTAAAGGGTGCGTAGGCGGGCAGGTAAGTCAGTGGTGAAATCCTGGAGCTCAACTCCAGAACTGCCATTGATACTATCTGTCTTGAATATTGTGGAGGTAAGCGGAATATGTCA	TACGGAGGGTGCAAGCGTTATCCGGATTCACTGGGTTTAAAGGGTGCGTAGGCGGGCAGGTAAGTCAGTGGTGAAATCCTGGAGCTCAACTCCAGAACTGCCATTGATACTATCTGTCTTGAATATTGTGGAGGTAAGCGGAATATGTCA	1.0
TACGGAGGGTGCAAGCGTTATCCGGATTCACTGGGTTTAAAGGGTGCGTAGGCGGGTAGGTAAGTCAGTGGTGAAATCCTGGAGCTCAACTCCAGAACTGCCATTGATACTATCTATCTTGAATATTGTGGAGGTAAGCGGAATATGTCA	TACGGAGGGTGCAAGCGTTATCCGGATTCACTGGGTTTAAAGGGTGCGTAGGCGGGTAGGTAAGTCAGTGGTGAAATCCTGGAGCTCAACTCCAGAACTGCCATTGATACTATCTATCTTGAATATTGTGGAGGTAAGCGGAATATGTCA	1.0
TACGGAGGGTGCAAGCGTTATCCGGATTCACTGGGTTTAAAGGGTGTGTAGGCGGGCTTGTAAGTCCGAGGTGAAATCTCCGAGCTCAACTTGGAAACTGCCTTGGATACTATAGGTCTTGAATATCGTTGAGGTAGGCGGAATATGTCA	TACGGAGGGTGCAAGCGTTATCCGGATTCACTGGGTTTAAAGGGTGTGTAGGCGGGCTTGTAAGTCCGAGGTGAAATCTCCGAGCTCAACTTGGAAACTGCCTTGGATACTATAGGTCTTGAATATCGTTGAGGTAGGCGGAATATGTCA	1.0
TACGGAGGGTGCAAGCGTTGTCCGGATTTATTGGGTTTAAAGGGTGCGCAGGTGGTTTATTAAGTCAGTGGTGAAAGACGGTCGCTCAACGATTGCAGTGCCATTGAAACTGGTAGACTTGAGTAAAGTAGAGGTGGGCGGAATTGATAG	TACGGAGGGTGCAAGCGTTGTCCGGATTTATTGGGTTTAAAGGGTGCGCAGGTGGTTTATTAAGTCAGTGGTGAAAGACGGTCGCTCAACGATTGCAGTGCCATTGAAACTGGTAGACTTGAGTAAAGTAGAGGTGGGCGGAATTGATAG	1.0
TACGGAGGGTGCAAGCGTTGTTCGGAATTATTGGGCGTAAAGCGCGTGTAGGCGGTCTGTTAAGTCTGGTGTGAAAGCCCTGGGCTCAACCCAGGAAGTGCATTGGATACTGGCAGACTTGAGTATGGGAGAGGAAAGCGGAATTCCGAG	TACGGAGGGTGCAAGCGTTGTTCGGAATTATTGGGCGTAAAGCGCGTGTAGGCGGTCTGTTAAGTCTGGTGTGAAAGCCCTGGGCTCAACCCAGGAAGTGCATTGGATACTGGCAGACTTGAGTATGGGAGAGGAAAGCGGAATTCCGAG	1.0
TACGTAGGGTGCAAGCGTTAATCGGAATTACTGGGCGTAAAGCGTGCGCAGGCGGTTATATAAGACAGATGTGAAATCCCCGGGCTCAACCTGGGAACTGCATTTGTGACTGTATAGCTGGAGTGCGGCAGAGGGGGATGGAATTCCGCG	TACGTAGGGTGCAAGCGTTAATCGGAATTACTGGGCGTAAAGCGTGCGCAGGCGGTTATATAAGACAGATGTGAAATCCCCGGGCTCAACCTGGGAACTGCATTTGTGACTGTATAGCTGGAGTGCGGCAGAGGGGGATGGAATTCCGCG	1.0
TACGTAGGGTGCAAGCGTTAATCGGAATTACTGGGCGTAAAGCGTGCGCAGGCGGTTATGTAAGACAGGCGTGAAATCCCCGGGCTTAACCTGGGAATTGCGCTTGTGACTGCATAGCTAGAGTATGTCAGAGGGGGGTAGAATTCCACG	TACGTAGGGTGCAAGCGTTAATCGGAATTACTGGGCGTAAAGCGTGCGCAGGCGGTTATGTAAGACAGGCGTGAAATCCCCGGGCTTAACCTGGGAATTGCGCTTGTGACTGCATAGCTAGAGTATGTCAGAGGGGGGTAGAATTCCACG	1.0
TACGTAGGGTGCAAGCGTTGTCCGGATTTATTGGGCGTAAAGAGCTCGTAGGCGGTTAGACACGTCGGATGTGAAAACTGGGGGCTCAACCCCCAGCCTGCATTCGATACGGTCTGACTAGAGTGTGGTAGGGGTAACTGGAATTCCTGG	TACGTAGGGTGCAAGCGTTGTCCGGATTTATTGGGCGTAAAGAGCTCGTAGGCGGTTAGACACGTCGGATGTGAAAACTGGGGGCTCAACCCCCAGCCTGCATTCGATACGGTCTGACTAGAGTGTGGTAGGGGTAACTGGAATTCCTGG	1.0
TACGTAGGGTGCGAGCGTTAATCGGAATTACTGGGCGTAAAGCGTGCGCAGGCGGTCTTGCAAGACAGGTGTGAAATCCCCGGGCTTAACCTGGGAACTGCACTTGTGACTGCAAGGCTGGAGTACGGCAGAGGGGGATGGAATTCCGCG	TACGTAGGGTGCGAGCGTTAATCGGAATTACTGGGCGTAAAGCGTGCGCAGGCGGTCTTGCAAGACAGGTGTGAAATCCCCGGGCTTAACCTGGGAACTGCACTTGTGACTGCAAGGCTGGAGTACGGCAGAGGGGGATGGAATTCCGCG	1.0
TACGTAGGGTGCGAGCGTTAATCGGAATTACTGGGCGTAAAGCGTGCGCAGGCGGTTATACAAGACAGGCGTGAAATCCCCGGGCTTAACCTGGGAATGGCGCCTGTGACTGTATAGCTAGAGTGTGTCAGAGGGGGGTAGAATTCCACG	TACGTAGGGTGCGAGCGTTAATCGGAATTACTGGGCGTAAAGCGTGCGCAGGCGGTTATACAAGACAGGCGTGAAATCCCCGGGCTTAACCTGGGAATGGCGCCTGTGACTGTATAGCTAGAGTGTGTCAGAGGGGGGTAGAATTCCACG	1.0
TACGTAGGGTGCGAGCGTTAATCGGAATTACTGGGCGTAAAGCGTGCGCAGGCGGTTGTGCAAGACAGATGTGAAATCCCCGGGCTCAACCTGGGAATTGCATTTGTGACTGCACGGCTAGAGTGTGTCAGAGGGGGGTAGAATTCCACG	TACGTAGGGTGCGAGCGTTAATCGGAATTACTGGGCGTAAAGCGTGCGCAGGCGGTTGTGCAAGACAGATGTGAAATCCCCGGGCTCAACCTGGGAATTGCATTTGTGACTGCACGGCTAGAGTGTGTCAGAGGGGGGTAGAATTCCACG	1.0
TACGTAGGGTGCGAGCGTTAATCGGAATTACTGGGCGTAAAGCGTGCGCAGGCGGTTTTGTAAGTCGGATGTGAAATCCCCGGGCTCAACCTGGGAACTGCGTTCGAAACTGCAAGGCTAGAGTGTGTCAGAGGGGGGTAGAATTCCACG	TACGTAGGGTGCGAGCGTTAATCGGAATTACTGGGCGTAAAGCGTGCGCAGGCGGTTTTGTAAGTCGGATGTGAAATCCCCGGGCTCAACCTGGGAACTGCGTTCGAAACTGCAAGGCTAGAGTGTGTCAGAGGGGGGTAGAATTCCACG	1.0
CACGTAGGCACCAAGCGTTATCCGGATTTATTGGGCGTAAAGAGCTCGTAGGCGGTTCAGTCAGTCGGGTGTGAAAACTTGAGGCTTAACCTCAAGAGGTCACTCGATACTACTGTGACTAGAGTGCGGTAGGGGAGCGGGGAATTCCTG	CACGTAGGCACCAAGCGTTATCCGGATTTATTGGGCGTAAAGAGCTCGTAGGCGGTTCAGTCAGTCGGGTGTGAAAACTTGAGGCTTAACCTCAAGAGGTCACTCGATACTACTGTGACTAGAGTGCGGTAGGGGAGCGGGGAATTCCTG	0.0
GACAGGAGGAGCGAGTGTTATTCGAATTAATTGGGCGTAAAGGGCATGTAGGTGGAGAGATGTAGTTGTTTGTGAAAGTCCAAAGGGTTTCTTTGGGTGTGCATTCAAGACGGTTTCTTCTCTTTGAGGGTGTAAGAGGAAAATAGAATT	GACAGGAGGAGCGAGTGTTATTCGAATTAATTGGGCGTAAAGGGCATGTAGGTGGAGAGATGTAGTTGTTTGTGAAAGTCCAAAGGGTTTCTTTGGGTGTGCATTCAAGACGGTTTCTTCTCTTTGAGGGTGTAAGAGGAAAATAGAATT	0.0
TACAGAGGATGCAAGCGTTATCCGGAATCACTGGGCATAAAGCGTCTGTAGGTGGTTCGGTAAGTCTGCTGTTAAAGACTAGGGCCTAACCCTAGAAAAGCAGTGGAAACTGCCAAACTTGAGTGTGGTAGAGGTAGAGGGAATTCCTAG	TACAGAGGATGCAAGCGTTATCCGGAATCACTGGGCATAAAGCGTCTGTAGGTGGTTCGGTAAGTCTGCTGTTAAAGACTAGGGCCTAACCCTAGAAAAGCAGTGGAAACTGCCAAACTTGAGTGTGGTAGAGGTAGAGGGAATTCCTAG	0.0
TACAGAGGATGCAAGCGTTATCCGGAATCACTGGGCATAAAGCGTCTGTAGGTTGTTTAGTAAGTCTGCTGTTAAAGACTGGGGCTCAACCCCAGAAAAGCAGTGGAAACTGCTAGACTTGAGTGTGGTAGAGGTAGAGGGAATTCCTAG	TACAGAGGATGCAAGCGTTATCCGGAATCACTGGGCATAAAGCGTCTGTAGGTTGTTTAGTAAGTCTGCTGTTAAAGACTGGGGCTCAACCCCAGAAAAGCAGTGGAAACTGCTAGACTTGAGTGTGGTAGAGGTAGAGGGAATTCCTAG	0.0
TACAGAGGGTGCAAACGTTGCTCGGATTTACTGGGCGTAAAGCGCGTGTAGGCGGACTCGCAAGTCGGTTGTGAAATCCCTGGGCTCAACCTAGGAACTGCATCCGAAACTGCTTGTCTTGAGTAATGGAGAGGGTGGCGGAATTCCCGG	TACAGAGGGTGCAAACGTTGCTCGGATTTACTGGGCGTAAAGCGCGTGTAGGCGGACTCGCAAGTCGGTTGTGAAATCCCTGGGCTCAACCTAGGAACTGCATCCGAAACTGCTTGTCTTGAGTAATGGAGAGGGTGGCGGAATTCCCGG	0.0
TACAGAGGGTGCAAGCGTTAATCGGAATTACTGGGCGTAAAGCGCGCGTAGGCGGCTTGGTCAGTCGGATGTGAAAGCCCCGGGCTTAACCTGGGAATTGCATTCGATACTGCCAGGCTAGAATGTAGTAGAGGGAAGTGGAATTCCAGG	TACAGAGGGTGCAAGCGTTAATCGGAATTACTGGGCGTAAAGCGCGCGTAGGCGGCTTGGTCAGTCGGATGTGAAAGCCCCGGGCTTAACCTGGGAATTGCATTCGATACTGCCAGGCTAGAATGTAGTAGAGGGAAGTGGAATTCCAGG	0.0
TACAGAGGGTGCAAGCGTTAATCGGAATTACTGGGCGTAAAGCGCGCGTAGGCGGTTTGTTAAGTCGGATGTGAAAGCCCCGGGCTCAACCTGGGAACTGCATTCGATACTGGCAGGCTAGAGTATGGTAGAGGGAAGTGGAATTCCGGG	TACAGAGGGTGCAAGCGTTAATCGGAATTACTGGGCGTAAAGCGCGCGTAGGCGGTTTGTTAAGTCGGATGTGAAAGCCCCGGGCTCAACCTGGGAACTGCATTCGATACTGGCAGGCTAGAGTATGGTAGAGGGAAGTGGAATTCCGGG	0.0
TACAGAGGGTGCGAACGTTGCTCGGATTTACTGGGCGTAAAGCGCGTGTAGGCGGACTCGCAAGTCGGTTGTGAAATCCCTGGGCTCAACCTAGGAACTGCATCCGAAACTGCTTGTCTTGAGTAATGGAGAGGGTGGCGGAATTCCCGG	TACAGAGGGTGCGAACGTTGCTCGGATTTACTGGGCGTAAAGCGCGTGTAGGCGGACTCGCAAGTCGGTTGTGAAATCCCTGGGCTCAACCTAGGAACTGCATCCGAAACTGCTTGTCTTGAGTAATGGAGAGGGTGGCGGAATTCCCGG	0.0
TACAGAGGGTGCGAACGTTGCTCGGATTTACTGGGCGTAAAGCGCGTGTAGGCGGACTCGCAAGTCGGTTGTGAAATCCCTGGGCTTAACCTAGGAACTGCATCCGAAACTGCTTGTCTTGAGTAATGGAGAGGGTGGCGGAATTCCCGG	TACAGAGGGTGCGAACGTTGCTCGGATTTACTGGGCGTAAAGCGCGTGTAGGCGGACTCGCAAGTCGGTTGTGAAATCCCTGGGCTTAACCTAGGAACTGCATCCGAAACTGCTTGTCTTGAGTAATGGAGAGGGTGGCGGAATTCCCGG	0.0
TACAGAGGGTGCGAGCGTTAATCGGAATTACTGGGCGTAAAGCGCGCGTAGGCGGCTTGGTCAGTCGGATGTGAAAGCCCCGGGCTTAACCTGGGAATTGCATTCGATACTGCCTGGCTAGAATGTAGTAGAGGGAAGTGGAATTCCAGG	TACAGAGGGTGCGAGCGTTAATCGGAATTACTGGGCGTAAAGCGCGCGTAGGCGGCTTGGTCAGTCGGATGTGAAAGCCCCGGGCTTAACCTGGGAATTGCATTCGATACTGCCTGGCTAGAATGTAGTAGAGGGAAGTGGAATTCCAGG	0.0
TACAGAGGGTGCGAGCGTTAATCGGATTTACTGGGCGTAAAGCGTGCGTAGGCGGCTGATTAAGTCGGATGTGAAATCCCTGAGCTTAACTTAGGAATTGCATTCGATACTGGTCAGCTAGAGTATGGGAGAGGATGGTAGAATTCCAGG	TACAGAGGGTGCGAGCGTTAATCGGATTTACTGGGCGTAAAGCGTGCGTAGGCGGCTGATTAAGTCGGATGTGAAATCCCTGAGCTTAACTTAGGAATTGCATTCGATACTGGTCAGCTAGAGTATGGGAGAGGATGGTAGAATTCCAGG	0.0
TACATAGGGGTCAAGCGTTGTCCGGATTTATTGGGCGTAAAGAGCTCGTAGGCGGTTCAACAAGTCGGTCGTAAAAGTTTAGGGCTCAACCCTAAAATGTCGATCGATACTGTTGTGACTAGGATACGGTAGAGGTGAATGGAATTCCGA	TACATAGGGGTCAAGCGTTGTCCGGATTTATTGGGCGTAAAGAGCTCGTAGGCGGTTCAACAAGTCGGTCGTAAAAGTTTAGGGCTCAACCCTAAAATGTCGATCGATACTGTTGTGACTAGGATACGGTAGAGGTGAATGGAATTCCGA	0.0
TACGAAGGGACCTAGCGTAGTTCGGAATTACTGGGCGTAAAGAGTATGTAGGCGGCTAGATAAGTTAATTGTGAAAGCCCAAAGCTTAACTTTGGAACTGCAATTAAAACTATTTAGCTGGAGTATGATAGAGGAAAGCGGAATACATAG	TACGAAGGGACCTAGCGTAGTTCGGAATTACTGGGCGTAAAGAGTATGTAGGCGGCTAGATAAGTTAATTGTGAAAGCCCAAAGCTTAACTTTGGAACTGCAATTAAAACTATTTAGCTGGAGTATGATAGAGGAAAGCGGAATACATAG	0.0
TACGAAGGGACCTAGCGTAGTTCGGAATTACTGGGCGTAAAGAGTATGTAGGCGGCTAGATAAGTTAATTGTGAAAGCCCAAAGCTTAACTTTGGAATTGCAATTAAAACTATTTAGCTAGAGTATGATAGAGGAAAGCGGAATACATAG	TACGAAGGGACCTAGCGTAGTTCGGAATTACTGGGCGTAAAGAGTATGTAGGCGGCTAGATAAGTTAATTGTGAAAGCCCAAAGCTTAACTTTGGAATTGCAATTAAAACTATTTAGCTAGAGTATGATAGAGGAAAGCGGAATACATAG	0.0
TACGAAGGGACCTAGCGTAGTTCGGAATTACTGGGCTTAAAGAGCTCGTAGGTGGTTAAAAAAGTTGATGGTGAAATCCCAAGGCTCAACCTTGGAACTGCCATCAAAACTTTTTAGCTAGAGTGTGATAGAGGTAAGTGGAATTTCTAG	TACGAAGGGACCTAGCGTAGTTCGGAATTACTGGGCTTAAAGAGCTCGTAGGTGGTTAAAAAAGTTGATGGTGAAATCCCAAGGCTCAACCTTGGAACTGCCATCAAAACTTTTTAGCTAGAGTGTGATAGAGGTAAGTGGAATTTCTAG	0.0
TACGAAGGGACCTAGCGTAGTTCGGAATTACTGGGCTTAAAGAGTTCGTAGGTGGTTGAAAAAGTTAGTGGTGAAATCCCAGAGCTTAACTCTGGAACTGCCATTAAAACTTTTCAGCTAGAGTATGATAGAGGAAAGCAGAATTTCTAG	TACGAAGGGACCTAGCGTAGTTCGGAATTACTGGGCTTAAAGAGTTCGTAGGTGGTTGAAAAAGTTAGTGGTGAAATCCCAGAGCTTAACTCTGGAACTGCCATTAAAACTTTTCAGCTAGAGTATGATAGAGGAAAGCAGAATTTCTAG	0.0
TACGAAGGGGGCGAGCGTTATTCGGAATTATTGGGCGTAAAGGGCTCGCAGGCTGCTTGAACAGTTAGACGTGAAATCCCCGGGCTTAACCTGGGAACTGCGTTTAATACTAGCAAGCTAGAGAAATAGAGAGGAAAGTGGAACTCCCAG	TACGAAGGGGGCGAGCGTTATTCGGAATTATTGGGCGTAAAGGGCTCGCAGGCTGCTTGAACAGTTAGACGTGAAATCCCCGGGCTTAACCTGGGAACTGCGTTTAATACTAGCAAGCTAGAGAAATAGAGAGGAAAGTGGAACTCCCAG	0.0
TACGAAGGGGGCGAGCGTTGTTCGGAATTACTGGGCGTAAAGGGCGCGTAGGCGGTCTTTTAAGTTAGGCGTGAAAGCCCCGGGCTCAACCCGGGAACTGCGCTTAAGACTGGAAGACTAGAAAACGGAAGAGGGTAGTGGAATTCCCAG	TACGAAGGGGGCGAGCGTTGTTCGGAATTACTGGGCGTAAAGGGCGCGTAGGCGGTCTTTTAAGTTAGGCGTGAAAGCCCCGGGCTCAACCCGGGAACTGCGCTTAAGACTGGAAGACTAGAAAACGGAAGAGGGTAGTGGAATTCCCAG	0.0
TACGAGGGGTGCAAGCGTTAATCGGAATTACTGGGCGTAAAGCGTGCGTAGGCGGTTTGTTAAGCAAGATGTGAAAGCCCCGGGCTCAACCTGGGAACTGCATTTTGAACTGGCAGGCTAGAGTACTGTAGAGGGTGGTGGAATTTCCAG	TACGAGGGGTGCAAGCGTTAATCGGAATTACTGGGCGTAAAGCGTGCGTAGGCGGTTTGTTAAGCAAGATGTGAAAGCCCCGGGCTCAACCTGGGAACTGCATTTTGAACTGGCAGGCTAGAGTACTGTAGAGGGTGGTGGAATTTCCAG	0.0
TACGGAAGGTCCAAGCGTTAATCGGAATTACTGGGCGTAAAGCGCGCGTAGGTGGTTTATTAAGTTGGATGTGAAATCCCCGGGCTCAACCTGGGAACTGCATCCAAAACTGATTCACTAGAGTACGATAGAGGGAGGTAGAATTCACAG	TACGGAAGGTCCAAGCGTTAATCGGAATTACTGGGCGTAAAGCGCGCGTAGGTGGTTTATTAAGTTGGATGTGAAATCCCCGGGCTCAACCTGGGAACTGCATCCAAAACTGATTCACTAGAGTACGATAGAGGGAGGTAGAATTCACAG	0.0
TACGGAAGGTGCAAGCGTTAATCGGAATTACTGGGCGTAAAGCGCGCGTAGGTGGTTTGTTAAGTTGGATGTGAAAGCCCTGGGCTCAACCTAGGAACTGCATCCAAAACTAACTCACTAGAGTACGATAGAGGGAGGTAGAATTCATAG	TACGGAAGGTGCAAGCGTTAATCGGAATTACTGGGCGTAAAGCGCGCGTAGGTGGTTTGTTAAGTTGGATGTGAAAGCCCTGGGCTCAACCTAGGAACTGCATCCAAAACTAACTCACTAGAGTACGATAGAGGGAGGTAGAATTCATAG	0.0
TACGGAAGGTGCAAGCGTTAATCGGAATTACTGGGCGTAAAGCGCGCGTAGGTGGTTTGTTAAGTTGGATGTGAAAGCCCTGGGCTTAACCTAGGAACTGCATCCAAAACTAACTCACTAGAGTACGATAGAGGGAGGTAGAATTCATAG	TACGGAAGGTGCAAGCGTTAATCGGAATTACTGGGCGTAAAGCGCGCGTAGGTGGTTTGTTAAGTTGGATGTGAAAGCCCTGGGCTTAACCTAGGAACTGCATCCAAAACTAACTCACTAGAGTACGATAGAGGGAGGTAGAATTCATAG	0.0
TACGGAAGGTGCGAGCGTTAATCGGAATTACTGGGCGTAAAGCGCGCGTAGGCGGCTGAGTAAGTCGGATGTGAAAGCCCTGGGCTTAACCTGGGAATTGCATTCGAAACTGCTCAACTAGAGTATGGAAGAGGAAAGCGGAATTCCCGG	TACGGAAGGTGCGAGCGTTAATCGGAATTACTGGGCGTAAAGCGCGCGTAGGCGGCTGAGTAAGTCGGATGTGAAAGCCCTGGGCTTAACCTGGGAATTGCATTCGAAACTGCTCAACTAGAGTATGGAAGAGGAAAGCGGAATTCCCGG	0.0
TACGGAGGATCCAAGCGTTATCCGGAATCATTGGGTTTAAAGGGTCCGTAGGCGGTTTTTTAAGTCAGAGGTGAAATCCTGCAGCTCAACTGTAGCATTGCCTTTGATACTGAAAGACTTGAGTTATTGTGAAGTAGTTAGAATGTGTAG	TACGGAGGATCCAAGCGTTATCCGGAATCATTGGGTTTAAAGGGTCCGTAGGCGGTTTTTTAAGTCAGAGGTGAAATCCTGCAGCTCAACTGTAGCATTGCCTTTGATACTGAAAGACTTGAGTTATTGTGAAGTAGTTAGAATGTGTAG	0.0
TACGGAGGATCCAAGCGTTATCCGGAATTATTGGGTTTAAAGGGTCCGCAGGCTGTTTGTTAAGTCAGAGGTGAAATCCTACCGCTCAACGGTAGAACTGCCCTTGATACTGGCAAACTTGAGTTATTGTGAAGTAGTTAGAATGTGTAG	TACGGAGGATCCAAGCGTTATCCGGAATTATTGGGTTTAAAGGGTCCGCAGGCTGTTTGTTAAGTCAGAGGTGAAATCCTACCGCTCAACGGTAGAACTGCCCTTGATACTGGCAAACTTGAGTTATTGTGAAGTAGTTAGAATGTGTAG	0.0
TACGGAGGGAGCGAGCGTTAATCGGAATTACTGGGCGTAAAGCGCGCGTAGGCGGCTTTGTAAGTCGGATGTGAAAGCCCAGGGCTTAACCCTGGAATTGCATTCGATACTGCATAGCTAGAGTATGGTAGAGGGAAGTGGAATTTCCGG	TACGGAGGGAGCGAGCGTTAATCGGAATTACTGGGCGTAAAGCGCGCGTAGGCGGCTTTGTAAGTCGGATGTGAAAGCCCAGGGCTTAACCCTGGAATTGCATTCGATACTGCATAGCTAGAGTATGGTAGAGGGAAGTGGAATTTCCGG	0.0
TACGGAGGGAGCGAGCGTTAATCGGAATTACTGGGCGTAAAGCGCGCGTAGGCGGCTTTGTAAGTCGGATGTGAAAGCCCTGGGCTCAACCTGGGAATGGCATTCGATACTGCAGAGCTAGAGTATGGTAGAGGGAAGTGGAATTTCCGG	TACGGAGGGAGCGAGCGTTAATCGGAATTACTGGGCGTAAAGCGCGCGTAGGCGGCTTTGTAAGTCGGATGTGAAAGCCCTGGGCTCAACCTGGGAATGGCATTCGATACTGCAGAGCTAGAGTATGGTAGAGGGAAGTGGAATTTCCGG	0.0
TACGGAGGGAGCGAGCGTTAATCGGAATTACTGGGCGTAAAGCGCGCGTAGGCGGCTTTGTAAGTCGGATGTGAAAGCCCTGGGCTTAACCTGGGAATGGCATTCGATACTGCAGAGCTAGAGTATGGTAGAGGGAAGTGGAATTTCCGG	TACGGAGGGAGCGAGCGTTAATCGGAATTACTGGGCGTAAAGCGCGCGTAGGCGGCTTTGTAAGTCGGATGTGAAAGCCCTGGGCTTAACCTGGGAATGGCATTCGATACTGCAGAGCTAGAGTATGGTAGAGGGAAGTGGAATTTCCGG	0.0
TACGGAGGGAGCTAGCGTTGTTCGGAATTACTGGGCGTAAAGCGCGCGTAGGCGGACTTTCAAGTCAGGGGTGAAATCCCGAGGCTCAACCTCGGAACTGCCTTTGATACTGATCGTCTTGAGTCCGAGAGAGGTGAGTGGAATTCCTAG	TACGGAGGGAGCTAGCGTTGTTCGGAATTACTGGGCGTAAAGCGCGCGTAGGCGGACTTTCAAGTCAGGGGTGAAATCCCGAGGCTCAACCTCGGAACTGCCTTTGATACTGATCGTCTTGAGTCCGAGAGAGGTGAGTGGAATTCCTAG	0.0
TACGGAGGGAGCTAGCGTTGTTCGGAATTACTGGGCGTAAAGGGCGCGTAGGCGGTCGGGTAAGTCGAGTGTGAAATTCCGGGGCTCAACCCCGCGAACTGCATTCGATACTGCTCGACTAGAGAGAGGTAGGGGCGAGTGGAATTCCCG	TACGGAGGGAGCTAGCGTTGTTCGGAATTACTGGGCGTAAAGGGCGCGTAGGCGGTCGGGTAAGTCGAGTGTGAAATTCCGGGGCTCAACCCCGCGAACTGCATTCGATACTGCTCGACTAGAGAGAGGTAGGGGCGAGTGGAATTCCCG	0.0
TACGGAGGGAGCTAGCGTTGTTCGGAATTACTGGGCGTAAAGGGCGCGTAGGCGGTCGGGTAAGTCGGGTGTGAAATTCCGGGGCTCAACCCCGTGAACTGCATCCGATACTGCTCGACTCGAGAGAGGTAGGGGCGAGTGGAATTCCCG	TACGGAGGGAGCTAGCGTTGTTCGGAATTACTGGGCGTAAAGGGCGCGTAGGCGGTCGGGTAAGTCGGGTGTGAAATTCCGGGGCTCAACCCCGTGAACTGCATCCGATACTGCTCGACTCGAGAGAGGTAGGGGCGAGTGGAATTCCCG	0.0
TACGGAGGGCGCAAGCGTTACTCGGAATCACTGGGCGTAAAGAGCGTGTAGGCGGATAAATAAGTTGGGAGTGAAATCCTATGGCTCAACCATAGAACTGCTTCCAAAACTGTTTATCTAGAATATGGGAGAGGTAGATGGAATTTCTGG	TACGGAGGGCGCAAGCGTTACTCGGAATCACTGGGCGTAAAGAGCGTGTAGGCGGATAAATAAGTTGGGAGTGAAATCCTATGGCTCAACCATAGAACTGCTTCCAAAACTGTTTATCTAGAATATGGGAGAGGTAGATGGAATTTCTGG	0.0
TACGGAGGGGGCAAGCGTTGTTCGGAATTACTGGGCGTAAAGCGCGCGTAGGCGGGTCTTTAAGTCAGAGGTGAAATCCTGGAGCTCAACTCCAGAACTGCCTTTGATACTGGAGATCTTGAGTCCGGAAGAGGTTAGTGGAATTCCCAG	TACGGAGGGGGCAAGCGTTGTTCGGAATTACTGGGCGTAAAGCGCGCGTAGGCGGGTCTTTAAGTCAGAGGTGAAATCCTGGAGCTCAACTCCAGAACTGCCTTTGATACTGGAGATCTTGAGTCCGGAAGAGGTTAGTGGAATTCCCAG	0.0
TACGGAGGGGGCAAGCGTTGTTCGGAATTACTGGGCGTAAAGCGCGCGTAGGCGGTTAGTCTAGTCAGGCGTGAAATCCCGGGGCTCAACCCCGGAACTGCGCTTGATACTGGCTTACTAGAGGTCTGGAGAGGGTAGTGGAATTCCCAG	TACGGAGGGGGCAAGCGTTGTTCGGAATTACTGGGCGTAAAGCGCGCGTAGGCGGTTAGTCTAGTCAGGCGTGAAATCCCGGGGCTCAACCCCGGAACTGCGCTTGATACTGGCTTACTAGAGGTCTGGAGAGGGTAGTGGAATTCCCAG	0.0
TACGGAGGGGGCTAGCGTTATTCGGATTTACTGGGCGTAAAGCGCACGTAGGCGGCGTATCTAGTCAGAGGTGAAAGCCCGGGGCTCAACCCCGGAATTGCCTTTGATACTGGTATGCTTGAGTTCGGAAGAGGGTAGTGGAATTCCAAG	TACGGAGGGGGCTAGCGTTATTCGGATTTACTGGGCGTAAAGCGCACGTAGGCGGCGTATCTAGTCAGAGGTGAAAGCCCGGGGCTCAACCCCGGAATTGCCTTTGATACTGGTATGCTTGAGTTCGGAAGAGGGTAGTGGAATTCCAAG	0.0
TACGGAGGGGGCTAGCGTTGCTCGGAATTACTGGGCGTAAAGAGCATGTAGGCGGATTGTATAGTCAGGCGTGAAAGCCCCAGGCTCAACCTGGGAACTGCGTTTGATACTTACAGTCTTGAGTCCGAGAGAGGGTGGTGGAATTCCCAG	TACGGAGGGGGCTAGCGTTGCTCGGAATTACTGGGCGTAAAGAGCATGTAGGCGGATTGTATAGTCAGGCGTGAAAGCCCCAGGCTCAACCTGGGAACTGCGTTTGATACTTACAGTCTTGAGTCCGAGAGAGGGTGGTGGAATTCCCAG	0.0
TACGGAGGGGGCTAGCGTTGTTCGGATTTACTGGGCGTAAAGCGCACGTAGGCGGCGTATCAAGTCAGAGGTGAAAGGCCTGGGCTCAACCTAGGAACTGCCTTTGATACTGATATGCTTGAGTTCGGGAGAGGGTAGTGGAATTCCAAG	TACGGAGGGGGCTAGCGTTGTTCGGATTTACTGGGCGTAAAGCGCACGTAGGCGGCGTATCAAGTCAGAGGTGAAAGGCCTGGGCTCAACCTAGGAACTGCCTTTGATACTGATATGCTTGAGTTCGGGAGAGGGTAGTGGAATTCCAAG	0.0
TACGGAGGGGGTTAGCGTTGTTCGGAATTACTGGGCGTAAAGCGCACGTAGGCGGATTGGAAAGTTGGGGGTGAAATCCCGGGGCTCAACCCCGGAACTGCCTCCAAAACTATCAGTCTAGAGTTCGAGAGAGGTGAGTGGAATTCCAAG	TACGGAGGGGGTTAGCGTTGTTCGGAATTACTGGGCGTAAAGCGCACGTAGGCGGATTGGAAAGTTGGGGGTGAAATCCCGGGGCTCAACCCCGGAACTGCCTCCAAAACTATCAGTCTAGAGTTCGAGAGAGGTGAGTGGAATTCCAAG	0.0
TACGGAGGGTCCAAGCGTTATCCGGATTCATTGGGTTTAAAGGGTCCGTAGGCGGTCTTTTAAGTCAGTGGTGAAATCCTGCAGCTCAACTGCAGAACTGCCATTGATACTGGAAGACTTGAGTATGATTGAAGTGGGCGGAATGTGTCA	TACGGAGGGTCCAAGCGTTATCCGGATTCATTGGGTTTAAAGGGTCCGTAGGCGGTCTTTTAAGTCAGTGGTGAAATCCTGCAGCTCAACTGCAGAACTGCCATTGATACTGGAAGACTTGAGTATGATTGAAGTGGGCGGAATGTGTCA	0.0
TACGGAGGGTCCAAGCGTTATCCGGATTCATTGGGTTTAAAGGGTGCGCAGGCGGAACTTTAAGTCAGTGGTGAAATCTTGCCGCTTAACGGTAAAATTGCCATTGATACTGAAGTTCTTGAATATGGTTGAGGTAGGCGGAATGTGTTG	TACGGAGGGTCCAAGCGTTATCCGGATTCATTGGGTTTAAAGGGTGCGCAGGCGGAACTTTAAGTCAGTGGTGAAATCTTGCCGCTTAACGGTAAAATTGCCATTGATACTGAAGTTCTTGAATATGGTTGAGGTAGGCGGAATGTGTTG	0.0
TACGGAGGGTCCAAGCGTTATCCGGATTCATTGGGTTTAAAGGGTGCGCAGGCGGGCTTGTAAGTCAGTGGTGAAATCTTGCCGCTTAACGGTAAAACTGCCATTGATACTGCAAGTCTTGAATATGGTTGAGGTAGGCGGAATGTGTTG	TACGGAGGGTCCAAGCGTTATCCGGATTCATTGGGTTTAAAGGGTGCGCAGGCGGGCTTGTAAGTCAGTGGTGAAATCTTGCCGCTTAACGGTAAAACTGCCATTGATACTGCAAGTCTTGAATATGGTTGAGGTAGGCGGAATGTGTTG	0.0
TACGGAGGGTCCAAGCGTTATCCGGATTTATTGGGTTTAAAGGGTTCGTAGGCGGGATATTAAGTCAGTGGTGAAATCCTACAGCTTAACTGTAGAACTGCCATTGATACTGATATTCTTGAATTCACCTGAAGTAGGCGGAACATGACA	TACGGAGGGTCCAAGCGTTATCCGGATTTATTGGGTTTAAAGGGTTCGTAGGCGGGATATTAAGTCAGTGGTGAAATCCTACAGCTTAACTGTAGAACTGCCATTGATACTGATATTCTTGAATTCACCTGAAGTAGGCGGAACATGACA	0.0
TACGGAGGGTCCGAGCGTTAATCGGAATTACTGGGCGTAAAGCGTGCGCAGGCGGTTATTTAAGCCAGATGTGAAAGCCCCGGGCTCAACCTGGGAATTGCATTTGGAACTGGGTAACTAGAGTCTTGTAGAGGGGGGTAGAATTTCAGG	TACGGAGGGTCCGAGCGTTAATCGGAATTACTGGGCGTAAAGCGTGCGCAGGCGGTTATTTAAGCCAGATGTGAAAGCCCCGGGCTCAACCTGGGAATTGCATTTGGAACTGGGTAACTAGAGTCTTGTAGAGGGGGGTAGAATTTCAGG	0.0
TACGGAGGGTCCGAGCGTTATCCGGAATCATTGGGTTTAAAGGGTCCGTAGGCGGGCGTCTAAGTCAGTGGTGAAATCTTACAGCTCAACTGTAAAATTGCCATTGATACTGGATGTCTTGAATTAGTGTGAAGTGGTTAGAATGTGTAG	TACGGAGGGTCCGAGCGTTATCCGGAATCATTGGGTTTAAAGGGTCCGTAGGCGGGCGTCTAAGTCAGTGGTGAAATCTTACAGCTCAACTGTAAAATTGCCATTGATACTGGATGTCTTGAATTAGTGTGAAGTGGTTAGAATGTGTAG	0.0
TACGGAGGGTGCAAACGTTGTTCGGAATTATTGGGCGTAAAGAGCATGTAGGCGGTCTGTCAAGTCTGATGTGAAAGCCCGGGGCTCAACCCCGGAAGTGCATTGGAAACTGGCAGACTTGAGTACGGGAGAGGAAAGTGGAATTTCGAG	TACGGAGGGTGCAAACGTTGTTCGGAATTATTGGGCGTAAAGAGCATGTAGGCGGTCTGTCAAGTCTGATGTGAAAGCCCGGGGCTCAACCCCGGAAGTGCATTGGAAACTGGCAGACTTGAGTACGGGAGAGGAAAGTGGAATTTCGAG	0.0
TACGGAGGGTGCAAGCGTTAATCGGAATTACTGGGCGTAAAGCGAGTGTAGGCGGCTTCGTAAGTCGGATGTGAAAGCCCTGGGCTTAACCTGGGAATTGCATTCGATACTGCGCGGCTAGAGTCTGATAGAGGGAAGTGGAATTCCAGG	TACGGAGGGTGCAAGCGTTAATCGGAATTACTGGGCGTAAAGCGAGTGTAGGCGGCTTCGTAAGTCGGATGTGAAAGCCCTGGGCTTAACCTGGGAATTGCATTCGATACTGCGCGGCTAGAGTCTGATAGAGGGAAGTGGAATTCCAGG	0.0
TACGGAGGGTGCAAGCGTTAATCGGAATTACTGGGCGTAAAGCGCGCGTAGGCGGCTTCGTCAGTTGGGTGTGAAAGCCCCGGGCTTAACCTGGGAACTGCATTCAATACTGCGAGGCTAGAGTATGGGAGAGGGTTGTGGAATTCCACG	TACGGAGGGTGCAAGCGTTAATCGGAATTACTGGGCGTAAAGCGCGCGTAGGCGGCTTCGTCAGTTGGGTGTGAAAGCCCCGGGCTTAACCTGGGAACTGCATTCAATACTGCGAGGCTAGAGTATGGGAGAGGGTTGTGGAATTCCACG	0.0
TACGGAGGGTGCAAGCGTTAATCGGAATTACTGGGCGTAAAGCGCGCGTAGGCGGCTTGGTCAGTCAGATGTGAAATCCCCGGGCTTAACCTGGGAACTGCATTTGATACTGCCTGGCTAGAGTATGGTAGAGGGAAGTGGAATTCCAGG	TACGGAGGGTGCAAGCGTTAATCGGAATTACTGGGCGTAAAGCGCGCGTAGGCGGCTTGGTCAGTCAGATGTGAAATCCCCGGGCTTAACCTGGGAACTGCATTTGATACTGCCTGGCTAGAGTATGGTAGAGGGAAGTGGAATTCCAGG	0.0
TACGGAGGGTGCAAGCGTTAATCGGAATTACTGGGCGTAAAGCGCGCGTAGGCGGCTTGGTCAGTCGGATGTGAAAGCCCAGGGCTTAACCCTGGAATTGCATTCGATACTGCCTGGCTAGAGTATGGTAGAGGGAAGTGGAATTTCCGG	TACGGAGGGTGCAAGCGTTAATCGGAATTACTGGGCGTAAAGCGCGCGTAGGCGGCTTGGTCAGTCGGATGTGAAAGCCCAGGGCTTAACCCTGGAATTGCATTCGATACTGCCTGGCTAGAGTATGGTAGAGGGAAGTGGAATTTCCGG	0.0
TACGGAGGGTGCAAGCGTTAATCGGAATTACTGGGCGTAAAGCGCGCGTAGGCGGCTTGTTAAGTCAGATGTGAAATCCCCGAGCTCAACTTGGGAACTGCATTTGATACTGGCAGGCTAGAGTATGTTAGAGGAAAGCGGAATTCCGGG	TACGGAGGGTGCAAGCGTTAATCGGAATTACTGGGCGTAAAGCGCGCGTAGGCGGCTTGTTAAGTCAGATGTGAAATCCCCGAGCTCAACTTGGGAACTGCATTTGATACTGGCAGGCTAGAGTATGTTAGAGGAAAGCGGAATTCCGGG	0.0
TACGGAGGGTGCAAGCGTTAATCGGAATTACTGGGCGTAAAGCGCGCGTAGGCGGCTTTGTAAGTCGGATGTGAAAGCCCCGGGCTTAACCTGGGAATTGCATTCGATACTGCAGAACTAGAGTATGGTAGAGGGAAGTGGAATTTCCGG	TACGGAGGGTGCAAGCGTTAATCGGAATTACTGGGCGTAAAGCGCGCGTAGGCGGCTTTGTAAGTCGGATGTGAAAGCCCCGGGCTTAACCTGGGAATTGCATTCGATACTGCAGAACTAGAGTATGGTAGAGGGAAGTGGAATTTCCGG	0.0
TACGGAGGGTGCAAGCGTTAATCGGAATTACTGGGCGTAAAGCGCGCGTAGGCGGCTTTGTAAGTCGGATGTGAAAGCCCCGGGCTTAACCTGGGAATTGCATTCGATACTGCGGAGCTAGAGTATGGTAGAGGGAAGTGGAATTCCGGG	TACGGAGGGTGCAAGCGTTAATCGGAATTACTGGGCGTAAAGCGCGCGTAGGCGGCTTTGTAAGTCGGATGTGAAAGCCCCGGGCTTAACCTGGGAATTGCATTCGATACTGCGGAGCTAGAGTATGGTAGAGGGAAGTGGAATTCCGGG	0.0
TACGGAGGGTGCAAGCGTTAATCGGAATTACTGGGCGTAAAGCGCGCGTAGGCGGCTTTGTAAGTCGGATGTGAAAGCCCTGGGCTTAACCTGGGAATTGCATTCGATACTGCAGAGCTAGAGTATGGTAGAGGGAAGTGGAATTCCGGG	TACGGAGGGTGCAAGCGTTAATCGGAATTACTGGGCGTAAAGCGCGCGTAGGCGGCTTTGTAAGTCGGATGTGAAAGCCCTGGGCTTAACCTGGGAATTGCATTCGATACTGCAGAGCTAGAGTATGGTAGAGGGAAGTGGAATTCCGGG	0.0
TACGGAGGGTGCAAGCGTTAATCGGAATTACTGGGCGTAAAGCGCGCGTAGGCGGTCTGGTCAGTTGGGTGTGAAATCCCCGGGCTTAACCTGGGAACTGCATCCAATACTGCCAGGCTGGAGTATGGGAGAGGGTAGTGGAATTCCACG	TACGGAGGGTGCAAGCGTTAATCGGAATTACTGGGCGTAAAGCGCGCGTAGGCGGTCTGGTCAGTTGGGTGTGAAATCCCCGGGCTTAACCTGGGAACTGCATCCAATACTGCCAGGCTGGAGTATGGGAGAGGGTAGTGGAATTCCACG	0.0
TACGGAGGGTGCAAGCGTTAATCGGAATTACTGGGCGTAAAGCGCGCGTAGGCGGTTATATAAGTCGGATGTGAAATACCTGGGCTCAACCTGGGAACTGCATTCGATACTGTATAACTAGAGTTTGGTAGAGGGAAGTGGAATTCCACA	TACGGAGGGTGCAAGCGTTAATCGGAATTACTGGGCGTAAAGCGCGCGTAGGCGGTTATATAAGTCGGATGTGAAATACCTGGGCTCAACCTGGGAACTGCATTCGATACTGTATAACTAGAGTTTGGTAGAGGGAAGTGGAATTCCACA	0.0
TACGGAGGGTGCAAGCGTTAATCGGAATTACTGGGCGTAAAGCGCGCGTAGGCGGTTTGTTAAGTCGGATGTGAAAGCCCCGGGCTCAACCTGGGAATTGCATTCGATACTGGCCGACTAGAGTACGAGAGAGGGAGGTAGAATTCCACG	TACGGAGGGTGCAAGCGTTAATCGGAATTACTGGGCGTAAAGCGCGCGTAGGCGGTTTGTTAAGTCGGATGTGAAAGCCCCGGGCTCAACCTGGGAATTGCATTCGATACTGGCCGACTAGAGTACGAGAGAGGGAGGTAGAATTCCACG	0.0
TACGGAGGGTGCAAGCGTTAATCGGAATTACTGGGCGTAAAGCGCGCGTAGGCGGTTTGTTAAGTCGGATGTGAAAGCCCTGGGCTCAACCTGGGAACTGCATTCGATACTGATCGACTAGAGTACGAGAGAGGGAGGTAGAATTCCACG	TACGGAGGGTGCAAGCGTTAATCGGAATTACTGGGCGTAAAGCGCGCGTAGGCGGTTTGTTAAGTCGGATGTGAAAGCCCTGGGCTCAACCTGGGAACTGCATTCGATACTGATCGACTAGAGTACGAGAGAGGGAGGTAGAATTCCACG	0.0
TACGGAGGGTGCAAGCGTTAATCGGAATTACTGGGCGTAAAGCGCGCGTAGGCGGTTTGTTAAGTCGGATGTGAAAGCCCTGGGCTCAACCTGGGAACTGCATTCGATACTGGCCGACTAGAGTACGAGAGAGGGAGGTAGAATTCCACG	TACGGAGGGTGCAAGCGTTAATCGGAATTACTGGGCGTAAAGCGCGCGTAGGCGGTTTGTTAAGTCGGATGTGAAAGCCCTGGGCTCAACCTGGGAACTGCATTCGATACTGGCCGACTAGAGTACGAGAGAGGGAGGTAGAATTCCACG	0.0
TACGGAGGGTGCAAGCGTTAATCGGAATTACTGGGCGTAAAGCGCTCGTAGGCGGTTTGTTAAGTCGGATGTGAAAGCCCCGGGCTCAACCTGGGAACTGCATTCGATACTGGCAAACTAGAGTATAGAAGAGGCAAGTGGAATTCCAGG	TACGGAGGGTGCAAGCGTTAATCGGAATTACTGGGCGTAAAGCGCTCGTAGGCGGTTTGTTAAGTCGGATGTGAAAGCCCCGGGCTCAACCTGGGAACTGCATTCGATACTGGCAAACTAGAGTATAGAAGAGGCAAGTGGAATTCCAGG	0.0
TACGGAGGGTGCAAGCGTTAATCGGAATTACTGGGCGTAAAGCGTGCGCAGGCGGTTTGTTAAGTCAGATGTGAAAGCCCCGGGCTCAACCTGGGAACTGCATTTGATACTGGCAAACTAGAGTGTGGTAGAGGGAAGTGGAATTCCTCA	TACGGAGGGTGCAAGCGTTAATCGGAATTACTGGGCGTAAAGCGTGCGCAGGCGGTTTGTTAAGTCAGATGTGAAAGCCCCGGGCTCAACCTGGGAACTGCATTTGATACTGGCAAACTAGAGTGTGGTAGAGGGAAGTGGAATTCCTCA	0.0
TACGGAGGGTGCAAGCGTTAATCGGAATTACTGGGCGTAAAGCGTGCGTAGGCGGTTTATTAAGTCAGATGTGAAAGCCCCGGGCTTAACCTGGGAACTGCATTTGAAACTGGTAAACTAGAGTATGGTAGAGGAAAGTGGAATTTCTGG	TACGGAGGGTGCAAGCGTTAATCGGAATTACTGGGCGTAAAGCGTGCGTAGGCGGTTTATTAAGTCAGATGTGAAAGCCCCGGGCTTAACCTGGGAACTGCATTTGAAACTGGTAAACTAGAGTATGGTAGAGGAAAGTGGAATTTCTGG	0.0
TACGGAGGGTGCAAGCGTTAATCGGAATTACTGGGCGTAAAGCGTGCGTAGGCGGTTTGCTAAGTCAGATGTGAAAGCCCCGGGCTTAACCTGGGAACTGCATTTGATACTGGCAGACTAGAGTATGGTAGAGGGGGGTAGAATTCATAG	TACGGAGGGTGCAAGCGTTAATCGGAATTACTGGGCGTAAAGCGTGCGTAGGCGGTTTGCTAAGTCAGATGTGAAAGCCCCGGGCTTAACCTGGGAACTGCATTTGATACTGGCAGACTAGAGTATGGTAGAGGGGGGTAGAATTCATAG	0.0
TACGGAGGGTGCAAGCGTTACTCGGAATCACTGGGCGTAAAGAGCGTGTAGGCGGATAAGTAAGTCAGAAGTGAAATCCAATAGCTTAACTATTGAACTGCTTTTGAAACTACTCATCTAGAATATGGGAGAGGTAGATGGAATTTCTGG	TACGGAGGGTGCAAGCGTTACTCGGAATCACTGGGCGTAAAGAGCGTGTAGGCGGATAAGTAAGTCAGAAGTGAAATCCAATAGCTTAACTATTGAACTGCTTTTGAAACTACTCATCTAGAATATGGGAGAGGTAGATGGAATTTCTGG	0.0
TACGGAGGGTGCAAGCGTTACTCGGAATCACTGGGCGTAAAGAGCGTGTAGGCGGGTTAATAAGTCAGAAGTGAAATCCAATGGCTCAACCATTGAACTGCTTTTGAAACTGTTAACCTAGAATATGGGAGAGGTAGATGGAATTTCTGG	TACGGAGGGTGCAAGCGTTACTCGGAATCACTGGGCGTAAAGAGCGTGTAGGCGGGTTAATAAGTCAGAAGTGAAATCCAATGGCTCAACCATTGAACTGCTTTTGAAACTGTTAACCTAGAATATGGGAGAGGTAGATGGAATTTCTGG	0.0
TACGGAGGGTGCAAGCGTTACTCGGAATCACTGGGCGTAAAGAGCGTGTAGGCGGGTTAATAAGTCAGAAGTGAAATCCTATGGCTCAACCATAGAACTGCTTTTGAAACTGTTAACCTAGAGTGTGGGAGAGGTAGATGGAATTTCTGG	TACGGAGGGTGCAAGCGTTACTCGGAATCACTGGGCGTAAAGAGCGTGTAGGCGGGTTAATAAGTCAGAAGTGAAATCCTATGGCTCAACCATAGAACTGCTTTTGAAACTGTTAACCTAGAGTGTGGGAGAGGTAGATGGAATTTCTGG	0.0
TACGGAGGGTGCAAGCGTTATCCGGAATCATTGGGTTTAAAGGGTCCGCAGGCGGACGTATAAGTCAGTGGTGAAATCCTGCAGCTTAACTGCAGAACTGCCATTGATACTGTACGTCTTGAATTCGGTCGAAGTGGGCGGAATGTGTAG	TACGGAGGGTGCAAGCGTTATCCGGAATCATTGGGTTTAAAGGGTCCGCAGGCGGACGTATAAGTCAGTGGTGAAATCCTGCAGCTTAACTGCAGAACTGCCATTGATACTGTACGTCTTGAATTCGGTCGAAGTGGGCGGAATGTGTAG	0.0
TACGGAGGGTGCAAGCGTTATCCGGAATTACTGGGTTTAAAGGGTGCGTAGGCGGCTTTGTAAGTCAGGAGTGAAAGTTTGCGGCTCAACCGTAAAATTGCTTTTGATACTGCATCGCTAGAATTAGGATGAGGTCAGCGGAATGTGGCA	TACGGAGGGTGCAAGCGTTATCCGGAATTACTGGGTTTAAAGGGTGCGTAGGCGGCTTTGTAAGTCAGGAGTGAAAGTTTGCGGCTCAACCGTAAAATTGCTTTTGATACTGCATCGCTAGAATTAGGATGAGGTCAGCGGAATGTGGCA	0.0
TACGGAGGGTGCAAGCGTTATCCGGATTTATTGGGTTTAAAGGGTCCGTAGGCGGATCTTTAAGTCAGTGGTGAAAGCCTATAGCTTAACTATAGAATTGCCGTTGATACTGAAGATCTTGAGTACATTTGAAGTGGGCGGAATGTGTCA	TACGGAGGGTGCAAGCGTTATCCGGATTTATTGGGTTTAAAGGGTCCGTAGGCGGATCTTTAAGTCAGTGGTGAAAGCCTATAGCTTAACTATAGAATTGCCGTTGATACTGAAGATCTTGAGTACATTTGAAGTGGGCGGAATGTGTCA	0.0
TACGGAGGGTGCAAGCGTTATCCGGATTTATTGGGTTTAAAGGGTGCGTAGGCGGGTTATTAAGTCAGTGGTGAAAGCCTACAGCTCAACTGTGGAATTGCCATTGATACTGATAGTCTTGAATTTAGTTGAGGTAGGCGGAATAAGACA	TACGGAGGGTGCAAGCGTTATCCGGATTTATTGGGTTTAAAGGGTGCGTAGGCGGGTTATTAAGTCAGTGGTGAAAGCCTACAGCTCAACTGTGGAATTGCCATTGATACTGATAGTCTTGAATTTAGTTGAGGTAGGCGGAATAAGACA	0.0
TACGGAGGGTGCAAGCGTTGTTCGGAATCACTGGGCGTAAAGGGCGCGCAGGCGGCCTGGTAAGTCAGATGTGAAAGCCCACGGCTTAACCGTGGAAGTGCATTTGAAACTGTCAGGCTTGAGTACCAGAGGGGAAAGTGGAATTCCCGG	TACGGAGGGTGCAAGCGTTGTTCGGAATCACTGGGCGTAAAGGGCGCGCAGGCGGCCTGGTAAGTCAGATGTGAAAGCCCACGGCTTAACCGTGGAAGTGCATTTGAAACTGTCAGGCTTGAGTACCAGAGGGGAAAGTGGAATTCCCGG	0.0
TACGGAGGGTGCAAGCGTTGTTCGGAATTACTGGGCGTAAAGGGCGCGTAGGCGGCTGGATAAGTCAGATGTGAAAGTCCATGGCTCAACTGTGGAAGTGCATTTGAAACTGTCCGGCTTGAGTATCGGAGGGGAGTGTGGAATTCCCGG	TACGGAGGGTGCAAGCGTTGTTCGGAATTACTGGGCGTAAAGGGCGCGTAGGCGGCTGGATAAGTCAGATGTGAAAGTCCATGGCTCAACTGTGGAAGTGCATTTGAAACTGTCCGGCTTGAGTATCGGAGGGGAGTGTGGAATTCCCGG	0.0
TACGGAGGGTGCAAGCGTTGTTCGGAATTATTGGGCGTAAAGAGCATGTAGGCGGACTGTTAAGTCTGGTGTGAAAGCCCGGGGCTCAACCCCGGAAGTGCATTGGATACTGGCAGTCTTGAGTATGGGAGAGGAAAGTGGAATTCCGAG	TACGGAGGGTGCAAGCGTTGTTCGGAATTATTGGGCGTAAAGAGCATGTAGGCGGACTGTTAAGTCTGGTGTGAAAGCCCGGGGCTCAACCCCGGAAGTGCATTGGATACTGGCAGTCTTGAGTATGGGAGAGGAAAGTGGAATTCCGAG	0.0
TACGGAGGGTGCAAGCGTTGTTCGGATTCACTGGGTATAAAGGGTGCGCAGGCGGCCCGATAAGTCAGGGGTGAAATATGACGGCTTAACCGTCAAACTGCCCCTGAAACTGTCAGGCTTGAGTTCGAGAGAGGTAGGTGGAATTCCAGG	TACGGAGGGTGCAAGCGTTGTTCGGATTCACTGGGTATAAAGGGTGCGCAGGCGGCCCGATAAGTCAGGGGTGAAATATGACGGCTTAACCGTCAAACTGCCCCTGAAACTGTCAGGCTTGAGTTCGAGAGAGGTAGGTGGAATTCCAGG	0.0
TACGGAGGGTGCGAGCGTTAATCGGAATTACTGGGCGTAAAGCGCATGCAGGTGGTCTGTTAAGTCAGATGTGAAAGCCCCGGGCTTAACCCGGGATGGTCATTTGAAACTGGCAGGCTAGAGTACTGTAGAGGGGGGTAGAATTTCAGG	TACGGAGGGTGCGAGCGTTAATCGGAATTACTGGGCGTAAAGCGCATGCAGGTGGTCTGTTAAGTCAGATGTGAAAGCCCCGGGCTTAACCCGGGATGGTCATTTGAAACTGGCAGGCTAGAGTACTGTAGAGGGGGGTAGAATTTCAGG	0.0
TACGGAGGGTGCGAGCGTTAATCGGAATTACTGGGCGTAAAGCGCGCGTAGGCGGCTTTGTCAGTCGGATGTGAAAGCCCCGGGCTTAACCTGGGAATTGCATTCGATACTGCATGGCTAGAGTATGGTAGAGGGAAGTGGAATTCCGGG	TACGGAGGGTGCGAGCGTTAATCGGAATTACTGGGCGTAAAGCGCGCGTAGGCGGCTTTGTCAGTCGGATGTGAAAGCCCCGGGCTTAACCTGGGAATTGCATTCGATACTGCATGGCTAGAGTATGGTAGAGGGAAGTGGAATTCCGGG	0.0
TACGGAGGGTGCGAGCGTTAATCGGAATTACTGGGCGTAAAGCGCGCGTAGGCGGTTAGTTAAGTCGGATGTGAAAGCCCTGGGCTCAACCTGGGAACTGCATTCGATACTGGCCAACTAGAGTGCGAGAGAGGGAGGTAGAATTCCACG	TACGGAGGGTGCGAGCGTTAATCGGAATTACTGGGCGTAAAGCGCGCGTAGGCGGTTAGTTAAGTCGGATGTGAAAGCCCTGGGCTCAACCTGGGAACTGCATTCGATACTGGCCAACTAGAGTGCGAGAGAGGGAGGTAGAATTCCACG	0.0
TACGGAGGGTGCGAGCGTTAATCGGAATTACTGGGCGTAAAGCGCGCGTAGGCGGTTAGTTAAGTCGGATGTGAAAGCCCTGGGCTCAACCTGGGAACTGCATTCGATACTGGCCCACTAGAGTGCGAGAGAGGGAGGTAGAATTCCACG	TACGGAGGGTGCGAGCGTTAATCGGAATTACTGGGCGTAAAGCGCGCGTAGGCGGTTAGTTAAGTCGGATGTGAAAGCCCTGGGCTCAACCTGGGAACTGCATTCGATACTGGCCCACTAGAGTGCGAGAGAGGGAGGTAGAATTCCACG	0.0
TACGGAGGGTGCGAGCGTTAATCGGAATTACTGGGCGTAAAGCGCGCGTAGGCGGTTGTTTAAGTCGGATGTGAAAGCCCTGGGCTCAACCTGGGAACTGCATTCGATACTGGGCAACTAGAGTATGAAAGAGGGAGGTAGAATTCCATG	TACGGAGGGTGCGAGCGTTAATCGGAATTACTGGGCGTAAAGCGCGCGTAGGCGGTTGTTTAAGTCGGATGTGAAAGCCCTGGGCTCAACCTGGGAACTGCATTCGATACTGGGCAACTAGAGTATGAAAGAGGGAGGTAGAATTCCATG	0.0
TACGGAGGGTGCGAGCGTTAATCGGAATTACTGGGCGTAAAGCGCGCGTAGGCGGTTTGGTCAGTCGGATGTGAAAGCCCCGGGCTTAACCTGGGAATTGCATTCGATACTGCCAGGCTAGAATGTGGGAGAGGCAAGTGGAATTTCCGG	TACGGAGGGTGCGAGCGTTAATCGGAATTACTGGGCGTAAAGCGCGCGTAGGCGGTTTGGTCAGTCGGATGTGAAAGCCCCGGGCTTAACCTGGGAATTGCATTCGATACTGCCAGGCTAGAATGTGGGAGAGGCAAGTGGAATTTCCGG	0.0
TACGGAGGGTGCGAGCGTTAATCGGAATTACTGGGCGTAAAGCGCGCGTAGGCGGTTTGTTAAGTCAGCTGTGAAAGCCCCGGGCTCAACCTGGGAACTGCAGTTGATACTGGCCGACTAGAGTATGAGAGAGGGAGGTAGAATTCCACG	TACGGAGGGTGCGAGCGTTAATCGGAATTACTGGGCGTAAAGCGCGCGTAGGCGGTTTGTTAAGTCAGCTGTGAAAGCCCCGGGCTCAACCTGGGAACTGCAGTTGATACTGGCCGACTAGAGTATGAGAGAGGGAGGTAGAATTCCACG	0.0
TACGGAGGGTGCGAGCGTTAATCGGAATTACTGGGCGTAAAGCGCGCGTAGGCGGTTTGTTAAGTCAGCTGTGAAAGCCCTGGGCTCAACCTGGGAACTGCAGTTGATACTGGCCGACTAGAGTACGAGAGAGGGAGGTAGAATTCCATG	TACGGAGGGTGCGAGCGTTAATCGGAATTACTGGGCGTAAAGCGCGCGTAGGCGGTTTGTTAAGTCAGCTGTGAAAGCCCTGGGCTCAACCTGGGAACTGCAGTTGATACTGGCCGACTAGAGTACGAGAGAGGGAGGTAGAATTCCATG	0.0
TACGGAGGGTGCGAGCGTTAATCGGAATTACTGGGCGTAAAGCGCGCGTAGGCGGTTTGTTAAGTCGGATGTGAAAGCCCTGGGCTCAACCTGGGAACTGCATTCGATACTGACCGACTAGAGTACGAGAGAGGGAGGTAGAATTCCACG	TACGGAGGGTGCGAGCGTTAATCGGAATTACTGGGCGTAAAGCGCGCGTAGGCGGTTTGTTAAGTCGGATGTGAAAGCCCTGGGCTCAACCTGGGAACTGCATTCGATACTGACCGACTAGAGTACGAGAGAGGGAGGTAGAATTCCACG	0.0
TACGGAGGGTGCGAGCGTTAATCGGAATTACTGGGCGTAAAGCGCGCGTAGGCGGTTTTGTAAGTCGGATGTGAAAGCCCTGGGCTTAACCTGGGAATTGCATTCGATACTGCTTAACTAGAGTACGGTAGAGGGAAGTGGAATTTCCGG	TACGGAGGGTGCGAGCGTTAATCGGAATTACTGGGCGTAAAGCGCGCGTAGGCGGTTTTGTAAGTCGGATGTGAAAGCCCTGGGCTTAACCTGGGAATTGCATTCGATACTGCTTAACTAGAGTACGGTAGAGGGAAGTGGAATTTCCGG	0.0
TACGGAGGGTGCGAGCGTTAATCGGAATTACTGGGCGTAAAGCGCGCGTAGGTGGTTGATTAAGTCAGCTGTGAAAGCCCTGGGCTTAACCTGGGAACTGCAGTTGATACTGGTCGACTAGAGTGCGAGAGAGGGAGGTAGAATTCCACG	TACGGAGGGTGCGAGCGTTAATCGGAATTACTGGGCGTAAAGCGCGCGTAGGTGGTTGATTAAGTCAGCTGTGAAAGCCCTGGGCTTAACCTGGGAACTGCAGTTGATACTGGTCGACTAGAGTGCGAGAGAGGGAGGTAGAATTCCACG	0.0
TACGGAGGGTGCGAGCGTTAATCGGAATTACTGGGCGTAAAGCGTGCGTAGGCGGTTAATTAAGTCAGATGTGAAATCCCGGGGCTCAACCTCGGAACTGCATTTGAAACTGGTTAACTAGAGTATTGTAGAGGGTGGTGGAATTTCCAG	TACGGAGGGTGCGAGCGTTAATCGGAATTACTGGGCGTAAAGCGTGCGTAGGCGGTTAATTAAGTCAGATGTGAAATCCCGGGGCTCAACCTCGGAACTGCATTTGAAACTGGTTAACTAGAGTATTGTAGAGGGTGGTGGAATTTCCAG	0.0
TACGGGGGGTGCAAGCGTTACTCGGAATCACTGGGCGTAAAGAGCATGTAGGCGGATTAATAAGTTTGAAGTGAAATCCTATAGCTTAACTATAGAACTGCTTTGAAAACTGTTAATCTAGAATGTGGGAGAGGTAGATGGAATTTCTGG	TACGGGGGGTGCAAGCGTTACTCGGAATCACTGGGCGTAAAGAGCATGTAGGCGGATTAATAAGTTTGAAGTGAAATCCTATAGCTTAACTATAGAACTGCTTTGAAAACTGTTAATCTAGAATGTGGGAGAGGTAGATGGAATTTCTGG	0.0
TACGGGGGGTGCAAGCGTTACTCGGAATCACTGGGCGTAAAGAGCATGTAGGCTGATAGATAAGTTGGAAGTGAAATCCTATGGCTTAACCATAGAACTGCTTCCAAAACTGTCTATCTAGAGTATGGGAGAGGTAGATGGAATTTCTGG	TACGGGGGGTGCAAGCGTTACTCGGAATCACTGGGCGTAAAGAGCATGTAGGCTGATAGATAAGTTGGAAGTGAAATCCTATGGCTTAACCATAGAACTGCTTCCAAAACTGTCTATCTAGAGTATGGGAGAGGTAGATGGAATTTCTGG	0.0
TACGGGGGGTGCAAGCGTTATTCGGAATCATTGGGCGTAAAGAGCGCGTAGGCGGCCCTTTAAGTCAGATGTGAAATCCCGGGGCTTAACCCCGGAAGTGCATTTGAAACTATTGGGCTTGAGTATGGGAGAGGGAAGTGGAATTCCTGG	TACGGGGGGTGCAAGCGTTATTCGGAATCATTGGGCGTAAAGAGCGCGTAGGCGGCCCTTTAAGTCAGATGTGAAATCCCGGGGCTTAACCCCGGAAGTGCATTTGAAACTATTGGGCTTGAGTATGGGAGAGGGAAGTGGAATTCCTGG	0.0
TACGGGGGGTGCAAGCGTTATTCGGAATTACTGGGCGTAAAGAGCGCGTAGGCGGTCTTTTAAGTCAGGTGTGAAAGCCCGGGGCTCAACCCCGGAAGTGCACTTGAAACTAAGGGACTTGAGTATGGGAGAGGGAAGTGGAATTCCTGG	TACGGGGGGTGCAAGCGTTATTCGGAATTACTGGGCGTAAAGAGCGCGTAGGCGGTCTTTTAAGTCAGGTGTGAAAGCCCGGGGCTCAACCCCGGAAGTGCACTTGAAACTAAGGGACTTGAGTATGGGAGAGGGAAGTGGAATTCCTGG	0.0
TACGGGGGGTGCAAGCGTTATTCGGATTTATTGGGCGTAAAGGGCGCGTAGGCGGCCGTTTAAGTCGGGTGTGAAATCCCGGGGCTTAACCCCGGAACTGCATCCGATACTGGACGGCTTGAGTATGGGAGAGGGAAGTGGAATTCCAGG	TACGGGGGGTGCAAGCGTTATTCGGATTTATTGGGCGTAAAGGGCGCGTAGGCGGCCGTTTAAGTCGGGTGTGAAATCCCGGGGCTTAACCCCGGAACTGCATCCGATACTGGACGGCTTGAGTATGGGAGAGGGAAGTGGAATTCCAGG	0.0
TACGTAGGGAGCGAACGTTGTCCGGATTTATTGGGCGTAAAGGGCTCGTAGGCGGTTCAGCAAGTCGGTCGTGAAAGCCCGGGGCTCAACCCCGGGATGCCGGTCGAAACTGCTGTGACTTGAGTTCGGTAGAGGTGAGTGGAATTCTCG	TACGTAGGGAGCGAACGTTGTCCGGATTTATTGGGCGTAAAGGGCTCGTAGGCGGTTCAGCAAGTCGGTCGTGAAAGCCCGGGGCTCAACCCCGGGATGCCGGTCGAAACTGCTGTGACTTGAGTTCGGTAGAGGTGAGTGGAATTCTCG	0.0
TACGTAGGGCGCAAGCGTTGTCCGGAATTATTGGGCGTAAAGAGCTCGTAGGCGGTTTGTCGCGTCTGCTGTGAAAATCCGAGGCTCAACCTCGGACCTGCAGTGGGTACGGGCAAACTAGAGTGCGGTAGGGGAGATTGGAATTCCTGG	TACGTAGGGCGCAAGCGTTGTCCGGAATTATTGGGCGTAAAGAGCTCGTAGGCGGTTTGTCGCGTCTGCTGTGAAAATCCGAGGCTCAACCTCGGACCTGCAGTGGGTACGGGCAAACTAGAGTGCGGTAGGGGAGATTGGAATTCCTGG	0.0
TACGTAGGGTGCAAGCGTTAATCGGAATTACTGGGCGTAAAGCGTGCGCAGGCGGACTTTTAAGCCAGATGTGAAAGCCCCGAGCTTAACTTGGGAATTGCGTTTGGAACTGGGAGTCTAGAGTCTGTCAGAGGGGGATGGAATTCCACG	TACGTAGGGTGCAAGCGTTAATCGGAATTACTGGGCGTAAAGCGTGCGCAGGCGGACTTTTAAGCCAGATGTGAAAGCCCCGAGCTTAACTTGGGAATTGCGTTTGGAACTGGGAGTCTAGAGTCTGTCAGAGGGGGATGGAATTCCACG	0.0
TACGTAGGGTGCGAGCGTTAATCGGAATTACTGGGCGTAAAGCGTGCGCAGGCGGCTCTTTAAGACAGGTGTGAAATCCCCGGGCTTAACCTGGGAATTGCGCTTGTGACTGGGGAGCTCGAGTGCGGCAGAGGGGGATGGAATTCCTGG	TACGTAGGGTGCGAGCGTTAATCGGAATTACTGGGCGTAAAGCGTGCGCAGGCGGCTCTTTAAGACAGGTGTGAAATCCCCGGGCTTAACCTGGGAATTGCGCTTGTGACTGGGGAGCTCGAGTGCGGCAGAGGGGGATGGAATTCCTGG	0.0
TACGTAGGGTGCGAGCGTTAATCGGAATTACTGGGCGTAAAGCGTGCGCAGGCGGTTATGTAAGACAGATGTGAAATCCCCGGGCTCAACCTGGGAACTGCGTTTGTGACTGCATAACTAGAGTACGGCAGAGGGAGGTGGAATTCCGCG	TACGTAGGGTGCGAGCGTTAATCGGAATTACTGGGCGTAAAGCGTGCGCAGGCGGTTATGTAAGACAGATGTGAAATCCCCGGGCTCAACCTGGGAACTGCGTTTGTGACTGCATAACTAGAGTACGGCAGAGGGAGGTGGAATTCCGCG	0.0
TACGTAGGGTGCGAGCGTTAATCGGAATTACTGGGCGTAAAGCGTGCGCAGGCGGTTTTATAAGTCAGATGTGAAATCCCCGAGCTCAACTTGGGAACTGCGTTTGAAACTGTAAGACTAGAGTGTGTCAGAGGGGGGTAGAATTCCACG	TACGTAGGGTGCGAGCGTTAATCGGAATTACTGGGCGTAAAGCGTGCGCAGGCGGTTTTATAAGTCAGATGTGAAATCCCCGAGCTCAACTTGGGAACTGCGTTTGAAACTGTAAGACTAGAGTGTGTCAGAGGGGGGTAGAATTCCACG	0.0
TACTGAGGGTGCAAGCGTTAATCGGAATTACTGGGCGTAAAGCGAGTGTAGGCGGCTATGTCAGTCGGATGTGAAAGCCCCGGGCTCAACCTGGGAATTGCATTCGATACTGCATAGCTAGAGTTTGGTAGAGGTAAGTGGAATTCCGGG	TACTGAGGGTGCAAGCGTTAATCGGAATTACTGGGCGTAAAGCGAGTGTAGGCGGCTATGTCAGTCGGATGTGAAAGCCCCGGGCTCAACCTGGGAATTGCATTCGATACTGCATAGCTAGAGTTTGGTAGAGGTAAGTGGAATTCCGGG	0.0
TACTGAGGGTGCAAGCGTTAATCGGAATTACTGGGCGTAAAGCGAGTGTAGGCGGCTATTTAAGTCGGATGTGAAATCCCCGGGCTCAACCTGGGAATTGCATTCGATACTGGATAGCTAGAGTTTGGTAGAGGTAAGTGGAATTCCGGG	TACTGAGGGTGCAAGCGTTAATCGGAATTACTGGGCGTAAAGCGAGTGTAGGCGGCTATTTAAGTCGGATGTGAAATCCCCGGGCTCAACCTGGGAATTGCATTCGATACTGGATAGCTAGAGTTTGGTAGAGGTAAGTGGAATTCCGGG	0.0
TACTGAGGGTGCAAGCGTTAATCGGAATTACTGGGCGTAAAGCGAGTGTAGGCGGCTTCGTAAGTCGGATGTGAAAGCCCCGGGCTTAACCTGGGAATTGCATTCGATACTGCGCGGCTAGAGTTTGATAGAGGAAAGTGGAATTCCAGG	TACTGAGGGTGCAAGCGTTAATCGGAATTACTGGGCGTAAAGCGAGTGTAGGCGGCTTCGTAAGTCGGATGTGAAAGCCCCGGGCTTAACCTGGGAATTGCATTCGATACTGCGCGGCTAGAGTTTGATAGAGGAAAGTGGAATTCCAGG	0.0
TACTGAGGGTGCAAGCGTTAATCGGAATTACTGGGCGTAAAGCGAGTGTAGGCGGCTTTGTAAGTCGGATGTGAAAGCCCCGGGCTTAACCTGGGAATTGCATTCGAAACTGCAAGGCTAGAGTTTGATAGAGGAAAGTGGAATTCCAGG	TACTGAGGGTGCAAGCGTTAATCGGAATTACTGGGCGTAAAGCGAGTGTAGGCGGCTTTGTAAGTCGGATGTGAAAGCCCCGGGCTTAACCTGGGAATTGCATTCGAAACTGCAAGGCTAGAGTTTGATAGAGGAAAGTGGAATTCCAGG	0.0
TACTGAGGGTGCGAGCGTTAATCGGAATTACTGGGCGTAAAGCGAGTGTAGGCGGCTACTTAAGTCGGATGTGAAATCCCCGGGCTCAACCTGGGAATTGCATTCGATACTGGGTAGCTAGAGTTTGGTAGAGGTAAGTGGAATTCCGGG	TACTGAGGGTGCGAGCGTTAATCGGAATTACTGGGCGTAAAGCGAGTGTAGGCGGCTACTTAAGTCGGATGTGAAATCCCCGGGCTCAACCTGGGAATTGCATTCGATACTGGGTAGCTAGAGTTTGGTAGAGGTAAGTGGAATTCCGGG	0.0
TACTGAGGGTGCGAGCGTTAATCGGAATTACTGGGCGTAAAGCGCGCGTAGGCGGTTTATTAAGTCAGATGTGAAAGCCCCGGGCTTAACCTGGGAACTGCATTTGATACTGGTAAACTAGAGTTTGGTAGAGGGTGACGGAATTCCAGG	TACTGAGGGTGCGAGCGTTAATCGGAATTACTGGGCGTAAAGCGCGCGTAGGCGGTTTATTAAGTCAGATGTGAAAGCCCCGGGCTTAACCTGGGAACTGCATTTGATACTGGTAAACTAGAGTTTGGTAGAGGGTGACGGAATTCCAGG	0.0
TTCCAGCTCCAATAGCGTATATTAAAGTTGTTGCAGTTAAAAAGCTCGTAGTTGGATTTCTGGCAGGAGTGACCGGTCACACACTCTGTGTGTGAACTCGCGTTGTCTCTGGCCATCCTTGGGGAGATCCTGTTTGGCATTAAGTTGTCG	TTCCAGCTCCAATAGCGTATATTAAAGTTGTTGCAGTTAAAAAGCTCGTAGTTGGATTTCTGGCAGGAGTGACCGGTCACACACTCTGTGTGTGAACTCGCGTTGTCTCTGGCCATCCTTGGGGAGATCCTGTTTGGCATTAAGTTGTCG	0.0
TTCCAGCTCCAATAGCGTATATTAAAGTTGTTGCAGTTAAAAAGCTCGTAGTTGGATTTCTGGTGGGAGCGTTGGGCCGGCCCTAAGGGTCTGAGCTCAAATGTTTTCCGCCATCCTTGGAGGGATGTTGTCTGGCATTAAGTTGTCGGG	TTCCAGCTCCAATAGCGTATATTAAAGTTGTTGCAGTTAAAAAGCTCGTAGTTGGATTTCTGGTGGGAGCGTTGGGCCGGCCCTAAGGGTCTGAGCTCAAATGTTTTCCGCCATCCTTGGAGGGATGTTGTCTGGCATTAAGTTGTCGGG	0.0
TTCCAGCTCCAATAGCGTATATTAATGTTGTTGCAGTTAAAAAGCTCGTAGTTGAATATCTGGACTCAACTTTCGGTCCGGGGCCTTGTGTCCTGCGTACTGTTCTTGTTGGGTCCATCTTAGTAGTGAATGGTTCTGGCATTAAGTTGT	TTCCAGCTCCAATAGCGTATATTAATGTTGTTGCAGTTAAAAAGCTCGTAGTTGAATATCTGGACTCAACTTTCGGTCCGGGGCCTTGTGTCCTGCGTACTGTTCTTGTTGGGTCCATCTTAGTAGTGAATGGTTCTGGCATTAAGTTGT	0.0
TTCCAGCTCCAATAGTGTATATTAAAGTTGTTGCAGTTAAAAAGCTCGTAGTCGAATGTAGGGTTATAAACGCTGAGATGTCTTTTAGGAGACGATTTTTGGCGTCATAACTCTTTTTTACCGACCAAAATTTGATTTTAACTAATCAGA	TTCCAGCTCCAATAGTGTATATTAAAGTTGTTGCAGTTAAAAAGCTCGTAGTCGAATGTAGGGTTATAAACGCTGAGATGTCTTTTAGGAGACGATTTTTGGCGTCATAACTCTTTTTTACCGACCAAAATTTGATTTTAACTAATCAGA	0.0
