	sequence	group
TAGGGAATCTTTCACAATGGGCGAAAGCCTGATGGAGCAACGCCGCGTGCAGGATGAAGGCCTTCGGGTTGTAAACTGCTTTTATAAGCGAGAAATATGATGGTAACTTATGAATAAGGATCGGCTAACTACGTGCCAGCAGCCGCGGTC	TAGGGAATCTTTCACAATGGGCGAAAGCCTGATGGAGCAACGCCGCGTGCAGGATGAAGGCCTTCGGGTTGTAAACTGCTTTTATAAGCGAGAAATATGATGGTAACTTATGAATAAGGATCGGCTAACTACGTGCCAGCAGCCGCGGTC	1.0
TCGGGAATATTGCACAATGGAGGAAACTCTGATGCAGTGACACCGCGTATAGGAAGAAGGTCTTAGGATTGTAAGCTATTGTCGTGTGAGAAGAAAATGACCATCACAGGAGGAAGCCCTGGCTAAATATGTGCCAGCAGCCGCGGTAAT	TCGGGAATATTGCACAATGGAGGAAACTCTGATGCAGTGACACCGCGTATAGGAAGAAGGTCTTAGGATTGTAAGCTATTGTCGTGTGAGAAGAAAATGACCATCACAGGAGGAAGCCCTGGCTAAATATGTGCCAGCAGCCGCGGTAAT	1.0
TGAGGAATATTGGACAATGGGTGGAAGCCTGATCCAGCCATCCCGCGTGCAGGACGACTGCCCTATGGGTTGTAAACTGCTTTTATATAGGGATAAACCTACTCTCGTGAGAGTAGCTGAAGGTACTATATGAATAAGCACCGGCTAACT	TGAGGAATATTGGACAATGGGTGGAAGCCTGATCCAGCCATCCCGCGTGCAGGACGACTGCCCTATGGGTTGTAAACTGCTTTTATATAGGGATAAACCTACTCTCGTGAGAGTAGCTGAAGGTACTATATGAATAAGCACCGGCTAACT	1.0
TGAGGAATATTGGACAATGGTCGGAAGACTGATCCAGCCATGCCGCGTGCAGGATGAAGGTCCTATGGATTGTAAACTGCTTTTGTAAGGGAAGAATAAGGAGTACGTGTACTTTGATGACGGTACCTTACGAATAAGCATCGGCTAACT	TGAGGAATATTGGACAATGGTCGGAAGACTGATCCAGCCATGCCGCGTGCAGGATGAAGGTCCTATGGATTGTAAACTGCTTTTGTAAGGGAAGAATAAGGAGTACGTGTACTTTGATGACGGTACCTTACGAATAAGCATCGGCTAACT	1.0
TGAGGAATATTGGTCAATGGACGAAAGTCTGAACCAGCCAAGTAGCGTGCAGGATGACGGCCCTCCGGGTTGTAAACTGCTTTTAGTTGGGAATAAAAAAAGGGACGTGTCCCTTATTGTATGTACCTTCAGAAAAAGGACCGGCTAATT	TGAGGAATATTGGTCAATGGACGAAAGTCTGAACCAGCCAAGTAGCGTGCAGGATGACGGCCCTCCGGGTTGTAAACTGCTTTTAGTTGGGAATAAAAAAAGGGACGTGTCCCTTATTGTATGTACCTTCAGAAAAAGGACCGGCTAATT	1.0
TGAGGAATATTGGTCAATGGACGGAAGTCTGAACCAGCCAAGTAGCGTGCAGGATGACGGCCCTCCGGGTTGTAAACTGCTTTTAGTTGGGAATAAAAAAGAGGACGTGTCCTCTATTGTATGTACCTTCAGAAAAAGGACCGGCTAATT	TGAGGAATATTGGTCAATGGACGGAAGTCTGAACCAGCCAAGTAGCGTGCAGGATGACGGCCCTCCGGGTTGTAAACTGCTTTTAGTTGGGAATAAAAAAGAGGACGTGTCCTCTATTGTATGTACCTTCAGAAAAAGGACCGGCTAATT	1.0
TGAGGAATATTGGTCAATGGACGTAAGTCTGAACCAGCCAAGTAGCGTGCAGGATGACGGCCCTATGGGTTGTAAACTGCTTTTGTTAGGGAGTAAATGAAGGCACGTGTGCTTTTTTGCATTTACCTTTCGAATAAGGACCGGCTAATT	TGAGGAATATTGGTCAATGGACGTAAGTCTGAACCAGCCAAGTAGCGTGCAGGATGACGGCCCTATGGGTTGTAAACTGCTTTTGTTAGGGAGTAAATGAAGGCACGTGTGCTTTTTTGCATTTACCTTTCGAATAAGGACCGGCTAATT	1.0
TGAGGAATATTGGTCAATGGATGGAAATCTGAACCAGCCAAGTAGCGTGCAGGATGACGGCCCTATGGGTTGTAAACTGCTTTTATGTGAGAATAAAGTTAGGTATGTATACTTATTTGCATGTATCACATGAATAAGGACCGGCTAATT	TGAGGAATATTGGTCAATGGATGGAAATCTGAACCAGCCAAGTAGCGTGCAGGATGACGGCCCTATGGGTTGTAAACTGCTTTTATGTGAGAATAAAGTTAGGTATGTATACTTATTTGCATGTATCACATGAATAAGGACCGGCTAATT	1.0
TGAGGAATATTGGTCAATGGGCGAGAGCCTGAACCAGCCAAGTAGCGTGCAGGAAGACGGCCCTATGGGTTGTAAACTGCTTTTATAGGGGAATAAAGTGGATTACGTGTAGTTTATTGTATGTACCCTATGAATAAGGACCGGCTAATT	TGAGGAATATTGGTCAATGGGCGAGAGCCTGAACCAGCCAAGTAGCGTGCAGGAAGACGGCCCTATGGGTTGTAAACTGCTTTTATAGGGGAATAAAGTGGATTACGTGTAGTTTATTGTATGTACCCTATGAATAAGGACCGGCTAATT	1.0
TGAGGAATATTGGTCAATGGGCGAGAGCCTGAACCAGCCAAGTAGCGTGCAGGATGACGGCCCTCCGGGTTGTAAACTGCTTTTAGTTGGGAATAAAAAAAAGGGACGTGTCCCTTCTTGTATGTACCTTCAGAAAAAGGACCGGCTAAT	TGAGGAATATTGGTCAATGGGCGAGAGCCTGAACCAGCCAAGTAGCGTGCAGGATGACGGCCCTCCGGGTTGTAAACTGCTTTTAGTTGGGAATAAAAAAAAGGGACGTGTCCCTTCTTGTATGTACCTTCAGAAAAAGGACCGGCTAAT	1.0
TGAGGAATATTGGTCAATGGGCGAGAGCCTGAACCAGCCAAGTCGCGTGAAGGATGACTGTCTTATGGATTGTAAACTTCTTTTATACGGGAATAACAAGAGCCACGTGTGGCTCCCTGCATGTACCGTATGAATAAGCATCGGCTAACT	TGAGGAATATTGGTCAATGGGCGAGAGCCTGAACCAGCCAAGTCGCGTGAAGGATGACTGTCTTATGGATTGTAAACTTCTTTTATACGGGAATAACAAGAGCCACGTGTGGCTCCCTGCATGTACCGTATGAATAAGCATCGGCTAACT	1.0
TGAGGAATATTGGTCAATGGGCGAGAGCCTGAACCAGCCAAGTCGCGTGAAGGATGACTGTCTTATGGATTGTAAACTTCTTTTATACGGGAATAACAAGAGTCACGTGTGACTCCCTGCATGTACCGTATGAATAAGCATCGGCTAACT	TGAGGAATATTGGTCAATGGGCGAGAGCCTGAACCAGCCAAGTCGCGTGAAGGATGACTGTCTTATGGATTGTAAACTTCTTTTATACGGGAATAACAAGAGTCACGTGTGACTCCCTGCATGTACCGTATGAATAAGCATCGGCTAACT	1.0
TGAGGAATATTGGTCAATGGGCGAGAGCCTGAACCAGCCAAGTCGCGTGAAGGATGACTGTCTTATGGATTGTAAACTTCTTTTATACGGGAATAACAAGAGTCACGTGTGGCTCCCCGCATGTACCGTATGAATAAGCATCGGCTAACT	TGAGGAATATTGGTCAATGGGCGAGAGCCTGAACCAGCCAAGTCGCGTGAAGGATGACTGTCTTATGGATTGTAAACTTCTTTTATACGGGAATAACAAGAGTCACGTGTGGCTCCCCGCATGTACCGTATGAATAAGCATCGGCTAACT	1.0
TGAGGAATATTGGTCAATGGGCGAGAGCCTGAACCAGCCAAGTCGCGTGAAGGATGACTGTCTTATGGATTGTAAACTTCTTTTATACGGGAATAACAAGAGTCACGTGTGGCTCCCTGCATGTACCGTATGAATAAGCATCGGCTAACT	TGAGGAATATTGGTCAATGGGCGAGAGCCTGAACCAGCCAAGTCGCGTGAAGGATGACTGTCTTATGGATTGTAAACTTCTTTTATACGGGAATAACAAGAGTCACGTGTGGCTCCCTGCATGTACCGTATGAATAAGCATCGGCTAACT	1.0
TGAGGAATATTGGTCAATGGGCGAGAGCCTGAACCAGCCAAGTCGCGTGAAGGATGACTGTCTTATGGATTGTAAACTTCTTTTGTAGGGGAATAAAGAACAGCACGTGTGCTGTAGTGAATGTACCCTACGAATAAGCATCGGCTAACT	TGAGGAATATTGGTCAATGGGCGAGAGCCTGAACCAGCCAAGTCGCGTGAAGGATGACTGTCTTATGGATTGTAAACTTCTTTTGTAGGGGAATAAAGAACAGCACGTGTGCTGTAGTGAATGTACCCTACGAATAAGCATCGGCTAACT	1.0
TGAGGAATATTGGTCAATGGGCGGAAGCCTGAACCAGCCAAGTAGCGTGCAGGAAGACGGCCCTATGGGTTGTAAACTGCTTTTACAGGGGAATAAAAAGGAGCACGTGTGCTTTATTGCATGTACCCTGCGAATAAGGACCGGCTAATT	TGAGGAATATTGGTCAATGGGCGGAAGCCTGAACCAGCCAAGTAGCGTGCAGGAAGACGGCCCTATGGGTTGTAAACTGCTTTTACAGGGGAATAAAAAGGAGCACGTGTGCTTTATTGCATGTACCCTGCGAATAAGGACCGGCTAATT	1.0
TGAGGAATATTGGTCAATGGGCGTAAGCCTGAACCAGCCAAGTAGCGTGCAGGATGACGGCCCTATGGGTTGTAAACTGCTTTTATGCGGGGATAAAAGAGCCCACGTGTGGGTTTTTGCAGGTACCGCATGAATAAGGACCGGCTAATT	TGAGGAATATTGGTCAATGGGCGTAAGCCTGAACCAGCCAAGTAGCGTGCAGGATGACGGCCCTATGGGTTGTAAACTGCTTTTATGCGGGGATAAAAGAGCCCACGTGTGGGTTTTTGCAGGTACCGCATGAATAAGGACCGGCTAATT	1.0
TGAGGAATCTTCCACAATGGACGAAAGTCTGATGGAGCGACACCGCGTGAAGGATGAAGGCCTAACGGTTGTAAACTTCTTTTCTGAAGGAGCATAATGAGAGTACTTTAGGAATAAGGGACGGCTAAATATGTGCCAGCAGCCGCGGTA	TGAGGAATCTTCCACAATGGACGAAAGTCTGATGGAGCGACACCGCGTGAAGGATGAAGGCCTAACGGTTGTAAACTTCTTTTCTGAAGGAGCATAATGAGAGTACTTTAGGAATAAGGGACGGCTAAATATGTGCCAGCAGCCGCGGTA	1.0
TGAGGAATCTTCCACAATGGGCGAAAGCCTGATGGAGCGACACCGCGTGAAGGATGAAGCCTTTGTTGGTGTAAACTTCTTTTCTCTTGGAAGATAATGACGGTACAAGAGGAATAAGGGGCGGCAAACTTCGTGCCAGCAGCCGCGGTA	TGAGGAATCTTCCACAATGGGCGAAAGCCTGATGGAGCGACACCGCGTGAAGGATGAAGCCTTTGTTGGTGTAAACTTCTTTTCTCTTGGAAGATAATGACGGTACAAGAGGAATAAGGGGCGGCAAACTTCGTGCCAGCAGCCGCGGTA	1.0
TGGGGAATATTGCACAATGGGCGAAAGCCTGATGCAGCAACGCCGCGTGAACGATGAAGGTCTTCGGATCGTAAAGTTCTGTTGCAGGGGAAGATAATGACGGTACCCTGTGAGGAAGCCCCGGCTAACTACGTGCCAGCAGCCGCGGTA	TGGGGAATATTGCACAATGGGCGAAAGCCTGATGCAGCAACGCCGCGTGAACGATGAAGGTCTTCGGATCGTAAAGTTCTGTTGCAGGGGAAGATAATGACGGTACCCTGTGAGGAAGCCCCGGCTAACTACGTGCCAGCAGCCGCGGTA	1.0
TGGGGAATATTGCACAATGGGCGAAAGCCTGATGCAGCAACGCCGCGTGAGCGAGGAAGGCCTTTGGGTCGTAAAGCTCTGTTGAGAGGGAAGAAAAAAATGACGGTACCTCTTGAGGAAGCCCCGGCTAACTACGTGCCAGCAGCCGCG	TGGGGAATATTGCACAATGGGCGAAAGCCTGATGCAGCAACGCCGCGTGAGCGAGGAAGGCCTTTGGGTCGTAAAGCTCTGTTGAGAGGGAAGAAAAAAATGACGGTACCTCTTGAGGAAGCCCCGGCTAACTACGTGCCAGCAGCCGCG	1.0
TGGGGAATATTGCACAATGGGCGAAAGCCTGATGCAGCGACGCCGCGTGAGGGATGGAGGCCTTCGGGTTGTAAACCTCTTTCGCTCATGGTCAAGCCGCAGCTTTGGGTTGTGGTGAGGGTAGTGGGTAAAGAAGCGCCGGCTAACTAC	TGGGGAATATTGCACAATGGGCGAAAGCCTGATGCAGCGACGCCGCGTGAGGGATGGAGGCCTTCGGGTTGTAAACCTCTTTCGCTCATGGTCAAGCCGCAGCTTTGGGTTGTGGTGAGGGTAGTGGGTAAAGAAGCGCCGGCTAACTAC	1.0
TGGGGAATATTGCACAATGGGCGCAAGCCTGATGCAGCGACGCCGCGTGAGGGATGGAGGCCTTCGGGTTGTGAACCTCTTTCGCCAGTGAAGCAGGCCTGCTCCTTTTGTGGGTGGGTTGACGGTAGCTGGATAAGAAGCGCCGGCTAA	TGGGGAATATTGCACAATGGGCGCAAGCCTGATGCAGCGACGCCGCGTGAGGGATGGAGGCCTTCGGGTTGTGAACCTCTTTCGCCAGTGAAGCAGGCCTGCTCCTTTTGTGGGTGGGTTGACGGTAGCTGGATAAGAAGCGCCGGCTAA	1.0
TGGGGAATATTGCACAATGGGCGCAAGCCTGATGCAGCGACGCCGCGTGGGGGATGACGGCCTTCGGGTTGTAAACTCCTTTCGTTAGGGACGAAGCCGCGCTTTTTTTGGGTGTGGTGACGGTACCTTTGTTAAGAAGCACCGGCTAAC	TGGGGAATATTGCACAATGGGCGCAAGCCTGATGCAGCGACGCCGCGTGGGGGATGACGGCCTTCGGGTTGTAAACTCCTTTCGTTAGGGACGAAGCCGCGCTTTTTTTGGGTGTGGTGACGGTACCTTTGTTAAGAAGCACCGGCTAAC	1.0
TGGGGAATATTGCACAATGGGCGCAAGCCTGATGCAGCGACGCCGCGTGGGGGATGGAAGGCCTTCGGGTTGTAAACTCCTTTCGCCCGGGACGAAGCCCACCTTAGTGGGTGACGGTACCGTGGAGAAGAAGCACCGGCTAACTACGTG	TGGGGAATATTGCACAATGGGCGCAAGCCTGATGCAGCGACGCCGCGTGGGGGATGGAAGGCCTTCGGGTTGTAAACTCCTTTCGCCCGGGACGAAGCCCACCTTAGTGGGTGACGGTACCGTGGAGAAGAAGCACCGGCTAACTACGTG	1.0
TGGGGAATATTGCACAATGGGGGAAACCCTGATGCAGCGACGCCGCGTGAACGAAGAAGGCTTTCGAGTCGTAAAGTTCTGTCCTATGAGAAGATAATGACGGTATCATAGGAGGAAGCCCCGGCTAAATACGTGCCAGCAGCCGCGGTA	TGGGGAATATTGCACAATGGGGGAAACCCTGATGCAGCGACGCCGCGTGAACGAAGAAGGCTTTCGAGTCGTAAAGTTCTGTCCTATGAGAAGATAATGACGGTATCATAGGAGGAAGCCCCGGCTAAATACGTGCCAGCAGCCGCGGTA	1.0
TGGGGAATATTGCACAATGGGGGAAACCCTGATGCAGCGACGCCGCGTGAGCGAAGAAGGTTTTCGAATCGTAAAGCTCTGTCCTATGAGAAGATAATGACGGTATCATAGGAGGAAGCCCCGGCTAAATACGTGCCAGCAGCCGCGGTA	TGGGGAATATTGCACAATGGGGGAAACCCTGATGCAGCGACGCCGCGTGAGCGAAGAAGGTTTTCGAATCGTAAAGCTCTGTCCTATGAGAAGATAATGACGGTATCATAGGAGGAAGCCCCGGCTAAATACGTGCCAGCAGCCGCGGTA	1.0
TGGGGAATATTGCACAATGGGGGGAACCCTGATGCAGCAACGCCGCGTGAGTGAAGAAGGCATTCGTGTCGTAAAACTCTGTAGTAGGGGAAGAAAAAAATGACAGTACCCTAAAAGAAAGCCCCGGCTAACTACGTGCCAGCAGCCGCG	TGGGGAATATTGCACAATGGGGGGAACCCTGATGCAGCAACGCCGCGTGAGTGAAGAAGGCATTCGTGTCGTAAAACTCTGTAGTAGGGGAAGAAAAAAATGACAGTACCCTAAAAGAAAGCCCCGGCTAACTACGTGCCAGCAGCCGCG	1.0
TGGGGAATATTGCACAATGGGGGGAACCCTGATGCAGCCATGCCGCGTGAATGAAGAAGGCCTTCGGGTTGTAAAGTTCTTTCGGTAGCGAGGAAGGCATTTAGTTTAATAGACTAGATGATTGACGTTAACTACAGAAGAAGCACCGGC	TGGGGAATATTGCACAATGGGGGGAACCCTGATGCAGCCATGCCGCGTGAATGAAGAAGGCCTTCGGGTTGTAAAGTTCTTTCGGTAGCGAGGAAGGCATTTAGTTTAATAGACTAGATGATTGACGTTAACTACAGAAGAAGCACCGGC	1.0
TGGGGAATATTGCGCAATGGGGGGAACCCTGACGCAGCCATGCCGCGTGAATGAAGAAGGCCTTCGGGTTGTAAAGTTCTTTCGGTATTGAGGAAGGTTGGTGTGTTAATAGCACATCAAATTGACGTTAAATACAGAAGAAGCACCGGC	TGGGGAATATTGCGCAATGGGGGGAACCCTGACGCAGCCATGCCGCGTGAATGAAGAAGGCCTTCGGGTTGTAAAGTTCTTTCGGTATTGAGGAAGGTTGGTGTGTTAATAGCACATCAAATTGACGTTAAATACAGAAGAAGCACCGGC	1.0
TGGGGAATATTGCGCAATGGGGGGAACCCTGACGCAGCCATGCCGCGTGAATGAAGAAGGCCTTCGGGTTGTAAAGTTCTTTCGGTGACGAGGAAGGTTGTTGTGTTAATAGCGCAACAAATTGACGTTAATCACAGAAGAAGCACCGGC	TGGGGAATATTGCGCAATGGGGGGAACCCTGACGCAGCCATGCCGCGTGAATGAAGAAGGCCTTCGGGTTGTAAAGTTCTTTCGGTGACGAGGAAGGTTGTTGTGTTAATAGCGCAACAAATTGACGTTAATCACAGAAGAAGCACCGGC	1.0
TGGGGAATATTGGACAATGGACCAAAAGTCTGATCCAGCAATTCTGTGTGCACGATGACGTTTTTCGGAATGTAAAGTGCTTTCAGTTGGGAAGAAAAAAATGACGGTACCAACAGAAGAAGTGACGGCTAAATACGTGCCAGCAGCCGC	TGGGGAATATTGGACAATGGACCAAAAGTCTGATCCAGCAATTCTGTGTGCACGATGACGTTTTTCGGAATGTAAAGTGCTTTCAGTTGGGAAGAAAAAAATGACGGTACCAACAGAAGAAGTGACGGCTAAATACGTGCCAGCAGCCGC	1.0
TGGGGAATATTGGACAATGGACCAAAAGTCTGATCCAGCAATTCTGTGTGCACGATGACGTTTTTCGGAATGTAAAGTGCTTTCAGTTGGGAAGAAAAAATGACGGTACCAACAGAAGAAGTGACGGCTAAATACGTGCCAGCAGCCGCG	TGGGGAATATTGGACAATGGACCAAAAGTCTGATCCAGCAATTCTGTGTGCACGATGACGTTTTTCGGAATGTAAAGTGCTTTCAGTTGGGAAGAAAAAATGACGGTACCAACAGAAGAAGTGACGGCTAAATACGTGCCAGCAGCCGCG	1.0
TGGGGAATATTGGACAATGGGCGAAAGCCTGATCCAGCCATGCCGCGTGTGTGAAGAAGGCCTTTTGGTTGTAAAGCACTTTAAGTGGGGAGGAAAAGTTGACGGTTAATACCCGCCAGCCCTGACGTTACCCACAGAATAAGCACCGGC	TGGGGAATATTGGACAATGGGCGAAAGCCTGATCCAGCCATGCCGCGTGTGTGAAGAAGGCCTTTTGGTTGTAAAGCACTTTAAGTGGGGAGGAAAAGTTGACGGTTAATACCCGCCAGCCCTGACGTTACCCACAGAATAAGCACCGGC	1.0
TGGGGAATATTGGACAATGGGGGCAACCCTGATCCAGCAATTCTGTGTGCACGAAGACGGTTTTCGGATTGTAAAGTGCTTTCAGCAGGGAAGAAGGAAGTGACGGTACCTGCAGAAGAAGCGACGGCTAAATACGTGCCAGCAGCCGCG	TGGGGAATATTGGACAATGGGGGCAACCCTGATCCAGCAATTCTGTGTGCACGAAGACGGTTTTCGGATTGTAAAGTGCTTTCAGCAGGGAAGAAGGAAGTGACGGTACCTGCAGAAGAAGCGACGGCTAAATACGTGCCAGCAGCCGCG	1.0
TGGGGAATATTGGACAATGGGGGCAACCCTGATCCAGCGACGCCGCGTGAGTGAAGAAGTATTTCGGTATGTAAAGCTCTATCGATAACGGAAGAAAATGACAAGCCGTTAAGGAAGAAGCCCCGGCTAACTACGTGCCAGCAGCCGCGG	TGGGGAATATTGGACAATGGGGGCAACCCTGATCCAGCGACGCCGCGTGAGTGAAGAAGTATTTCGGTATGTAAAGCTCTATCGATAACGGAAGAAAATGACAAGCCGTTAAGGAAGAAGCCCCGGCTAACTACGTGCCAGCAGCCGCGG	1.0
TGGGGAATCTTCCGCAATGGACGAAAGTCTGACGGAGCAACGCCGCGTGAGTGATGAAGGTCTTCGGATTGTAAAGCTCTGTTAATCGGGACGAAAGAGTTCTGTGTAAATAATGCAGAAAAGTGACGGTACCGGAATAGAAAGCCACGG	TGGGGAATCTTCCGCAATGGACGAAAGTCTGACGGAGCAACGCCGCGTGAGTGATGAAGGTCTTCGGATTGTAAAGCTCTGTTAATCGGGACGAAAGAGTTCTGTGTAAATAATGCAGAAAAGTGACGGTACCGGAATAGAAAGCCACGG	1.0
TGGGGAATCTTCCGCAATGGACGAAAGTCTGACGGAGCAACGCCGCGTGAGTGATGACGGCCTTCGGGTTGTAAAGCTCTGTTAATCGGGACGAAAGGTCCTCTTGCGAATAGTTAGAGGAATTGACGGTACCGGAATAGAAAGCCACGG	TGGGGAATCTTCCGCAATGGACGAAAGTCTGACGGAGCAACGCCGCGTGAGTGATGACGGCCTTCGGGTTGTAAAGCTCTGTTAATCGGGACGAAAGGTCCTCTTGCGAATAGTTAGAGGAATTGACGGTACCGGAATAGAAAGCCACGG	1.0
TGGGGAATCTTCCGCAATGGACGAAAGTCTGACGGAGCAACGCCGCGTGAGTGATGACGGCCTTCGGGTTGTAAAGCTCTGTTAATCGGGACGAATGGTTCTTGTACGAATAGTGCGAGGATTTGACGGTACCGGAATAGAAAGCCACGG	TGGGGAATCTTCCGCAATGGACGAAAGTCTGACGGAGCAACGCCGCGTGAGTGATGACGGCCTTCGGGTTGTAAAGCTCTGTTAATCGGGACGAATGGTTCTTGTACGAATAGTGCGAGGATTTGACGGTACCGGAATAGAAAGCCACGG	1.0
TGGGGAATCTTCCGCAATGGGCGAAAGCCTGACGGAGCAATGCCGCGTGAGTGAAGAAGGCCTTCGGGTTGTAAAACTCTGTCCTTATCGAAGAGAGAGTGTTGTAGTAACTGACAATACTAGGACGGTAGATGAGGAGGAAGCCCCGGC	TGGGGAATCTTCCGCAATGGGCGAAAGCCTGACGGAGCAATGCCGCGTGAGTGAAGAAGGCCTTCGGGTTGTAAAACTCTGTCCTTATCGAAGAGAGAGTGTTGTAGTAACTGACAATACTAGGACGGTAGATGAGGAGGAAGCCCCGGC	1.0
TGGGGAATCTTGCACAATGGACGAAAGTCTGATGCAGCAATTTCGCGTGAAGGATGAAGCATTACGGTGTGTAAACTTCTTTTTTGGAGGAAGACGAATGACGGTACTTCAAGAATAAGAGACGGCTAACTACGTGCCAGCAGCCGCGGT	TGGGGAATCTTGCACAATGGACGAAAGTCTGATGCAGCAATTTCGCGTGAAGGATGAAGCATTACGGTGTGTAAACTTCTTTTTTGGAGGAAGACGAATGACGGTACTTCAAGAATAAGAGACGGCTAACTACGTGCCAGCAGCCGCGGT	1.0
TGGGGAATCTTGCACAATGGACGAAAGTCTGATGCAGCAATTTCGCGTGAAGGATGAAGCATTACGGTGTGTAAACTTCTTTTTTGGCAGAAGACGAATGACGGTATGTCAAGAATAAGAGACGGCTAACTACGTGCCAGCAGCCGCGGT	TGGGGAATCTTGCACAATGGACGAAAGTCTGATGCAGCAATTTCGCGTGAAGGATGAAGCATTACGGTGTGTAAACTTCTTTTTTGGCAGAAGACGAATGACGGTATGTCAAGAATAAGAGACGGCTAACTACGTGCCAGCAGCCGCGGT	1.0
TGGGGAATTTTGGACAATGGGGGGAACCCTGATCCAGCCATGCCGCGTGTATGAAGAAGGCCTTAGGGTTGTAAAGTACTTTTGTTAGGGAAGAAAAGGCGTTTGCTAATATCAGATGCTGATGACGGTACCTAAAGAATAAGCACCGGC	TGGGGAATTTTGGACAATGGGGGGAACCCTGATCCAGCCATGCCGCGTGTATGAAGAAGGCCTTAGGGTTGTAAAGTACTTTTGTTAGGGAAGAAAAGGCGTTTGCTAATATCAGATGCTGATGACGGTACCTAAAGAATAAGCACCGGC	1.0
TGGGGGATATTGCACAATGGGGGGAACCCTGATGCAGCAACGCCGCGTGAGTGAAGAAGGCCTTAGGGTCGTAAAGCTCTGTCGTATGGGAAGAAACAAATGACTGTACCATACAAGAAAGCCCCGGCTAACTACGTGCCAGCAGCCGCG	TGGGGGATATTGCACAATGGGGGGAACCCTGATGCAGCAACGCCGCGTGAGTGAAGAAGGCCTTAGGGTCGTAAAGCTCTGTCGTATGGGAAGAAACAAATGACTGTACCATACAAGAAAGCCCCGGCTAACTACGTGCCAGCAGCCGCG	1.0
TGGGGGATATTGCACAATGGGGGGAACCCTGATGCAGCAACGCCGCGTGAGTGAAGAAGGCTTTCGAGTCGTAAAGCTCTGTCGTATGAGAAGAATAAATGACTGTATCATACAAGAAAGCCCCGGCTAACTACGTGCCAGCAGCCGCGG	TGGGGGATATTGCACAATGGGGGGAACCCTGATGCAGCAACGCCGCGTGAGTGAAGAAGGCTTTCGAGTCGTAAAGCTCTGTCGTATGAGAAGAATAAATGACTGTATCATACAAGAAAGCCCCGGCTAACTACGTGCCAGCAGCCGCGG	1.0
CTAAGAATATTCCGCAATGGGGGGAACCCTGACGGAGCGACGCCGCGTGGACGATGAAGGCTGGAAGGTTGTAAAGTCCTTTTGTCCGCGAGGAATAATATTGGGAGGAAATGCCTGATAGGTGACGGTAGCGGATGAATAAGCACCGGC	CTAAGAATATTCCGCAATGGGGGGAACCCTGACGGAGCGACGCCGCGTGGACGATGAAGGCTGGAAGGTTGTAAAGTCCTTTTGTCCGCGAGGAATAATATTGGGAGGAAATGCCTGATAGGTGACGGTAGCGGATGAATAAGCACCGGC	0.0
TAAGGAATATTGGACAATGGGCGAAAGCCTGATCCAGCCATGCCGCGTGAAGGATGAAGGTCCTCTGGATTGTAAACTTCTTTTATTTGGGACGAAAAAAGGGAATTCTTTCCCACTTGACGGTACCAGATGAATAAGCACCGGCTAACT	TAAGGAATATTGGACAATGGGCGAAAGCCTGATCCAGCCATGCCGCGTGAAGGATGAAGGTCCTCTGGATTGTAAACTTCTTTTATTTGGGACGAAAAAAGGGAATTCTTTCCCACTTGACGGTACCAGATGAATAAGCACCGGCTAACT	0.0
TAGGGAATATTGCGCAATGGGGGAAACCCTGACGCAGCAACGCCGCGTGGAGGATGACACTTTTCGGAGCGTAAACTCCTTTTGTTAGGGAAGAATAATGACGGTACCTAACGAATAAGCACCGGCTAACTCCGTGCCAGCAGCCGCGGT	TAGGGAATATTGCGCAATGGGGGAAACCCTGACGCAGCAACGCCGCGTGGAGGATGACACTTTTCGGAGCGTAAACTCCTTTTGTTAGGGAAGAATAATGACGGTACCTAACGAATAAGCACCGGCTAACTCCGTGCCAGCAGCCGCGGT	0.0
TAGGGAATATTGCTCAATGGGGGAAACCCTGAAGCAGCAACGCCGCGTGGAGGATGACACTTTTCGGAGCGTAAACTCCTTTTGTTAGGGAAGAACAATGACGGTACCTAACGAATAAGCACCGGCTAACTCCGTGCCAGCAGCCGCGGT	TAGGGAATATTGCTCAATGGGGGAAACCCTGAAGCAGCAACGCCGCGTGGAGGATGACACTTTTCGGAGCGTAAACTCCTTTTGTTAGGGAAGAACAATGACGGTACCTAACGAATAAGCACCGGCTAACTCCGTGCCAGCAGCCGCGGT	0.0
TAGGGAATCTTCCGCAATGGACGCAAGTCTGACGGAGCAACGCCGCGTGAGTGAAGAAGGTTTTCGGATCGTAAAACTCTGTTGTTAGAGAAGAACAAGTGCTAGAGTAACTGTTAGCGCCTTGACGGTATCTAACCAGAAAGCCACGGC	TAGGGAATCTTCCGCAATGGACGCAAGTCTGACGGAGCAACGCCGCGTGAGTGAAGAAGGTTTTCGGATCGTAAAACTCTGTTGTTAGAGAAGAACAAGTGCTAGAGTAACTGTTAGCGCCTTGACGGTATCTAACCAGAAAGCCACGGC	0.0
TAGGGAATCTTCCGCAATGGGCGAAAGCCTGACGGAGCAACGCCGCGTGAGTGAAGAAGGATTTCGGTTCGTAAAGCTCTGTTGTTAGGGAAGAATGATTGTATAGTAACTATATACAATAGAGACGGTACCTAACCAGAAAGCCACGGC	TAGGGAATCTTCCGCAATGGGCGAAAGCCTGACGGAGCAACGCCGCGTGAGTGAAGAAGGATTTCGGTTCGTAAAGCTCTGTTGTTAGGGAAGAATGATTGTATAGTAACTATATACAATAGAGACGGTACCTAACCAGAAAGCCACGGC	0.0
TAGGGAATCTTCGGCAATGGGGGCAACCCTGACCGAGCAACGCCGCGTGAGTGAAGAAGGTTTTCGGATCGTAAAGCTCTGTTGTAAGAGAAGAACGAGTGTGAGAGTGGAAAGTTCACACTGTGACGGTAACTTACCAGAAAGGGACGG	TAGGGAATCTTCGGCAATGGGGGCAACCCTGACCGAGCAACGCCGCGTGAGTGAAGAAGGTTTTCGGATCGTAAAGCTCTGTTGTAAGAGAAGAACGAGTGTGAGAGTGGAAAGTTCACACTGTGACGGTAACTTACCAGAAAGGGACGG	0.0
TAGGGAATCTTCGGCAATGGGGGCAACCCTGACCGAGCAACGCCGCGTGAGTGAAGAAGGTTTTCGGATCGTAAAGCTCTGTTGTAAGTCAAGAACGAGTGTGAGAGTGGAAAATTCACACTGTGACGGTAGCTTACCAGAAAGGGACGG	TAGGGAATCTTCGGCAATGGGGGCAACCCTGACCGAGCAACGCCGCGTGAGTGAAGAAGGTTTTCGGATCGTAAAGCTCTGTTGTAAGTCAAGAACGAGTGTGAGAGTGGAAAATTCACACTGTGACGGTAGCTTACCAGAAAGGGACGG	0.0
TAGGGAATCTTCGGCAATGGGGGCAACCCTGACCGAGCAACGCCGCGTGAGTGAAGAAGGTTTTCGGATCGTAAAGCTCTGTTGTAAGTCAAGAACGAGTGTGAGAGTGGAAAGTTCACACTGTGACGGTAGCTTACCAGAAAGGGACGG	TAGGGAATCTTCGGCAATGGGGGCAACCCTGACCGAGCAACGCCGCGTGAGTGAAGAAGGTTTTCGGATCGTAAAGCTCTGTTGTAAGTCAAGAACGAGTGTGAGAGTGGAAAGTTCACACTGTGACGGTAGCTTACCAGAAAGGGACGG	0.0
TAGGGAATCTTCGGCAATGGGGGGAACCCTGACCGAGCAACGCCGCGTGAGTGAAGAAGGTTTTCGGATCGTAAAGCTCTGTTGTTAAGGAAGAACGAGTGTGAGAATGGAAAGTTCATACTGTGACGGTACTTAACCAGAAAGGGACGG	TAGGGAATCTTCGGCAATGGGGGGAACCCTGACCGAGCAACGCCGCGTGAGTGAAGAAGGTTTTCGGATCGTAAAGCTCTGTTGTTAAGGAAGAACGAGTGTGAGAATGGAAAGTTCATACTGTGACGGTACTTAACCAGAAAGGGACGG	0.0
TAGGGAATCTTCGGCAATGGGGGGAACCCTGACCGAGCAACGCCGCGTGAGTGAAGAAGGTTTTCGGATCGTAAAGCTCTGTTGTTAAGGAAGAACGGGAGTAGGAGTGGAAAGCCTACTTTGTGACGGTACTTAACCAGAAAGGGACGG	TAGGGAATCTTCGGCAATGGGGGGAACCCTGACCGAGCAACGCCGCGTGAGTGAAGAAGGTTTTCGGATCGTAAAGCTCTGTTGTTAAGGAAGAACGGGAGTAGGAGTGGAAAGCCTACTTTGTGACGGTACTTAACCAGAAAGGGACGG	0.0
TAGGGAATCTTTCACAATGGGCGAAAGCCTGATGGAGCAATGCCGCGTGCAGGACGAAGGCCTTCGGGTTGTAAACTGCTTTTAAAGCCGAGAAATATGATGGTAAGCTTTGAATAAGGATCGGCTAACTACGTGCCAGCAGCCGCGGTC	TAGGGAATCTTTCACAATGGGCGAAAGCCTGATGGAGCAATGCCGCGTGCAGGACGAAGGCCTTCGGGTTGTAAACTGCTTTTAAAGCCGAGAAATATGATGGTAAGCTTTGAATAAGGATCGGCTAACTACGTGCCAGCAGCCGCGGTC	0.0
TAGGGAATTTTCGGCAATGGGGGGAACCCTGACCGAGCAACGCCGCGTGAGTGAAGACGGCCTTCGGGTTGTAAAGCTCTGTTGTAAGAAAAGATAAACTAGGAGAGGATCTTAGTCAGACATTATCTTACCAGAAAGCCACGGCTAACT	TAGGGAATTTTCGGCAATGGGGGGAACCCTGACCGAGCAACGCCGCGTGAGTGAAGACGGCCTTCGGGTTGTAAAGCTCTGTTGTAAGAAAAGATAAACTAGGAGAGGATCTTAGTCAGACATTATCTTACCAGAAAGCCACGGCTAACT	0.0
TGAGGAATATTGGACAATGGGTGGGAGCCTGATCCAGCCATTCCGCGTGCAGGAAGAAGGTCTTATGGATTGTAAACTGCTTTTATATAGGGATAAACCTACTCTCGCGAGGGTAGCTGAAGGTACTATATGAATAAGCACCGGCTAACT	TGAGGAATATTGGACAATGGGTGGGAGCCTGATCCAGCCATTCCGCGTGCAGGAAGAAGGTCTTATGGATTGTAAACTGCTTTTATATAGGGATAAACCTACTCTCGCGAGGGTAGCTGAAGGTACTATATGAATAAGCACCGGCTAACT	0.0
TGAGGAATATTGGACAATGGTCGGAAGACTGATCCAGCCATGCCGCGTGCAGGATGAAGGTCTTATGGATTGTAAACTGCTTTTGTAAGGGAAGAATAAGAGCTACGTGTAGTTTGATGACGGTACCTTATGAATAAGCATCGGCTAACT	TGAGGAATATTGGACAATGGTCGGAAGACTGATCCAGCCATGCCGCGTGCAGGATGAAGGTCTTATGGATTGTAAACTGCTTTTGTAAGGGAAGAATAAGAGCTACGTGTAGTTTGATGACGGTACCTTATGAATAAGCATCGGCTAACT	0.0
TGAGGAATATTGGACAATGGTCGGAAGACTGATCCAGCCATGCCGCGTGCAGGATGACGGCCTTATGGGTTGTAAACTGCTTTTGTAAGGGAAGAATAAGAGCTACGCGTAGTTTGATGACGGTACCTTATGAATAAGCATCGGCTAACT	TGAGGAATATTGGACAATGGTCGGAAGACTGATCCAGCCATGCCGCGTGCAGGATGACGGCCTTATGGGTTGTAAACTGCTTTTGTAAGGGAAGAATAAGAGCTACGCGTAGTTTGATGACGGTACCTTATGAATAAGCATCGGCTAACT	0.0
TGAGGAATATTGGACAATGGTCGGAAGACTGATCCAGCCATGCCGCGTGCAGGATGACGGCCTTATGGGTTGTAAACTGCTTTTGTAAGGGAAGAATAAGGAGTACGTGTACTTTGATGACGGTACCTTACGAATAAGCATCGGCTAACT	TGAGGAATATTGGACAATGGTCGGAAGACTGATCCAGCCATGCCGCGTGCAGGATGACGGCCTTATGGGTTGTAAACTGCTTTTGTAAGGGAAGAATAAGGAGTACGTGTACTTTGATGACGGTACCTTACGAATAAGCATCGGCTAACT	0.0
TGAGGAATATTGGTCAATGGACGTAAGTCTGAACCAGCCAAGTAGCGTGCAGGATTGACGGCCCTATGGGTTGTAAACTGCTTTTGTTGGGGAGTAAAGCGGGGCACGTGTGCCCCTTTGCATTTACCCTTCGAATAAGGACCGGCTAAT	TGAGGAATATTGGTCAATGGACGTAAGTCTGAACCAGCCAAGTAGCGTGCAGGATTGACGGCCCTATGGGTTGTAAACTGCTTTTGTTGGGGAGTAAAGCGGGGCACGTGTGCCCCTTTGCATTTACCCTTCGAATAAGGACCGGCTAAT	0.0
TGAGGAATATTGGTCAATGGGCGAGAGCCTGAACCAGCCAAGTAGCGTGCAGGAAGACGGCCCTATGGGTTGTAAACTGCTTTTATAGGGGAATAAAGTGATCTACGTGTAGTTTATTGTATGTACCCTATGAATAAGGACCGGCTAATT	TGAGGAATATTGGTCAATGGGCGAGAGCCTGAACCAGCCAAGTAGCGTGCAGGAAGACGGCCCTATGGGTTGTAAACTGCTTTTATAGGGGAATAAAGTGATCTACGTGTAGTTTATTGTATGTACCCTATGAATAAGGACCGGCTAATT	0.0
TGAGGAATATTGGTCAATGGGCGAGAGCCTGAACCAGCCAAGTAGCGTGCAGGACGACGGCCCTATGGGTTGTAAACTGCTTTTGTATGGGGATAAAGTCAATCACGTGTGATTGTTTGCAGGTACCATACGAATAAGGACCGGCTAATT	TGAGGAATATTGGTCAATGGGCGAGAGCCTGAACCAGCCAAGTAGCGTGCAGGACGACGGCCCTATGGGTTGTAAACTGCTTTTGTATGGGGATAAAGTCAATCACGTGTGATTGTTTGCAGGTACCATACGAATAAGGACCGGCTAATT	0.0
TGAGGAATATTGGTCAATGGGCGAGAGCCTGAACCAGCCAAGTAGCGTGCAGGATGACGGCCCTATGGGTTGTAAACTGCTTTTATGCGGGGATAAAGTGAGGGACGTGTCCTTCATTGCAGGTACCGCATGAATAAGGACCGGCTAATT	TGAGGAATATTGGTCAATGGGCGAGAGCCTGAACCAGCCAAGTAGCGTGCAGGATGACGGCCCTATGGGTTGTAAACTGCTTTTATGCGGGGATAAAGTGAGGGACGTGTCCTTCATTGCAGGTACCGCATGAATAAGGACCGGCTAATT	0.0
TGAGGAATATTGGTCAATGGGCGAGAGCCTGAACCAGCCAAGTAGCGTGCAGGATGACGGCCCTATGGGTTGTAAACTGCTTTTATGTGGGGATAAAGTGAGCTACGTGTAGTTTATTGCAGGTACCACATGAATAAGGACCGGCTAATT	TGAGGAATATTGGTCAATGGGCGAGAGCCTGAACCAGCCAAGTAGCGTGCAGGATGACGGCCCTATGGGTTGTAAACTGCTTTTATGTGGGGATAAAGTGAGCTACGTGTAGTTTATTGCAGGTACCACATGAATAAGGACCGGCTAATT	0.0
TGAGGAATATTGGTCAATGGGCGAGAGCCTGAACCAGCCAAGTAGCGTGCAGGATGACGGCCCTATGGGTTGTAAACTGCTTTTGTATGGGGATAAAGTCAATCACGTGTGATTGTTTGCAGGTACCATACGAATAAGGACCGGCTAATT	TGAGGAATATTGGTCAATGGGCGAGAGCCTGAACCAGCCAAGTAGCGTGCAGGATGACGGCCCTATGGGTTGTAAACTGCTTTTGTATGGGGATAAAGTCAATCACGTGTGATTGTTTGCAGGTACCATACGAATAAGGACCGGCTAATT	0.0
TGAGGAATATTGGTCAATGGGCGGAAGCCTGAACCAGCCAAGTAGCGTGCAGGAAGACGGCCCTATGGGTTGTAAACTGCTTTTACAGGGGAATAAAGTGAGATACGTGTGTTTCATTGCATGTACCCTGCGAATAAGGACCGGCTAATT	TGAGGAATATTGGTCAATGGGCGGAAGCCTGAACCAGCCAAGTAGCGTGCAGGAAGACGGCCCTATGGGTTGTAAACTGCTTTTACAGGGGAATAAAGTGAGATACGTGTGTTTCATTGCATGTACCCTGCGAATAAGGACCGGCTAATT	0.0
TGAGGAATATTGGTCAATGGGCGGAAGCCTGAACCAGCCAAGTAGCGTGCAGGATGACGGCCCTATGGGTTGTAAACTGCTTTTATGCGGGGATAAAGGGGCCCACGTGTGGGCTTTTGCAGGTACCGCATGAATAAGGACCGGCTAATT	TGAGGAATATTGGTCAATGGGCGGAAGCCTGAACCAGCCAAGTAGCGTGCAGGATGACGGCCCTATGGGTTGTAAACTGCTTTTATGCGGGGATAAAGGGGCCCACGTGTGGGCTTTTGCAGGTACCGCATGAATAAGGACCGGCTAATT	0.0
TGAGGAATATTGGTCAATGGGCGGAAGCCTGAACCAGCCAAGTAGCGTGCAGGATGACGGCCCTATGGGTTGTAAACTGCTTTTATGCGGGGATAACCGGGGCCACGCGTGGCCCCCTGCAGGTACCGCATGAATAAGGACCGGCTAATT	TGAGGAATATTGGTCAATGGGCGGAAGCCTGAACCAGCCAAGTAGCGTGCAGGATGACGGCCCTATGGGTTGTAAACTGCTTTTATGCGGGGATAACCGGGGCCACGCGTGGCCCCCTGCAGGTACCGCATGAATAAGGACCGGCTAATT	0.0
TGAGGAATATTGGTCAATGGGCGTGAGCCTGAACCAGCCAAGTAGCGTGCAGGATGACGGCCCTATGGGTTGTAAACTGCTTTTATACGGGGATAAAAGGGTGAACGTGTTCTCCTTTGCAGGTACCGTATGAATAAGGACCGGCTAATT	TGAGGAATATTGGTCAATGGGCGTGAGCCTGAACCAGCCAAGTAGCGTGCAGGATGACGGCCCTATGGGTTGTAAACTGCTTTTATACGGGGATAAAAGGGTGAACGTGTTCTCCTTTGCAGGTACCGTATGAATAAGGACCGGCTAATT	0.0
TGAGGAATATTGGTCAATGGTCGGAAGACTGAACCAGCCATGCCGCGTGCAGGAAGAATGCCTTATGGGTTGTAAACTGCTTTTATATGGGAAGAATAAGGAGTACGCGTACTTTGATGACGGTACCATATGAATAAGCATCGGCTAACT	TGAGGAATATTGGTCAATGGTCGGAAGACTGAACCAGCCATGCCGCGTGCAGGAAGAATGCCTTATGGGTTGTAAACTGCTTTTATATGGGAAGAATAAGGAGTACGCGTACTTTGATGACGGTACCATATGAATAAGCATCGGCTAACT	0.0
TGAGGAATATTTCACAATGAGCGAAAGCTTGATGGAGCAATGCCGCGTGCAGGATGAAGGCCCTCGGGTTGTAAACTGCTTTTATAAGAGAAGATTATGACGGTAACTTATGAATAAGGGACGGCTAACTACGTGCCAGCAGCCGCGGTC	TGAGGAATATTTCACAATGAGCGAAAGCTTGATGGAGCAATGCCGCGTGCAGGATGAAGGCCCTCGGGTTGTAAACTGCTTTTATAAGAGAAGATTATGACGGTAACTTATGAATAAGGGACGGCTAACTACGTGCCAGCAGCCGCGGTC	0.0
TGGGGAATATTGCACAATGGGCGAAAGCCTGATGCAGCGACGCCGCGTGAGGGATGGAGGCCTTCGGGTTGTAAACCTCTTTCGCTCATGGTCAAGCCGCAACAGTGGTTGTGGTGAGGGTAGTGGGTAAAGAAGCACCGGCTAACTACG	TGGGGAATATTGCACAATGGGCGAAAGCCTGATGCAGCGACGCCGCGTGAGGGATGGAGGCCTTCGGGTTGTAAACCTCTTTCGCTCATGGTCAAGCCGCAACAGTGGTTGTGGTGAGGGTAGTGGGTAAAGAAGCACCGGCTAACTACG	0.0
TGGGGAATATTGCACAATGGGCGAAAGCCTGATGCAGCGACGCCGCGTGAGGGATGGAGGCCTTCGGGTTGTAAACCTCTTTCGCTCATGGTCAAGCCGCAACGCTGGTTGTGGTGAGGGTAGTGGGTAAAGAAGCGCCGGCTAACTACG	TGGGGAATATTGCACAATGGGCGAAAGCCTGATGCAGCGACGCCGCGTGAGGGATGGAGGCCTTCGGGTTGTAAACCTCTTTCGCTCATGGTCAAGCCGCAACGCTGGTTGTGGTGAGGGTAGTGGGTAAAGAAGCGCCGGCTAACTACG	0.0
TGGGGAATATTGCACAATGGGCGAAAGCCTGATGCAGCGACGCCGCGTGAGGGATGGAGGCCTTCGGGTTGTAAACCTCTTTCGCTCATGGTCAAGCCGCAACTGTGGGTTGTGGTGAGGGTAGTGGGTAAAGAAGCGCCGGCTAACTAC	TGGGGAATATTGCACAATGGGCGAAAGCCTGATGCAGCGACGCCGCGTGAGGGATGGAGGCCTTCGGGTTGTAAACCTCTTTCGCTCATGGTCAAGCCGCAACTGTGGGTTGTGGTGAGGGTAGTGGGTAAAGAAGCGCCGGCTAACTAC	0.0
TGGGGAATATTGCACAATGGGCGCAAGCCTGATGCAGCGACGCCGCGTGAGGGATGAAGGCCTTCGGGTTGTAAACCTCTTTCGTCAGGGAACAAGGCACTGCTTTTTGGTGGTGTTGAGGGTACCTGGATAAGAAGCGCCGGCTAACTA	TGGGGAATATTGCACAATGGGCGCAAGCCTGATGCAGCGACGCCGCGTGAGGGATGAAGGCCTTCGGGTTGTAAACCTCTTTCGTCAGGGAACAAGGCACTGCTTTTTGGTGGTGTTGAGGGTACCTGGATAAGAAGCGCCGGCTAACTA	0.0
TGGGGAATATTGCACAATGGGCGCAAGCCTGATGCAGCGACGCCGCGTGAGGGATGACGGCCTTCGGGTTGTAAACCTCTGTTAGCATCGAAGAAGCGAAAGTGACGGTAGGTGCAGAGAAAGCGCCGGCTAACTACGTGCCAGCAGCCG	TGGGGAATATTGCACAATGGGCGCAAGCCTGATGCAGCGACGCCGCGTGAGGGATGACGGCCTTCGGGTTGTAAACCTCTGTTAGCATCGAAGAAGCGAAAGTGACGGTAGGTGCAGAGAAAGCGCCGGCTAACTACGTGCCAGCAGCCG	0.0
TGGGGAATATTGCACAATGGGCGCAAGCCTGATGCAGCGACGCCGCGTGAGGGATGGAGGCCTTCGGGTTGTAAACCTCTTTCGCCAGTGAAGCAGGCCCGCCTCGTTTGTGGGTGGGTTGACGGTAGCTGGATAAGAAGCGCCGGCTAA	TGGGGAATATTGCACAATGGGCGCAAGCCTGATGCAGCGACGCCGCGTGAGGGATGGAGGCCTTCGGGTTGTAAACCTCTTTCGCCAGTGAAGCAGGCCCGCCTCGTTTGTGGGTGGGTTGACGGTAGCTGGATAAGAAGCGCCGGCTAA	0.0
TGGGGAATATTGCACAATGGGCGCAAGCCTGATGCAGCGACGCCGCGTGAGGGATGGAGGCCTTCGGGTTGTAAACCTCTTTCGCCAGTGAAGCAGGCCTGCTCCTTGTGGGTGGGTTGACGGTAGCTGGATAAGAAGCGCCGGCTAACT	TGGGGAATATTGCACAATGGGCGCAAGCCTGATGCAGCGACGCCGCGTGAGGGATGGAGGCCTTCGGGTTGTAAACCTCTTTCGCCAGTGAAGCAGGCCTGCTCCTTGTGGGTGGGTTGACGGTAGCTGGATAAGAAGCGCCGGCTAACT	0.0
TGGGGAATATTGCACAATGGGCGCAAGCCTGATGCAGCGACGCCGCGTGAGGGATGGAGGCCTTCGGGTTGTAAACCTCTTTCGCCAGTGAAGCAGGCCTGTCCCTTGTGGGTGGGTTGACGGTAGCTGGATAAGAAGCGCCGGCTAACT	TGGGGAATATTGCACAATGGGCGCAAGCCTGATGCAGCGACGCCGCGTGAGGGATGGAGGCCTTCGGGTTGTAAACCTCTTTCGCCAGTGAAGCAGGCCTGTCCCTTGTGGGTGGGTTGACGGTAGCTGGATAAGAAGCGCCGGCTAACT	0.0
TGGGGAATATTGCACAATGGGCGCAAGCCTGATGCAGCGACGCCGCGTGAGGGATGGAGGCCTTCGGGTTGTAAACCTCTTTTATCGGGGAGCAAGCGTGAGTGAGTTTACCCGTTGAATAAGCACCGGCTAACTACGTGCCAGCAGCCG	TGGGGAATATTGCACAATGGGCGCAAGCCTGATGCAGCGACGCCGCGTGAGGGATGGAGGCCTTCGGGTTGTAAACCTCTTTTATCGGGGAGCAAGCGTGAGTGAGTTTACCCGTTGAATAAGCACCGGCTAACTACGTGCCAGCAGCCG	0.0
TGGGGAATATTGCACAATGGGCGCAAGCCTGATGCAGCGACGCCGCGTGAGGGATGGAGGCCTTCGGGTTGTGAACCTCTTTCGCCAGTGAAGCAGGCCTGTCCCTGTGTGGGTGGGTTGACGGTAGCTGGATAAGAAGCGCCGGCTAAC	TGGGGAATATTGCACAATGGGCGCAAGCCTGATGCAGCGACGCCGCGTGAGGGATGGAGGCCTTCGGGTTGTGAACCTCTTTCGCCAGTGAAGCAGGCCTGTCCCTGTGTGGGTGGGTTGACGGTAGCTGGATAAGAAGCGCCGGCTAAC	0.0
TGGGGAATATTGCACAATGGGCGCAAGCCTGATGCAGCGACGCCGCGTGCGGGATGGAGGCCTTCGGGTTGTAAACCGCTTTTATAGGGGGGCAAGCTATGCCTGTGTGGTGTGGTGAGTGGACTTTATGAATAAGCACCGGCTAACTAC	TGGGGAATATTGCACAATGGGCGCAAGCCTGATGCAGCGACGCCGCGTGCGGGATGGAGGCCTTCGGGTTGTAAACCGCTTTTATAGGGGGGCAAGCTATGCCTGTGTGGTGTGGTGAGTGGACTTTATGAATAAGCACCGGCTAACTAC	0.0
TGGGGAATATTGCACAATGGGCGCAAGCCTGATGCAGCGACGCCGCGTGGGGGATGACGGCCTTCGGGTTGTAAACTCCTTTCGTTAGGGACGAAGCCACGCCTGTTTTGGGTGTGGTGACGGTACCTTTGTTAAGAAGCACCGGCTAAC	TGGGGAATATTGCACAATGGGCGCAAGCCTGATGCAGCGACGCCGCGTGGGGGATGACGGCCTTCGGGTTGTAAACTCCTTTCGTTAGGGACGAAGCCACGCCTGTTTTGGGTGTGGTGACGGTACCTTTGTTAAGAAGCACCGGCTAAC	0.0
TGGGGAATATTGCACAATGGGCGCAAGCCTGATGCAGCGACGCCGCGTGGGGGATGACGGCCTTCGGGTTGTAAACTCCTTTCGTTAGGGACGAAGCCACGCCTTTTTTGGGTGTGGTGACGGTACCTTTGTTAAGAAGCACCGGCTAAC	TGGGGAATATTGCACAATGGGCGCAAGCCTGATGCAGCGACGCCGCGTGGGGGATGACGGCCTTCGGGTTGTAAACTCCTTTCGTTAGGGACGAAGCCACGCCTTTTTTGGGTGTGGTGACGGTACCTTTGTTAAGAAGCACCGGCTAAC	0.0
TGGGGAATATTGCACAATGGGCGCAAGCCTGATGCAGCGACGCCGCGTGGGGGATGACGGCCTTCGGGTTGTAAACTCCTTTCGTTAGGGACGAAGCCACGCTTTTTTTGGGTGTGGTGACGGTACCTTTGTTAAGAAGCACCGGCTAAC	TGGGGAATATTGCACAATGGGCGCAAGCCTGATGCAGCGACGCCGCGTGGGGGATGACGGCCTTCGGGTTGTAAACTCCTTTCGTTAGGGACGAAGCCACGCTTTTTTTGGGTGTGGTGACGGTACCTTTGTTAAGAAGCACCGGCTAAC	0.0
TGGGGAATATTGCACAATGGGGGAAACCCTGATGCAGCGACGCCGCGTGAGTGAAGAAGTATTTCGGTATGTAAAGCTCTATCAGCAGGGAAGAAAATGACGGTACCTGAGTAAGAAGCCCCGGCTAACTACGTGCCAGCAGCCGCGGTA	TGGGGAATATTGCACAATGGGGGAAACCCTGATGCAGCGACGCCGCGTGAGTGAAGAAGTATTTCGGTATGTAAAGCTCTATCAGCAGGGAAGAAAATGACGGTACCTGAGTAAGAAGCCCCGGCTAACTACGTGCCAGCAGCCGCGGTA	0.0
TGGGGAATATTGCACAATGGGGGGAACCCTGATGCAGCGACGCCGCGTGAGCGAAGAAGGTTTTCGAATCGTAAAGCTCTGTCCTATGAGAAGATAATGACGGTATCATAGGAGGAAGCCCCGGCTAAATACGTGCCAGCAGCCGCGGTA	TGGGGAATATTGCACAATGGGGGGAACCCTGATGCAGCGACGCCGCGTGAGCGAAGAAGGTTTTCGAATCGTAAAGCTCTGTCCTATGAGAAGATAATGACGGTATCATAGGAGGAAGCCCCGGCTAAATACGTGCCAGCAGCCGCGGTA	0.0
TGGGGAATATTGCGCAATGGGGGCAACCCTGACGCAGCCATGCCGCGTGAATGAAGAAGGCCTTCGGGTTGTAAAGTTCTTTCGGTAGCGAGGAAGGCACTTAGTTTAATAAACTAGGTGATTGACGTTAACTACAGAAGAAGCACCGGC	TGGGGAATATTGCGCAATGGGGGCAACCCTGACGCAGCCATGCCGCGTGAATGAAGAAGGCCTTCGGGTTGTAAAGTTCTTTCGGTAGCGAGGAAGGCACTTAGTTTAATAAACTAGGTGATTGACGTTAACTACAGAAGAAGCACCGGC	0.0
TGGGGAATATTGGACAATGGACCAAGAGTCTGATCCAGCAATTCTGTGTGCACGATGAAGTTTTTCGGAATGTAAAGTGCTTTCAGTTGGGAAGAAAGAAATGACGGTACCAACAGAAGAAGTGACGGCTAAATACGTGCCAGCAGCCGC	TGGGGAATATTGGACAATGGACCAAGAGTCTGATCCAGCAATTCTGTGTGCACGATGAAGTTTTTCGGAATGTAAAGTGCTTTCAGTTGGGAAGAAAGAAATGACGGTACCAACAGAAGAAGTGACGGCTAAATACGTGCCAGCAGCCGC	0.0
TGGGGAATATTGGACAATGGACCGAGAGTCTGATCCAGCAATTCTGTGTGCACGATGAAGTTTTTCGGAATGTAAAGTGCTTTCAGTTGGGAAGAAAGAAATGACGGTACCAACAGAAGAAGTGACGGCTAAATACGTGCCAGCAGCCGC	TGGGGAATATTGGACAATGGACCGAGAGTCTGATCCAGCAATTCTGTGTGCACGATGAAGTTTTTCGGAATGTAAAGTGCTTTCAGTTGGGAAGAAAGAAATGACGGTACCAACAGAAGAAGTGACGGCTAAATACGTGCCAGCAGCCGC	0.0
TGGGGAATATTGGACAATGGAGGAAACTCTGATCCAGCAATTCTGTGTGTGTGAAGAAGGTCTTCGGATTGTAAAACACTTTTAGTTGGGAAGAAACAAATGACGGTACCAACAGAAGAAGCGACGGCTAAATACGTGCCAGCAGCCGCG	TGGGGAATATTGGACAATGGAGGAAACTCTGATCCAGCAATTCTGTGTGTGTGAAGAAGGTCTTCGGATTGTAAAACACTTTTAGTTGGGAAGAAACAAATGACGGTACCAACAGAAGAAGCGACGGCTAAATACGTGCCAGCAGCCGCG	0.0
TGGGGAATATTGGACAATGGGCGAAAGCCTGATCCAGCCATGCCGCGTGTGTGAAGAAGATCTTCGGATTGTAAAGCACTTTAAGTTGGGAGGAAGGGCAGTAAGCTAATACCTTGCTGTTTTGACGTTACCGACAGAATAAGCACCGGC	TGGGGAATATTGGACAATGGGCGAAAGCCTGATCCAGCCATGCCGCGTGTGTGAAGAAGATCTTCGGATTGTAAAGCACTTTAAGTTGGGAGGAAGGGCAGTAAGCTAATACCTTGCTGTTTTGACGTTACCGACAGAATAAGCACCGGC	0.0
TGGGGAATATTGGACAATGGGCGAAAGCCTGATCCAGCCATGCCGCGTGTGTGAAGAAGGTCTTCGGATTGTAAAGCACTTTAAGTTGGGAGGAAGGGCAGTAAGCTAATACCTTGCTGTTTTGACGTTACCGACAGAATAAGCACCGGC	TGGGGAATATTGGACAATGGGCGAAAGCCTGATCCAGCCATGCCGCGTGTGTGAAGAAGGTCTTCGGATTGTAAAGCACTTTAAGTTGGGAGGAAGGGCAGTAAGCTAATACCTTGCTGTTTTGACGTTACCGACAGAATAAGCACCGGC	0.0
TGGGGAATATTGGACAATGGGCGAAAGCCTGATCCAGCCATGCCGCGTGTGTGAAGAAGGTCTTCGGATTGTAAAGCACTTTAAGTTGGGAGGAAGGGCAGTAAGTTAATACCTTGCTGTTTTGACGTTACCGACAGAATAAGCACCGGC	TGGGGAATATTGGACAATGGGCGAAAGCCTGATCCAGCCATGCCGCGTGTGTGAAGAAGGTCTTCGGATTGTAAAGCACTTTAAGTTGGGAGGAAGGGCAGTAAGTTAATACCTTGCTGTTTTGACGTTACCGACAGAATAAGCACCGGC	0.0
TGGGGAATATTGGACAATGGGCGAAAGCCTGATCCAGCTATGCCGCGTGTGTGAAGAAGGCCTTTTGGTTGTAAAGCACTTTAAGCGAGGAGGAGGCTACTTAGATTAATACTCTAGGATAGTGGACGTTACTCGCAGAATAAGCACCGG	TGGGGAATATTGGACAATGGGCGAAAGCCTGATCCAGCTATGCCGCGTGTGTGAAGAAGGCCTTTTGGTTGTAAAGCACTTTAAGCGAGGAGGAGGCTACTTAGATTAATACTCTAGGATAGTGGACGTTACTCGCAGAATAAGCACCGG	0.0
TGGGGAATATTGGACAATGGGCGCAAGCCTGATCCAGCCATGCCGCGTGTGTGAAGAAGGCCTTTTGGTTGTAAAGCACTTTAAGCGAGGAGGAGGCTACTTGGATTAATACTCTAGGATAGTGGACGTTACTCGCAGAATAAGCACCGG	TGGGGAATATTGGACAATGGGCGCAAGCCTGATCCAGCCATGCCGCGTGTGTGAAGAAGGCCTTTTGGTTGTAAAGCACTTTAAGCGAGGAGGAGGCTACTTGGATTAATACTCTAGGATAGTGGACGTTACTCGCAGAATAAGCACCGG	0.0
TGGGGAATATTGGACAATGGGGGCAACCCTGATCCAGCCATGCCGCGTGAGTGATGAAGGCCTTCGGGTTGTAAAGCTCTTTTGGCGGGGACGATGATGACGGTACCCGCAGAATAAGCCCCGGCTAACTTCGTGCCAGCAGCCGCGGTA	TGGGGAATATTGGACAATGGGGGCAACCCTGATCCAGCCATGCCGCGTGAGTGATGAAGGCCTTCGGGTTGTAAAGCTCTTTTGGCGGGGACGATGATGACGGTACCCGCAGAATAAGCCCCGGCTAACTTCGTGCCAGCAGCCGCGGTA	0.0
TGGGGAATATTGGACAATGGGGGGAACCCTGATCCAGCAATGCCGCGTGTGTGAAGAAGGCCTTCGGGTTGTAAAGCACTTTCAGCAGGGAGGAAAGGTACGTAGTTAATAGCTGCGCAATTGACGTTACCTGCAGAAGAAGCACCGGCT	TGGGGAATATTGGACAATGGGGGGAACCCTGATCCAGCAATGCCGCGTGTGTGAAGAAGGCCTTCGGGTTGTAAAGCACTTTCAGCAGGGAGGAAAGGTACGTAGTTAATAGCTGCGCAATTGACGTTACCTGCAGAAGAAGCACCGGCT	0.0
TGGGGAATCTTCCACAATGGGCGAAAGCCTGATGGAGCAACGCCGCGTGAGTGAAGAAGGTCTTCGGATCGTAAAGCTCTGTTGCACGGGACGAAAACTGGGTTTGAAAACATTGAACCTGGGTGACGGTACCGAGCGAGGAAGCCACGG	TGGGGAATCTTCCACAATGGGCGAAAGCCTGATGGAGCAACGCCGCGTGAGTGAAGAAGGTCTTCGGATCGTAAAGCTCTGTTGCACGGGACGAAAACTGGGTTTGAAAACATTGAACCTGGGTGACGGTACCGAGCGAGGAAGCCACGG	0.0
TGGGGAATCTTCCGCAATGGACGAAAGTCTGACGGAGCAACGCCGCGTGAACGAAGAAGGTCTTCGGATTGTAAAGTTCTGTGATTCGGGACGAAAGGGTTTGTGGTGAATAATCATAGACATTGACGGTACCGAAAAAGCAAGCCACGG	TGGGGAATCTTCCGCAATGGACGAAAGTCTGACGGAGCAACGCCGCGTGAACGAAGAAGGTCTTCGGATTGTAAAGTTCTGTGATTCGGGACGAAAGGGTTTGTGGTGAATAATCATAGACATTGACGGTACCGAAAAAGCAAGCCACGG	0.0
TGGGGAATCTTCCGCAATGGACGAAAGTCTGACGGAGCAACGCCGCGTGAGTGATGACGGCCTTCGGGTTGTAAAGCTCTGTTAATCGGGACGAAAGGCCTTCTTGCGAATAGTGAGAAGGATTGACGGTACCGGAATAGAAAGCCACGG	TGGGGAATCTTCCGCAATGGACGAAAGTCTGACGGAGCAACGCCGCGTGAGTGATGACGGCCTTCGGGTTGTAAAGCTCTGTTAATCGGGACGAAAGGCCTTCTTGCGAATAGTGAGAAGGATTGACGGTACCGGAATAGAAAGCCACGG	0.0
TGGGGAATCTTCCGCAATGGACGAAAGTCTGACGGAGCAACGCCGCGTGAGTGATGACGGCCTTCGGGTTGTAAAGCTCTGTTAATCGGGACGAAAGGCCTTCTTGCGAATAGTTAGAAGGATTGACGGTACCGGAATAGAAAGCCACGG	TGGGGAATCTTCCGCAATGGACGAAAGTCTGACGGAGCAACGCCGCGTGAGTGATGACGGCCTTCGGGTTGTAAAGCTCTGTTAATCGGGACGAAAGGCCTTCTTGCGAATAGTTAGAAGGATTGACGGTACCGGAATAGAAAGCCACGG	0.0
TGGGGAATCTTCCGCAATGGACGAAAGTCTGACGGAGCAACGCCGCGTGAGTGATGACGGCCTTCGGGTTGTAAAGCTCTGTTAATCGGGACGAAAGGCTTTCTTGCGAATAGTTAGAAGGATTGACGGTACCGGAATAGAAAGCCACGG	TGGGGAATCTTCCGCAATGGACGAAAGTCTGACGGAGCAACGCCGCGTGAGTGATGACGGCCTTCGGGTTGTAAAGCTCTGTTAATCGGGACGAAAGGCTTTCTTGCGAATAGTTAGAAGGATTGACGGTACCGGAATAGAAAGCCACGG	0.0
TGGGGAATCTTCCGCAATGGACGAAAGTCTGACGGAGCAACGCCGCGTGAGTGATGACGGCCTTCGGGTTGTAAAGCTCTGTTAATCGGGACGAATGGTTCTTGTGCAAATAGTGCGAGGATTTGACGGTACCGGAATAGAAAGCCACGG	TGGGGAATCTTCCGCAATGGACGAAAGTCTGACGGAGCAACGCCGCGTGAGTGATGACGGCCTTCGGGTTGTAAAGCTCTGTTAATCGGGACGAATGGTTCTTGTGCAAATAGTGCGAGGATTTGACGGTACCGGAATAGAAAGCCACGG	0.0
TGGGGAATCTTCCGCAATGGACGAAAGTCTGACGGAGCAACGCCGCGTGAGTGATGACGGCCTTCGGGTTGTAAAGCTCTGTTAATCGGGACGAATGGTTCTTGTGCGAATAGTGCGAGGATTTGACGGTACCGGAATAGAAAGCCACGG	TGGGGAATCTTCCGCAATGGACGAAAGTCTGACGGAGCAACGCCGCGTGAGTGATGACGGCCTTCGGGTTGTAAAGCTCTGTTAATCGGGACGAATGGTTCTTGTGCGAATAGTGCGAGGATTTGACGGTACCGGAATAGAAAGCCACGG	0.0
TGGGGAATCTTCCGCAATGGGCGAAAGCCTGACGGAGCAACGCCGCGTGAGTGAAGACGGCCTTCGGGTTGTAAAGCTCTGTTACACGGGACGAACGGGTTTTGTGCGAACAGCATAAGACCGTGACGGTACCGTAGAAGAAAGCCACGG	TGGGGAATCTTCCGCAATGGGCGAAAGCCTGACGGAGCAACGCCGCGTGAGTGAAGACGGCCTTCGGGTTGTAAAGCTCTGTTACACGGGACGAACGGGTTTTGTGCGAACAGCATAAGACCGTGACGGTACCGTAGAAGAAAGCCACGG	0.0
TGGGGAATCTTCCGCAATGGGCGAAAGCCTGACGGAGCAACGCCGCGTGAGTGAAGACGGCCTTCGGGTTGTAAAGCTCTGTTATACGGGACGAATAATCTTGTGGTTAATACCCATGAGAAGTGACGGTACCGTAAGAGAAAGCCACGG	TGGGGAATCTTCCGCAATGGGCGAAAGCCTGACGGAGCAACGCCGCGTGAGTGAAGACGGCCTTCGGGTTGTAAAGCTCTGTTATACGGGACGAATAATCTTGTGGTTAATACCCATGAGAAGTGACGGTACCGTAAGAGAAAGCCACGG	0.0
TGGGGAATCTTCCGCAATGGGCGAAAGCCTGACGGAGCAACGCCGCGTGAGTGAAGACGGCCTTCGGGTTGTAAAGCTCTGTTATACGGGACGAATAGTCTTGTGGTTAATACCCATAAGAAGTGACGGTACCGTAAGAGAAAGCCACGG	TGGGGAATCTTCCGCAATGGGCGAAAGCCTGACGGAGCAACGCCGCGTGAGTGAAGACGGCCTTCGGGTTGTAAAGCTCTGTTATACGGGACGAATAGTCTTGTGGTTAATACCCATAAGAAGTGACGGTACCGTAAGAGAAAGCCACGG	0.0
TGGGGAATCTTCCGCAATGGGCGAAAGCCTGACGGAGCAACGCCGCGTGAGTGAAGACGGCCTTCGGGTTGTAAAGCTCTGTTATACGGGACGAATAGTCTTGTGGTTAATACCCATGAGAAGTGACGGTACCGTAAGAGAAAGCCACGG	TGGGGAATCTTCCGCAATGGGCGAAAGCCTGACGGAGCAACGCCGCGTGAGTGAAGACGGCCTTCGGGTTGTAAAGCTCTGTTATACGGGACGAATAGTCTTGTGGTTAATACCCATGAGAAGTGACGGTACCGTAAGAGAAAGCCACGG	0.0
TGGGGAATCTTCCGCAATGGGCGCAAGCCTGACGGAGCAACGCCGCGTGAGTGAAGAAGGTCTTCGGATCGTAAAGCTCTGTTGAAGGGGACGAACGTACACAGTGCGAATAGTTCTGTGTAATGACGGTACCTTTTGAGGAAGCCACGG	TGGGGAATCTTCCGCAATGGGCGCAAGCCTGACGGAGCAACGCCGCGTGAGTGAAGAAGGTCTTCGGATCGTAAAGCTCTGTTGAAGGGGACGAACGTACACAGTGCGAATAGTTCTGTGTAATGACGGTACCTTTTGAGGAAGCCACGG	0.0
TGGGGAATCTTCCGCAATGGGCGCAAGCCTGACGGAGCAACGCCGCGTGAGTGAAGAAGGTCTTCGGATCGTAAAGCTCTGTTGAAGGGGACGAACGTGCGCAGTGCAAATAGTACTGCGTAATGACGGTACCTTTTGAGGAAGCCACGG	TGGGGAATCTTCCGCAATGGGCGCAAGCCTGACGGAGCAACGCCGCGTGAGTGAAGAAGGTCTTCGGATCGTAAAGCTCTGTTGAAGGGGACGAACGTGCGCAGTGCAAATAGTACTGCGTAATGACGGTACCTTTTGAGGAAGCCACGG	0.0
TGGGGAATCTTCCGCAATGGGCGCAAGCCTGACGGAGCAACGCCGCGTGAGTGAAGAAGGTCTTCGGATCGTAAAGCTCTGTTGACGGGGACGAACGTGCGTGATGCGAACAGTGTCATGCAATGACGGTACCTGTCGAGGAAGCCACGG	TGGGGAATCTTCCGCAATGGGCGCAAGCCTGACGGAGCAACGCCGCGTGAGTGAAGAAGGTCTTCGGATCGTAAAGCTCTGTTGACGGGGACGAACGTGCGTGATGCGAACAGTGTCATGCAATGACGGTACCTGTCGAGGAAGCCACGG	0.0
TGGGGAATCTTCCGCAATGGGCGCAAGCCTGACGGAGCAACGCCGCGTGAGTGAAGAAGGTCTTCGGATCGTAAAGCTCTGTTGATGGGGACGAACGTGCCTAATGCGAATAGTTTTAGGTAATGACGGTACCCATCGAGGAAGCCACGG	TGGGGAATCTTCCGCAATGGGCGCAAGCCTGACGGAGCAACGCCGCGTGAGTGAAGAAGGTCTTCGGATCGTAAAGCTCTGTTGATGGGGACGAACGTGCCTAATGCGAATAGTTTTAGGTAATGACGGTACCCATCGAGGAAGCCACGG	0.0
TGGGGAATCTTGCGCAATGGGCGAAAGCCTGACGCAGCCATGCCGCGTGGATGATGAAGGTCTTAGGATTGTAAAATCCTTTCACCGGGGACGATAATGACGGTACCCGGAGAAGAAGCCCCGGCTAACTTCGTGCCAGCAGCCGCGGTA	TGGGGAATCTTGCGCAATGGGCGAAAGCCTGACGCAGCCATGCCGCGTGGATGATGAAGGTCTTAGGATTGTAAAATCCTTTCACCGGGGACGATAATGACGGTACCCGGAGAAGAAGCCCCGGCTAACTTCGTGCCAGCAGCCGCGGTA	0.0
TGGGGAATTTTGGACAATGGGCGAAAGCCTGATCCAGCAATGCCGCGTGTGTGAAGAAGGCCTTCGGGTTGTAAAGCACTTTTGTCCGGAAAGAAATCCTTGGCTCTAATACAGTCGGGGGATGACGGTACCGGAAGAATAAGCACCGGC	TGGGGAATTTTGGACAATGGGCGAAAGCCTGATCCAGCAATGCCGCGTGTGTGAAGAAGGCCTTCGGGTTGTAAAGCACTTTTGTCCGGAAAGAAATCCTTGGCTCTAATACAGTCGGGGGATGACGGTACCGGAAGAATAAGCACCGGC	0.0
TGGGGAATTTTGGACAATGGGCGCAAGCCTGATCCAGCCATGCCGCGTGTCTGAAGAAGGCCTTCGGGTTGTAAAGGACTTTTGTTAGGGAAGAAAAGAAATGGGTTAATACCCCATTTTGCTGACGGTACCTAAAGAATAAGCACCGGC	TGGGGAATTTTGGACAATGGGCGCAAGCCTGATCCAGCCATGCCGCGTGTCTGAAGAAGGCCTTCGGGTTGTAAAGGACTTTTGTTAGGGAAGAAAAGAAATGGGTTAATACCCCATTTTGCTGACGGTACCTAAAGAATAAGCACCGGC	0.0
TGGGGAATTTTGGACAATGGGCGCAAGCCTGATCCAGCCATGCCGCGTGTCTGAAGAAGGCCTTCGGGTTGTAAAGGACTTTTGTTAGGGAAGAAAAGGAGTATGTTAATACCATACTCTGCTGACGGTACCTAAAGAATAAGCACCGGC	TGGGGAATTTTGGACAATGGGCGCAAGCCTGATCCAGCCATGCCGCGTGTCTGAAGAAGGCCTTCGGGTTGTAAAGGACTTTTGTTAGGGAAGAAAAGGAGTATGTTAATACCATACTCTGCTGACGGTACCTAAAGAATAAGCACCGGC	0.0
TGGGGAATTTTGGACAATGGGCGCAAGCCTGATCCAGCCATGCCGCGTGTCTGAAGAAGGCCTTCGGGTTGTAAAGGACTTTTGTTAGGGAAGAAAAGGATAATGTTAATACCATTATCTGCTGACGGTACCTAAAGAATAAGCACCGGC	TGGGGAATTTTGGACAATGGGCGCAAGCCTGATCCAGCCATGCCGCGTGTCTGAAGAAGGCCTTCGGGTTGTAAAGGACTTTTGTTAGGGAAGAAAAGGATAATGTTAATACCATTATCTGCTGACGGTACCTAAAGAATAAGCACCGGC	0.0
TGGGGAATTTTGGACAATGGGCGCAAGCCTGATCCAGCCATGCCGCGTGTCTGAAGAAGGCCTTCGGGTTGTAAAGGACTTTTGTTAGGGAAGAAAAGGATAGTGTTAATACCATTATCTGCTGACGGTACCTAAAGAATAAGCACCGGC	TGGGGAATTTTGGACAATGGGCGCAAGCCTGATCCAGCCATGCCGCGTGTCTGAAGAAGGCCTTCGGGTTGTAAAGGACTTTTGTTAGGGAAGAAAAGGATAGTGTTAATACCATTATCTGCTGACGGTACCTAAAGAATAAGCACCGGC	0.0
TGGGGAATTTTGGACAATGGGGGCAACCCTGATCCAGCAATGCCGCGTGTGTGAAGAAGGCCTTCGGGTTGTAAAGCACTTTTGTCCGGAAAGAAATCGCACTTACTAATATTAGGTGTGGATGACGGTACCGGAAGAATAAGGACCGGC	TGGGGAATTTTGGACAATGGGGGCAACCCTGATCCAGCAATGCCGCGTGTGTGAAGAAGGCCTTCGGGTTGTAAAGCACTTTTGTCCGGAAAGAAATCGCACTTACTAATATTAGGTGTGGATGACGGTACCGGAAGAATAAGGACCGGC	0.0
TGGGGGATTTTGCACAATGGGCGCAAGCCTGATGCAGCGACGCCGCGTGAGGGATGGAGGCCTTCGGGTTGTGAACCTCTGTCGCCGGTGATGTAGGCTCTGCTTTGTGGGTGGGGTTGACGGTAGCCGGGGTATGAAGTGCCGGCTAAC	TGGGGGATTTTGCACAATGGGCGCAAGCCTGATGCAGCGACGCCGCGTGAGGGATGGAGGCCTTCGGGTTGTGAACCTCTGTCGCCGGTGATGTAGGCTCTGCTTTGTGGGTGGGGTTGACGGTAGCCGGGGTATGAAGTGCCGGCTAAC	0.0
