	sequence	group
GTAAGAATATTCCGCAATGGGGGGAACCCTGACGGAGCGACGCCGCGTGAACGAAGAAGGCCGGAAGGTTGTAAAGTTCTTTTCTGTTCGAGGAATAAGTGTCGGAGGAAATGCCGACATGGTGACGGTAGGGCAGGAATAAGCACCGGC	GTAAGAATATTCCGCAATGGGGGGAACCCTGACGGAGCGACGCCGCGTGAACGAAGAAGGCCGGAAGGTTGTAAAGTTCTTTTCTGTTCGAGGAATAAGTGTCGGAGGAAATGCCGACATGGTGACGGTAGGGCAGGAATAAGCACCGGC	1.0
TAGGGAATATTGCGCAATGGGGGAAACCCTGACGCAGCAACGCCGCGTGGAGGATGACACTTTTCGGAGCGTAAACTCCTTTTGTTAGGGAAGAATAATGACGGTACCTAACGAATAAGCACCGGCTAACTCCGTGCCAGCAGCCGCGGT	TAGGGAATATTGCGCAATGGGGGAAACCCTGACGCAGCAACGCCGCGTGGAGGATGACACTTTTCGGAGCGTAAACTCCTTTTGTTAGGGAAGAATAATGACGGTACCTAACGAATAAGCACCGGCTAACTCCGTGCCAGCAGCCGCGGT	1.0
TAGGGAATATTGCTCAATGGGGGAAACCCTGAAGCAGCAACGCCGCGTGGAGGATGACACTTTTCGGAGCGTAAACTCCTTTTCTTGGGAAAGAATTATGACGGTACCCAAGGAATAAGCACCGGCTAACTCCGTGCCAGCAGCCGCGGT	TAGGGAATATTGCTCAATGGGGGAAACCCTGAAGCAGCAACGCCGCGTGGAGGATGACACTTTTCGGAGCGTAAACTCCTTTTCTTGGGAAAGAATTATGACGGTACCCAAGGAATAAGCACCGGCTAACTCCGTGCCAGCAGCCGCGGT	1.0
TAGGGAATCTTCCACAATGGACGAAAGTCTGATGGAGCAACGCCGCGTGAGTGAAGAAGGGTTTCGGCTCGTAAAACTCTGTTGTTAAAGAAGAACATATCTGAGAGTAACTGTTCAGGTATTGACGGTATTTAACCAGAAAGCCACGGC	TAGGGAATCTTCCACAATGGACGAAAGTCTGATGGAGCAACGCCGCGTGAGTGAAGAAGGGTTTCGGCTCGTAAAACTCTGTTGTTAAAGAAGAACATATCTGAGAGTAACTGTTCAGGTATTGACGGTATTTAACCAGAAAGCCACGGC	1.0
TAGGGAATCTTCCACAATGGACGCAAGTCTGATGGAGCAACGCCGCGTGAGTGAAGAAGGCTTTCGGGTCGTAAAACTCTGTTGTTGGAGAAGAATGGTCGGCAGAGTAACTGTTGTCGGCGTGACGGTATCCAACCAGAAAGCCACGGC	TAGGGAATCTTCCACAATGGACGCAAGTCTGATGGAGCAACGCCGCGTGAGTGAAGAAGGCTTTCGGGTCGTAAAACTCTGTTGTTGGAGAAGAATGGTCGGCAGAGTAACTGTTGTCGGCGTGACGGTATCCAACCAGAAAGCCACGGC	1.0
TAGGGAATCTTCCACAATGGACGCAAGTCTGATGGAGCAACGCCGCGTGAGTGAAGAAGGGTTTCGGCTCGTAAAGCTCTGTTGGTAGTGAAGAAAGATAGAGGTAGTAACTGGCCTTTATTTGACGGTAATTACTTAGAAAGTCACGGC	TAGGGAATCTTCCACAATGGACGCAAGTCTGATGGAGCAACGCCGCGTGAGTGAAGAAGGGTTTCGGCTCGTAAAGCTCTGTTGGTAGTGAAGAAAGATAGAGGTAGTAACTGGCCTTTATTTGACGGTAATTACTTAGAAAGTCACGGC	1.0
TAGGGAATCTTCCACAATGGGCGCAAGCCTGATGGAGCAACACCGCGTGAGTGAAGAAGGGTTTCGGCTCGTAAAGCTCTGTTGTTAAAGAAGAACACGTATGAGAGTAACTGTTCATACGTTGACGGTATTTAACCAGAAAGTCACGGC	TAGGGAATCTTCCACAATGGGCGCAAGCCTGATGGAGCAACACCGCGTGAGTGAAGAAGGGTTTCGGCTCGTAAAGCTCTGTTGTTAAAGAAGAACACGTATGAGAGTAACTGTTCATACGTTGACGGTATTTAACCAGAAAGTCACGGC	1.0
TAGGGAATCTTCCGCAATGGGCGAAAGCCTGACGGAGCAACGCCGCGTGAGTGAAGAAGGATTTCGGTTCGTAAAGCTCTGTTGTTAGGGAAGAATGGATATGTAGTAACTATACATGTAAGAGACGGTACCTAACCAGAAAGCCACGGC	TAGGGAATCTTCCGCAATGGGCGAAAGCCTGACGGAGCAACGCCGCGTGAGTGAAGAAGGATTTCGGTTCGTAAAGCTCTGTTGTTAGGGAAGAATGGATATGTAGTAACTATACATGTAAGAGACGGTACCTAACCAGAAAGCCACGGC	1.0
TAGGGAATCTTCGGCAATGGACGAAAGTCTGACCGAGCAACGCCGCGTGAGTGAAGAAGGTTTTCGGATCGTAAAACTCTGTTGGTAGAGAAGAACGTTGGTGAGAGTGGAAAGCTCATCAAGTGACGGTAACTACCCAGAAAGGGACGG	TAGGGAATCTTCGGCAATGGACGAAAGTCTGACCGAGCAACGCCGCGTGAGTGAAGAAGGTTTTCGGATCGTAAAACTCTGTTGGTAGAGAAGAACGTTGGTGAGAGTGGAAAGCTCATCAAGTGACGGTAACTACCCAGAAAGGGACGG	1.0
TAGGGAATCTTCGGCAATGGACGAAAGTCTGACCGAGCAACGCCGCGTGAGTGAAGAAGGTTTTCGGATCGTAAAGCTCTGTTGTAAGAGAAGAACGGGTGTGAGAGTGGAAAGTTCACACTGTGACGGTATCTTACCAGAAAGGGACGG	TAGGGAATCTTCGGCAATGGACGAAAGTCTGACCGAGCAACGCCGCGTGAGTGAAGAAGGTTTTCGGATCGTAAAGCTCTGTTGTAAGAGAAGAACGGGTGTGAGAGTGGAAAGTTCACACTGTGACGGTATCTTACCAGAAAGGGACGG	1.0
TAGGGAATCTTCGGCAATGGACGAAAGTCTGACCGAGCAACGCCGCGTGAGTGAAGAAGGTTTTCGGATCGTAAAGCTCTGTTGTAAGTCAAGAACGTGTGTGAGAGTGGAAAGTTCACACAGTGACGGTAGCTTACCAGAAAGGGACGG	TAGGGAATCTTCGGCAATGGACGAAAGTCTGACCGAGCAACGCCGCGTGAGTGAAGAAGGTTTTCGGATCGTAAAGCTCTGTTGTAAGTCAAGAACGTGTGTGAGAGTGGAAAGTTCACACAGTGACGGTAGCTTACCAGAAAGGGACGG	1.0
TAGGGAATCTTCGGCAATGGGGGCAACCCTGACCGAGCAACGCCGCGTGAGTGAAGAAGGTTTTCGGATCGTAAAGCTCTGTTGTAAGTCAAGAACGAGTGTGAGAGTGGAAAATTCACACTGTGACGGTAGCTTACCAGAAAGGGACGG	TAGGGAATCTTCGGCAATGGGGGCAACCCTGACCGAGCAACGCCGCGTGAGTGAAGAAGGTTTTCGGATCGTAAAGCTCTGTTGTAAGTCAAGAACGAGTGTGAGAGTGGAAAATTCACACTGTGACGGTAGCTTACCAGAAAGGGACGG	1.0
TAGGGAATCTTCGGCAATGGGGGGAACCCTGACCGAGCAACGCCGCGTGAGTGAAGAAGGTTTTCGGATCGTAAAGCTCTGTTGTAAGAGAAGAACGGGTGTGAGAGTGGAAAGTTCACACTGTGACGGTATCTTACCAGAAAGGGACGG	TAGGGAATCTTCGGCAATGGGGGGAACCCTGACCGAGCAACGCCGCGTGAGTGAAGAAGGTTTTCGGATCGTAAAGCTCTGTTGTAAGAGAAGAACGGGTGTGAGAGTGGAAAGTTCACACTGTGACGGTATCTTACCAGAAAGGGACGG	1.0
TAGGGAATCTTCGGCAATGGGGGGAACCCTGACCGAGCAACGCCGCGTGAGTGAAGAAGGTTTTCGGATCGTAAAGCTCTGTTGTTAAGGAAGAACGAGTGTGAGAATGGAAAGTTCATACTGTGACGGTACTTAACCAGAAAGGGACGG	TAGGGAATCTTCGGCAATGGGGGGAACCCTGACCGAGCAACGCCGCGTGAGTGAAGAAGGTTTTCGGATCGTAAAGCTCTGTTGTTAAGGAAGAACGAGTGTGAGAATGGAAAGTTCATACTGTGACGGTACTTAACCAGAAAGGGACGG	1.0
TAGGGAATTTTCGGCAATGGGGGCAACCCTGACCGAGCAACGCCGCGTGAGTGAAGACGGCCTTCGGGTTGTAAAGCTCTGTTGTAAGGGAAGAACGGTAGATAGAGAATATCTAAGTGACGGTACCTTACCAGAAAGCCACGGCTAACT	TAGGGAATTTTCGGCAATGGGGGCAACCCTGACCGAGCAACGCCGCGTGAGTGAAGACGGCCTTCGGGTTGTAAAGCTCTGTTGTAAGGGAAGAACGGTAGATAGAGAATATCTAAGTGACGGTACCTTACCAGAAAGCCACGGCTAACT	1.0
TCACAGCTTCAGTGGACTGAATCTTTCCTGCCTGACGGCTCTAAAGAGAGTGGCTGATCCTCACAAGGAGGATTCTCCCAGCACAGCACACCAACTCTGCTAAGGGACAGACTGCCTCTTCGAGCGAGTCCCTGACCCCCGTGCCTCCAG	TCACAGCTTCAGTGGACTGAATCTTTCCTGCCTGACGGCTCTAAAGAGAGTGGCTGATCCTCACAAGGAGGATTCTCCCAGCACAGCACACCAACTCTGCTAAGGGACAGACTGCCTCTTCGAGCGAGTCCCTGACCCCCGTGCCTCCAG	1.0
TGAGGAATATTGGACAATGGGTGAAAGCCTGATCCAGCCATCCCGCGTGAAGGAAGACGGTTCTATGGATTGTAAACTTCTTTTATACAGGGATAAACCTACCCTCGTGAGGGTAGCTGAAGGTACTGTATGAATAAGCACCGGCTAACT	TGAGGAATATTGGACAATGGGTGAAAGCCTGATCCAGCCATCCCGCGTGAAGGAAGACGGTTCTATGGATTGTAAACTTCTTTTATACAGGGATAAACCTACCCTCGTGAGGGTAGCTGAAGGTACTGTATGAATAAGCACCGGCTAACT	1.0
TGAGGAATATTGGACAATGGGTGTAAGCCTGATCCAGCCATCCCGCGTGAAGGAAGACGGTTCTATGGATTGTAAACTTCTTTTATACAGGGATAAACCTACCCTCGTGAGGGTAGCTGAAGGTACTGTATGAATAAGCACCGGCTAACT	TGAGGAATATTGGACAATGGGTGTAAGCCTGATCCAGCCATCCCGCGTGAAGGAAGACGGTTCTATGGATTGTAAACTTCTTTTATACAGGGATAAACCTACCCTCGTGAGGGTAGCTGAAGGTACTGTATGAATAAGCACCGGCTAACT	1.0
TGAGGAATATTGGTCAATGGACGAGAGTCTGAACCAGCCAAGTAGCGTGCAGGATGACGGCCCTATGGGTTGTAAACTGCTTTTATAGGGGAATAAAGTGATCTACGTGTAGTTTATTGTATGTACCCTATGAATAAGGACCGGCTAATT	TGAGGAATATTGGTCAATGGACGAGAGTCTGAACCAGCCAAGTAGCGTGCAGGATGACGGCCCTATGGGTTGTAAACTGCTTTTATAGGGGAATAAAGTGATCTACGTGTAGTTTATTGTATGTACCCTATGAATAAGGACCGGCTAATT	1.0
TGAGGAATATTGGTCAATGGACGAGAGTCTGAACCAGCCAAGTAGCGTGCAGGATGACGGCCCTATGGGTTGTAAACTGCTTTTATGCGGGGATAAAGTGAGGGACGTGTCCCTCATTGCAGGTACCGCATGAATAAGGACCGGCTAATT	TGAGGAATATTGGTCAATGGACGAGAGTCTGAACCAGCCAAGTAGCGTGCAGGATGACGGCCCTATGGGTTGTAAACTGCTTTTATGCGGGGATAAAGTGAGGGACGTGTCCCTCATTGCAGGTACCGCATGAATAAGGACCGGCTAATT	1.0
TGAGGAATATTGGTCAATGGACGAGAGTCTGAACCAGCCAAGTAGCGTGCAGGATGACTGCCCTATGGGTTGTAAACTGCTTTTATGCGGGGATAAAGTGAGTTACGTGTAACTTATTGCAGGTACCGCATGAATAAGGACCGGCTAATT	TGAGGAATATTGGTCAATGGACGAGAGTCTGAACCAGCCAAGTAGCGTGCAGGATGACTGCCCTATGGGTTGTAAACTGCTTTTATGCGGGGATAAAGTGAGTTACGTGTAACTTATTGCAGGTACCGCATGAATAAGGACCGGCTAATT	1.0
TGAGGAATATTGGTCAATGGACGCAAGTCTGAACCAGCCAAGTAGCGTGCAGGATGACGGCCCTATGGGTTGTAAACTGCTTTTATGTGGGAATAAAGTGGCGCACGTGTGCGCCATTGCATGTACCTCATGAATAAGGACCGGCTAATT	TGAGGAATATTGGTCAATGGACGCAAGTCTGAACCAGCCAAGTAGCGTGCAGGATGACGGCCCTATGGGTTGTAAACTGCTTTTATGTGGGAATAAAGTGGCGCACGTGTGCGCCATTGCATGTACCTCATGAATAAGGACCGGCTAATT	1.0
TGAGGAATATTGGTCAATGGACGGAAGTCTGAACCAGCCAAGTAGCGTGCAGGATGACGGCCCTATGGGTTGTAAACTGCTTTTGTATGGGGATAAAGTTAGGGACGTGTCCCTATTTGCAGGTACCATATGAATAAGGACCGGCTAATT	TGAGGAATATTGGTCAATGGACGGAAGTCTGAACCAGCCAAGTAGCGTGCAGGATGACGGCCCTATGGGTTGTAAACTGCTTTTGTATGGGGATAAAGTTAGGGACGTGTCCCTATTTGCAGGTACCATATGAATAAGGACCGGCTAATT	1.0
TGAGGAATATTGGTCAATGGACGTAAGTCTGAACCAGCCAAGTAGCGTGCAGGAAGACGGCCCTATGGGTTGTAAACTGCTTTTATACGAGAATAATTTGATGCACGTGTGCGTTATTGCATGTATCGTATGAATAAGGACCGGCTAATT	TGAGGAATATTGGTCAATGGACGTAAGTCTGAACCAGCCAAGTAGCGTGCAGGAAGACGGCCCTATGGGTTGTAAACTGCTTTTATACGAGAATAATTTGATGCACGTGTGCGTTATTGCATGTATCGTATGAATAAGGACCGGCTAATT	1.0
TGAGGAATATTGGTCAATGGACGTAAGTCTGAACCAGCCAAGTAGCGTGCAGGATGACGGCCCTATGGGTTGTAAACTGCTTTTGTATGGGGATAAAGTTAGGGACGTGTCCCTATTTGCAGGTACCATACGAATAAGGACCGGCTAATT	TGAGGAATATTGGTCAATGGACGTAAGTCTGAACCAGCCAAGTAGCGTGCAGGATGACGGCCCTATGGGTTGTAAACTGCTTTTGTATGGGGATAAAGTTAGGGACGTGTCCCTATTTGCAGGTACCATACGAATAAGGACCGGCTAATT	1.0
TGAGGAATATTGGTCAATGGGCGAGAGCCTGAACCAGCCAAGTAGCGTGCAGGAAGACGGCCCTATGGGTTGTAAACTGCTTTTATAGGGGAATAAAGTGATCTACGTGTAGTTTATTGTATGTACCCTATGAATAAGGACCGGCTAATT	TGAGGAATATTGGTCAATGGGCGAGAGCCTGAACCAGCCAAGTAGCGTGCAGGAAGACGGCCCTATGGGTTGTAAACTGCTTTTATAGGGGAATAAAGTGATCTACGTGTAGTTTATTGTATGTACCCTATGAATAAGGACCGGCTAATT	1.0
TGAGGAATATTGGTCAATGGGCGAGAGCCTGAACCAGCCAAGTAGCGTGCAGGAAGACGGCCCTATGGGTTGTAAACTGCTTTTATAGGGGAATAAAGTGGACTACGTGTAGTTTATTGTATGTACCCTATGAATAAGGACCGGCTAATT	TGAGGAATATTGGTCAATGGGCGAGAGCCTGAACCAGCCAAGTAGCGTGCAGGAAGACGGCCCTATGGGTTGTAAACTGCTTTTATAGGGGAATAAAGTGGACTACGTGTAGTTTATTGTATGTACCCTATGAATAAGGACCGGCTAATT	1.0
TGAGGAATATTGGTCAATGGGCGAGAGCCTGAACCAGCCAAGTAGCGTGCAGGAAGACGGCCCTATGGGTTGTAAACTGCTTTTATGTGGGGATAAAGTGAGCTACGTGTAGTTTATTGCAGGTACCACATGAATAAGGACCGGCTAATT	TGAGGAATATTGGTCAATGGGCGAGAGCCTGAACCAGCCAAGTAGCGTGCAGGAAGACGGCCCTATGGGTTGTAAACTGCTTTTATGTGGGGATAAAGTGAGCTACGTGTAGTTTATTGCAGGTACCACATGAATAAGGACCGGCTAATT	1.0
TGAGGAATATTGGTCAATGGGCGAGAGCCTGAACCAGCCAAGTAGCGTGCAGGACGACGGCCCTATGGGTTGTAAACTGCTTTTATACGGGGATAAAGTGGCGAACGTGTTTGCTATTGCAGGTACCGTATGAATAAGGACCGGCTAATT	TGAGGAATATTGGTCAATGGGCGAGAGCCTGAACCAGCCAAGTAGCGTGCAGGACGACGGCCCTATGGGTTGTAAACTGCTTTTATACGGGGATAAAGTGGCGAACGTGTTTGCTATTGCAGGTACCGTATGAATAAGGACCGGCTAATT	1.0
TGAGGAATATTGGTCAATGGGCGAGAGCCTGAACCAGCCAAGTAGCGTGCAGGATGACGGCCCTATGGGTTGTAAACTGCTTTTATACGGGGATAAAGTAGCGAACGTGTTTGCTATTGCAGGTACCGTATGAATAAGGACCGGCTAATT	TGAGGAATATTGGTCAATGGGCGAGAGCCTGAACCAGCCAAGTAGCGTGCAGGATGACGGCCCTATGGGTTGTAAACTGCTTTTATACGGGGATAAAGTAGCGAACGTGTTTGCTATTGCAGGTACCGTATGAATAAGGACCGGCTAATT	1.0
TGAGGAATATTGGTCAATGGGCGAGAGCCTGAACCAGCCAAGTAGCGTGCAGGATGACGGCCCTATGGGTTGTAAACTGCTTTTATACGGGGATAAAGTGGCGAACGTGTTTGCTATTGCAGGTACCGTATGAATAAGGACCGGCTAATT	TGAGGAATATTGGTCAATGGGCGAGAGCCTGAACCAGCCAAGTAGCGTGCAGGATGACGGCCCTATGGGTTGTAAACTGCTTTTATACGGGGATAAAGTGGCGAACGTGTTTGCTATTGCAGGTACCGTATGAATAAGGACCGGCTAATT	1.0
TGAGGAATATTGGTCAATGGGCGAGAGCCTGAACCAGCCAAGTAGCGTGCAGGATGACGGCCCTATGGGTTGTAAACTGCTTTTATGCGGGGATAAAGTGAGGGACGTGTCCTTCATTGCAGGTACCGCATGAATAAGGACCGGCTAATT	TGAGGAATATTGGTCAATGGGCGAGAGCCTGAACCAGCCAAGTAGCGTGCAGGATGACGGCCCTATGGGTTGTAAACTGCTTTTATGCGGGGATAAAGTGAGGGACGTGTCCTTCATTGCAGGTACCGCATGAATAAGGACCGGCTAATT	1.0
TGAGGAATATTGGTCAATGGGCGAGAGCCTGAACCAGCCAAGTCGCGTGAAGGATGACGGCCCTATGGGTTGTAAACTTCTTTTGCAGGGGAATAAAGATATTCACGTGTGGGTAGTTGTATGTACCCTGCGAATAAGCATCGGCTAACT	TGAGGAATATTGGTCAATGGGCGAGAGCCTGAACCAGCCAAGTCGCGTGAAGGATGACGGCCCTATGGGTTGTAAACTTCTTTTGCAGGGGAATAAAGATATTCACGTGTGGGTAGTTGTATGTACCCTGCGAATAAGCATCGGCTAACT	1.0
TGAGGAATATTGGTCAATGGGCGCAAGCCTGAACCAGCCAAGTAGCGTGCAGGATGACGGCCCTATGGGTTGTAAACTGCTTTTTAAGGTGAATAAAGAGGGGCACGTGTGCCCTGTTGCATGTAGCCTTGGAATAAGGACCGGCTAATT	TGAGGAATATTGGTCAATGGGCGCAAGCCTGAACCAGCCAAGTAGCGTGCAGGATGACGGCCCTATGGGTTGTAAACTGCTTTTTAAGGTGAATAAAGAGGGGCACGTGTGCCCTGTTGCATGTAGCCTTGGAATAAGGACCGGCTAATT	1.0
TGAGGAATATTGGTCAATGGGCGCAAGCCTGAACCAGCCATGTAGCGTGAAGGATGACAGTTTTTTTGATTGTAAACTTCTTTTCTGTGCGATTAAAGTGTGGCATTTATGCCATATTGCAGTTATCTCAGGAATAAGCATCGGCTAACT	TGAGGAATATTGGTCAATGGGCGCAAGCCTGAACCAGCCATGTAGCGTGAAGGATGACAGTTTTTTTGATTGTAAACTTCTTTTCTGTGCGATTAAAGTGTGGCATTTATGCCATATTGCAGTTATCTCAGGAATAAGCATCGGCTAACT	1.0
TGAGGAATATTGGTCAATGGGCGCAAGCCTGAACCAGTCAAGTAGCGTGCAGGAAGACGGCCCTATGGGTTGTAAACTGCTTTTATACGAGAATAATTTGATGCACGTGTGCGTTATTGCATGTATCGTATGAATAAGGACCGGCTAATT	TGAGGAATATTGGTCAATGGGCGCAAGCCTGAACCAGTCAAGTAGCGTGCAGGAAGACGGCCCTATGGGTTGTAAACTGCTTTTATACGAGAATAATTTGATGCACGTGTGCGTTATTGCATGTATCGTATGAATAAGGACCGGCTAATT	1.0
TGAGGAATATTGGTCAATGGGCGCGAGCCTGAACCAGCCAAGTAGCGTGCAGGATGACGGCCCTATGGGTTGTAAACTGCTTTTATGTGGGGATAAAGTGAGCTACGTGTAGTTTATTGCAGGTACCACATGAATAAGGACCGGCTAATT	TGAGGAATATTGGTCAATGGGCGCGAGCCTGAACCAGCCAAGTAGCGTGCAGGATGACGGCCCTATGGGTTGTAAACTGCTTTTATGTGGGGATAAAGTGAGCTACGTGTAGTTTATTGCAGGTACCACATGAATAAGGACCGGCTAATT	1.0
TGAGGAATATTGGTCAATGGGCGGAAGCCTGAACCAGCCAAGTAGCGTGCAGGAGGACGGCCCTACGGGTTGTAAACTGCTTTTATGCGGGGATAAAGTGAGGGACGTGTCCCTTTTTGCAGGTACCGCATGAATAAGGACCGGCTAATT	TGAGGAATATTGGTCAATGGGCGGAAGCCTGAACCAGCCAAGTAGCGTGCAGGAGGACGGCCCTACGGGTTGTAAACTGCTTTTATGCGGGGATAAAGTGAGGGACGTGTCCCTTTTTGCAGGTACCGCATGAATAAGGACCGGCTAATT	1.0
TGAGGAATATTGGTCAATGGGCGGAAGCCTGAACCAGCCAAGTAGCGTGCAGGAGGACGGCCCTATGGGTTGTAAACTGCTTTTATGCGGGGATAAAGTGAGGGACGCGTCCCTTTTTGCAGGTACCGCATGAATAAGGACCGGCTAATT	TGAGGAATATTGGTCAATGGGCGGAAGCCTGAACCAGCCAAGTAGCGTGCAGGAGGACGGCCCTATGGGTTGTAAACTGCTTTTATGCGGGGATAAAGTGAGGGACGCGTCCCTTTTTGCAGGTACCGCATGAATAAGGACCGGCTAATT	1.0
TGAGGAATATTGGTCAATGGGCGGAAGCCTGAACCAGCCAAGTAGCGTGCAGGATGACGGCCCTACGGGTTGTAAACTGCTTTTATGCGGGGATAAAGTGAGGGACGCGTCCCTTTTTGCAGGTACCGCATGAATAAGGACCGGCTAATT	TGAGGAATATTGGTCAATGGGCGGAAGCCTGAACCAGCCAAGTAGCGTGCAGGATGACGGCCCTACGGGTTGTAAACTGCTTTTATGCGGGGATAAAGTGAGGGACGCGTCCCTTTTTGCAGGTACCGCATGAATAAGGACCGGCTAATT	1.0
TGAGGAATATTGGTCAATGGGCGGAAGCCTGAACCAGCCAAGTAGCGTGCAGGATGACGGCCCTATGGGTTGTAAACTGCTTTTATGCGGGGATAAAGGAGCCCACGTGTGGGCTTTTGCAGGTACCGCATGAATAAGGACCGGCTAATT	TGAGGAATATTGGTCAATGGGCGGAAGCCTGAACCAGCCAAGTAGCGTGCAGGATGACGGCCCTATGGGTTGTAAACTGCTTTTATGCGGGGATAAAGGAGCCCACGTGTGGGCTTTTGCAGGTACCGCATGAATAAGGACCGGCTAATT	1.0
TGAGGAATATTGGTCAATGGGCGGAAGCCTGAACCAGCCAAGTCGCGTGAAGGAAGACGGTTCTATGGATTGTAAACTTCTTTTGTAGAGGAATAATGGCAGCTACGCGTAGCTGAGATGCATGTACTCTACGAATAAGTATCGGCTAAC	TGAGGAATATTGGTCAATGGGCGGAAGCCTGAACCAGCCAAGTCGCGTGAAGGAAGACGGTTCTATGGATTGTAAACTTCTTTTGTAGAGGAATAATGGCAGCTACGCGTAGCTGAGATGCATGTACTCTACGAATAAGTATCGGCTAAC	1.0
TGAGGAATATTGGTCAATGGGCGTAAGCCTGAACCAGCCAAGTAGCGTGCAGGATGACGGCCCTATGGGTTGTAAACTGCTTTTATGCGGGGATAAAGTTGGGGACGTGTCCCTTTTTGCAGGTACCGCATGAATAAGGACCGGCTAATT	TGAGGAATATTGGTCAATGGGCGTAAGCCTGAACCAGCCAAGTAGCGTGCAGGATGACGGCCCTATGGGTTGTAAACTGCTTTTATGCGGGGATAAAGTTGGGGACGTGTCCCTTTTTGCAGGTACCGCATGAATAAGGACCGGCTAATT	1.0
TGAGGAATATTGGTCAATGGTCGAAAGACTGAACCAGCCATGCCGCGTGCAGGACAGACGGCCCTAGAGGTTGTAAACTGCTTTTATATGGGAAGAATAAGGAGCACGTGTGCTTTGATGACGGTACCATATGAATAAGCATCGGCTAAC	TGAGGAATATTGGTCAATGGTCGAAAGACTGAACCAGCCATGCCGCGTGCAGGACAGACGGCCCTAGAGGTTGTAAACTGCTTTTATATGGGAAGAATAAGGAGCACGTGTGCTTTGATGACGGTACCATATGAATAAGCATCGGCTAAC	1.0
TGAGGAATATTGGTCAATGGTCGGAAGACTGAACCAGCCATGCCGCGTGCAGGAAGAATGCCTTATGGGTTGTAAACTGCTTTTATATGGGAAGAATAAGGAGTACGTGTACTTTGATGACGGTACCATATGAATAAGCATCGGCTAACT	TGAGGAATATTGGTCAATGGTCGGAAGACTGAACCAGCCATGCCGCGTGCAGGAAGAATGCCTTATGGGTTGTAAACTGCTTTTATATGGGAAGAATAAGGAGTACGTGTACTTTGATGACGGTACCATATGAATAAGCATCGGCTAACT	1.0
TGAGGAATATTGGTCAATGGTCGGAAGACTGAACCAGCCATGCCGCGTGCAGGAAGAATGCCTTATGGGTTGTAAACTGCTTTTATATGGGAAGAATAAGGCGTACGTGTACGTTGATGACGGTACCATATGAATAAGCATCGGCTAACT	TGAGGAATATTGGTCAATGGTCGGAAGACTGAACCAGCCATGCCGCGTGCAGGAAGAATGCCTTATGGGTTGTAAACTGCTTTTATATGGGAAGAATAAGGCGTACGTGTACGTTGATGACGGTACCATATGAATAAGCATCGGCTAACT	1.0
TGAGGAATATTGGTCAATGGTCGGAAGACTGAACCAGCCATGCCGCGTGCAGGAAGAATGCCTTATGGGTTGTAAACTGCTTTTATATGGGAAGAATAAGGTGTACGTGTACATTGATGACGGTACCATATGAATAAGCATCGGCTAACT	TGAGGAATATTGGTCAATGGTCGGAAGACTGAACCAGCCATGCCGCGTGCAGGAAGAATGCCTTATGGGTTGTAAACTGCTTTTATATGGGAAGAATAAGGTGTACGTGTACATTGATGACGGTACCATATGAATAAGCATCGGCTAACT	1.0
TGAGGAATATTTCACAATGAGCGAAAGCTTGATGGAGCAATGCCGCGTGCAGGATGAAGGCCCTCGGGTTGTAAACTGCTTTTATAAGAGAAGATTATGACGGTAACTTATGAATAAGGGACGGCTAACTACGTGCCAGCAGCCGCGGTC	TGAGGAATATTTCACAATGAGCGAAAGCTTGATGGAGCAATGCCGCGTGCAGGATGAAGGCCCTCGGGTTGTAAACTGCTTTTATAAGAGAAGATTATGACGGTAACTTATGAATAAGGGACGGCTAACTACGTGCCAGCAGCCGCGGTC	1.0
TGAGGAATCTTCCACAATGGGCGAAAGCCTGATGGAGCAACGCCGCGTGCAGGATGAAGGCCTTCGGGTTGTAAACTGCTTTTATAAGTGAGGAATATGACGGTAGCTTATGAATAAGGATCGGCTAACTACGTGCCAGCAGCCGCGGTC	TGAGGAATCTTCCACAATGGGCGAAAGCCTGATGGAGCAACGCCGCGTGCAGGATGAAGGCCTTCGGGTTGTAAACTGCTTTTATAAGTGAGGAATATGACGGTAGCTTATGAATAAGGATCGGCTAACTACGTGCCAGCAGCCGCGGTC	1.0
TGATAAACCTTTAGCAATAAACGAAAGTTTAACTGAGCTATACTAACTTTAGGGTTGGTTAATTTCATGCCAGCCACCACGGTCATACGATGAACCCAAGCTAATAGAGACTGGCGTAAAGAATGTTTTACATTATCCCTCAATAAAGCT	TGATAAACCTTTAGCAATAAACGAAAGTTTAACTGAGCTATACTAACTTTAGGGTTGGTTAATTTCATGCCAGCCACCACGGTCATACGATGAACCCAAGCTAATAGAGACTGGCGTAAAGAATGTTTTACATTATCCCTCAATAAAGCT	1.0
TGGGGAATATTGCACAATGGAGGGAACTCTGATGCAGCGACGCCGCGTGAGTGAAGAAGTATTTCGGTATGTAAAGCTCTATCAGTAGGGAAGATAATGACGGTACCTACATAAGAAGCCCCGGCTAAATACGTGCCAGCAGCCGCGGTA	TGGGGAATATTGCACAATGGAGGGAACTCTGATGCAGCGACGCCGCGTGAGTGAAGAAGTATTTCGGTATGTAAAGCTCTATCAGTAGGGAAGATAATGACGGTACCTACATAAGAAGCCCCGGCTAAATACGTGCCAGCAGCCGCGGTA	1.0
TGGGGAATATTGCACAATGGGCGAAAGCCTGATGCAGCGACGCCGCGTGAGGGATGGAGGCCTTCGGGTTGTAAACCTCTTTCGCTCATGGTCAAGCCGCAACATTGGTTGTGGTGAGGGTAGTGGGTAAAGAAGCGCCGGCTAACTACG	TGGGGAATATTGCACAATGGGCGAAAGCCTGATGCAGCGACGCCGCGTGAGGGATGGAGGCCTTCGGGTTGTAAACCTCTTTCGCTCATGGTCAAGCCGCAACATTGGTTGTGGTGAGGGTAGTGGGTAAAGAAGCGCCGGCTAACTACG	1.0
TGGGGAATATTGCACAATGGGCGAAAGCCTGATGCAGCGACGCCGCGTGAGGGATGGAGGCCTTCGGGTTGTAAACCTCTTTCGCTCATGGTCAAGCCGCAACTCAAGGTTGTGGTGAGGGTAGTGGGTAAAGAAGCACCGGCTAACTAC	TGGGGAATATTGCACAATGGGCGAAAGCCTGATGCAGCGACGCCGCGTGAGGGATGGAGGCCTTCGGGTTGTAAACCTCTTTCGCTCATGGTCAAGCCGCAACTCAAGGTTGTGGTGAGGGTAGTGGGTAAAGAAGCACCGGCTAACTAC	1.0
TGGGGAATATTGCACAATGGGCGAAAGCCTGATGCAGCGACGCCGCGTGAGGGATGGAGGCCTTCGGGTTGTAAACCTCTTTCGCTCATGGTCAAGCCGCAACTTGGGTTGTGGTGAGGGTAGTGGGTAAAGAAGCACCGGCTAACTACG	TGGGGAATATTGCACAATGGGCGAAAGCCTGATGCAGCGACGCCGCGTGAGGGATGGAGGCCTTCGGGTTGTAAACCTCTTTCGCTCATGGTCAAGCCGCAACTTGGGTTGTGGTGAGGGTAGTGGGTAAAGAAGCACCGGCTAACTACG	1.0
TGGGGAATATTGCACAATGGGCGAAAGCCTGATGCAGCGACGCCGCGTGAGTGAGGAAGTATTTCGGTATGTAAAGCTCTATCAGCAGGGAAGAAAGAAATGACGGTACCTGAGTAAGAAGCTCCGGCTAAATACGTGCCAGCAGCCGCG	TGGGGAATATTGCACAATGGGCGAAAGCCTGATGCAGCGACGCCGCGTGAGTGAGGAAGTATTTCGGTATGTAAAGCTCTATCAGCAGGGAAGAAAGAAATGACGGTACCTGAGTAAGAAGCTCCGGCTAAATACGTGCCAGCAGCCGCG	1.0
TGGGGAATATTGCACAATGGGCGCAAGCCTGATGCAGCGACGCCGCGTGAGGGATGAAGGCCTTCGGGTTGTAAACCTCTTTCGCCAGTGAAGCAGGCCAGGCCTTATTGGCTTGGTTGACGGTAGCTGGATAAGAAGCGCCGGCTAACT	TGGGGAATATTGCACAATGGGCGCAAGCCTGATGCAGCGACGCCGCGTGAGGGATGAAGGCCTTCGGGTTGTAAACCTCTTTCGCCAGTGAAGCAGGCCAGGCCTTATTGGCTTGGTTGACGGTAGCTGGATAAGAAGCGCCGGCTAACT	1.0
TGGGGAATATTGCACAATGGGCGCAAGCCTGATGCAGCGACGCCGCGTGAGGGATGAAGGCCTTCGGGTTGTAAACCTCTTTCGCCAGTGAAGCAGGCCAGGTCTTATTGGCTTGGTTGACGGTAGCTGGATAAGAAGCGCCGGCTAACT	TGGGGAATATTGCACAATGGGCGCAAGCCTGATGCAGCGACGCCGCGTGAGGGATGAAGGCCTTCGGGTTGTAAACCTCTTTCGCCAGTGAAGCAGGCCAGGTCTTATTGGCTTGGTTGACGGTAGCTGGATAAGAAGCGCCGGCTAACT	1.0
TGGGGAATATTGCACAATGGGCGCAAGCCTGATGCAGCGACGCCGCGTGAGGGATGACGGCCTTCGGGTTGTAAACCTCTGTTAGCATCGAAGAAGCGAAAGTGACGGTAGGTGCAGAGAAAGCGCCGGCTAACTACGTGCCAGCAGCCG	TGGGGAATATTGCACAATGGGCGCAAGCCTGATGCAGCGACGCCGCGTGAGGGATGACGGCCTTCGGGTTGTAAACCTCTGTTAGCATCGAAGAAGCGAAAGTGACGGTAGGTGCAGAGAAAGCGCCGGCTAACTACGTGCCAGCAGCCG	1.0
TGGGGAATATTGCACAATGGGCGCAAGCCTGATGCAGCGACGCCGCGTGAGGGATGGAGGCCTTCGGGTTGTAAACCTCTTTCGCCAGTGAAGCAGGCCTGTCCCTTGTGGGTGGGTTGACGGTAGCTGGATAAGAAGCGCCGGCTAACT	TGGGGAATATTGCACAATGGGCGCAAGCCTGATGCAGCGACGCCGCGTGAGGGATGGAGGCCTTCGGGTTGTAAACCTCTTTCGCCAGTGAAGCAGGCCTGTCCCTTGTGGGTGGGTTGACGGTAGCTGGATAAGAAGCGCCGGCTAACT	1.0
TGGGGAATATTGCACAATGGGCGCAAGCCTGATGCAGCGACGCCGCGTGAGGGATGGAGGCCTTCGGGTTGTGAACCTCTTTCGCCAGTGAAGCAGGCCTGCCCCTGGTGGGTGGGTTGACGGTAGCTGGATAAGAAGCGCCGGCTAACT	TGGGGAATATTGCACAATGGGCGCAAGCCTGATGCAGCGACGCCGCGTGAGGGATGGAGGCCTTCGGGTTGTGAACCTCTTTCGCCAGTGAAGCAGGCCTGCCCCTGGTGGGTGGGTTGACGGTAGCTGGATAAGAAGCGCCGGCTAACT	1.0
TGGGGAATATTGCACAATGGGCGCAAGCCTGATGCAGCGACGCCGCGTGAGGGATGGAGGCCTTCGGGTTGTGAACCTCTTTCGCCAGTGAAGCAGGCCTGCCTCGTTTGTGGGTGGGTTGACGGTAGCTGGATAAGAAGCGCCGGCTAA	TGGGGAATATTGCACAATGGGCGCAAGCCTGATGCAGCGACGCCGCGTGAGGGATGGAGGCCTTCGGGTTGTGAACCTCTTTCGCCAGTGAAGCAGGCCTGCCTCGTTTGTGGGTGGGTTGACGGTAGCTGGATAAGAAGCGCCGGCTAA	1.0
TGGGGAATATTGCACAATGGGCGCAAGCCTGATGCAGCGACGCCGCGTGAGGGATGGAGGCCTTCGGGTTGTGAACCTCTTTCGCCAGTGAAGCAGGCCTGCCTCTTTTGTGGGTGGGTTGACGGTAGCTGGATAAGAAGCGCCGGCTAA	TGGGGAATATTGCACAATGGGCGCAAGCCTGATGCAGCGACGCCGCGTGAGGGATGGAGGCCTTCGGGTTGTGAACCTCTTTCGCCAGTGAAGCAGGCCTGCCTCTTTTGTGGGTGGGTTGACGGTAGCTGGATAAGAAGCGCCGGCTAA	1.0
TGGGGAATATTGCACAATGGGCGCAAGCCTGATGCAGCGACGCCGCGTGAGGGATGGAGGCCTTCGGGTTGTGAACCTCTTTCGCCCGTGGTCAAGCCGCGACGTGGGTCGTGGTGAGGGTAGTGGGTAAAGAAGCGCCGGCTAACTACG	TGGGGAATATTGCACAATGGGCGCAAGCCTGATGCAGCGACGCCGCGTGAGGGATGGAGGCCTTCGGGTTGTGAACCTCTTTCGCCCGTGGTCAAGCCGCGACGTGGGTCGTGGTGAGGGTAGTGGGTAAAGAAGCGCCGGCTAACTACG	1.0
TGGGGAATATTGCACAATGGGCGCAAGCCTGATGCAGCGACGCCGCGTGAGGGATGGAGGCCTTCGGGTTGTGAACCTCTTTCGCTCATGGTCAAGCCGCAACAATGGTTGTGGTGAGGGTAGTGGGTAAAGAAGCGCCGGCTAACTACG	TGGGGAATATTGCACAATGGGCGCAAGCCTGATGCAGCGACGCCGCGTGAGGGATGGAGGCCTTCGGGTTGTGAACCTCTTTCGCTCATGGTCAAGCCGCAACAATGGTTGTGGTGAGGGTAGTGGGTAAAGAAGCGCCGGCTAACTACG	1.0
TGGGGAATATTGCACAATGGGCGCAAGCCTGATGCAGCGACGCCGCGTGAGGGATGGAGGCCTTCGGGTTGTGAACCTCTTTCGCTCATGGTCAAGCCGCAACTGTGGGTTGTGGTGAGGGTAGTGGGTAAAGAAGCGCCGGCTAACTAC	TGGGGAATATTGCACAATGGGCGCAAGCCTGATGCAGCGACGCCGCGTGAGGGATGGAGGCCTTCGGGTTGTGAACCTCTTTCGCTCATGGTCAAGCCGCAACTGTGGGTTGTGGTGAGGGTAGTGGGTAAAGAAGCGCCGGCTAACTAC	1.0
TGGGGAATATTGCACAATGGGCGCAAGCCTGATGCAGCGACGCCGCGTGCGGGATGGAGGCCTTCGGGTTGTAAACCGCTTTTGATCGGGAGCAAGCCCTTCGGGGTGAGTGTACCCTTCGAATAAGCACCGGCTAACTACGTGCCAGCA	TGGGGAATATTGCACAATGGGCGCAAGCCTGATGCAGCGACGCCGCGTGCGGGATGGAGGCCTTCGGGTTGTAAACCGCTTTTGATCGGGAGCAAGCCCTTCGGGGTGAGTGTACCCTTCGAATAAGCACCGGCTAACTACGTGCCAGCA	1.0
TGGGGAATATTGCACAATGGGCGCAAGCCTGATGCAGCGACGCCGCGTGCGGGATGGAGGCCTTCGGGTTGTAAACCGCTTTTGATCGGGAGCAAGCCCTTCGGGGTGAGTGTACCTTTCGAATAAGCACCGGCTAACTACGTGCCAGCA	TGGGGAATATTGCACAATGGGCGCAAGCCTGATGCAGCGACGCCGCGTGCGGGATGGAGGCCTTCGGGTTGTAAACCGCTTTTGATCGGGAGCAAGCCCTTCGGGGTGAGTGTACCTTTCGAATAAGCACCGGCTAACTACGTGCCAGCA	1.0
TGGGGAATATTGCACAATGGGGGAAACCCTGATGCAGCGACGCCGCGTGAGTGAAGAAGTATTTCGGTATGTAAAGCTCTATCAGCAGGGAAGAAAATGACGGTACCTGAGTAAGAAGCCCCGGCTAACTACGTGCCAGCAGCCGCGGTA	TGGGGAATATTGCACAATGGGGGAAACCCTGATGCAGCGACGCCGCGTGAGTGAAGAAGTATTTCGGTATGTAAAGCTCTATCAGCAGGGAAGAAAATGACGGTACCTGAGTAAGAAGCCCCGGCTAACTACGTGCCAGCAGCCGCGGTA	1.0
TGGGGAATATTGCACAATGGGGGGAACCCTGATGCAGCGACGCCGCGTGCGGGATGGAGGCCTTCGGGTCGTGAACCGCTTTTACAGGGGAGCAAGCTTTCGGGTGAGTTAACTTTGTGAATAAGCACCGGCTAACTACGTGCCAGCAGC	TGGGGAATATTGCACAATGGGGGGAACCCTGATGCAGCGACGCCGCGTGCGGGATGGAGGCCTTCGGGTCGTGAACCGCTTTTACAGGGGAGCAAGCTTTCGGGTGAGTTAACTTTGTGAATAAGCACCGGCTAACTACGTGCCAGCAGC	1.0
TGGGGAATATTGCGCAATGGGCGAAAGCCTGACGCAGCGACGCCGCGTGCGGGAAGGAGGCCTTCGGGTCGTAAACCGCTTTCAGCAGGGAAGAAGCCTGACGGTACCTGCAGAAGAAGCCCCGGCTAACTACGTGCCAGCAGCCGCGGT	TGGGGAATATTGCGCAATGGGCGAAAGCCTGACGCAGCGACGCCGCGTGCGGGAAGGAGGCCTTCGGGTCGTAAACCGCTTTCAGCAGGGAAGAAGCCTGACGGTACCTGCAGAAGAAGCCCCGGCTAACTACGTGCCAGCAGCCGCGGT	1.0
TGGGGAATATTGCGCAATGGGGGCAACCCTGACGCAGCCATGCCACGTGAATGAAGAAGGCCTTCGGGTTGTAAAGTTCTTTCGGTGACGAGGAAGGCGTGATGTTTAATAGGCATCACGATTGACGTTAATCACAGAAGAAGCACCGGC	TGGGGAATATTGCGCAATGGGGGCAACCCTGACGCAGCCATGCCACGTGAATGAAGAAGGCCTTCGGGTTGTAAAGTTCTTTCGGTGACGAGGAAGGCGTGATGTTTAATAGGCATCACGATTGACGTTAATCACAGAAGAAGCACCGGC	1.0
TGGGGAATATTGCGCAATGGGGGCAACCCTGACGCAGCCATGCCGCGTGAATGAAGAAGGCCTTCGGGTTGTAAAGTTCTTTCGGTAGCGAGGAAGGCATTTAGTTTAATAAACTGGATGATTGACGTTAACTACAGAAGAAGCACCGGC	TGGGGAATATTGCGCAATGGGGGCAACCCTGACGCAGCCATGCCGCGTGAATGAAGAAGGCCTTCGGGTTGTAAAGTTCTTTCGGTAGCGAGGAAGGCATTTAGTTTAATAAACTGGATGATTGACGTTAACTACAGAAGAAGCACCGGC	1.0
TGGGGAATATTGCGCAATGGGGGGAACCCTGACGCAGCCATGCCGCGTGAATGAAGAAGGCCTTCGGGTTGTAAAGTTCTTTCGGTATTGAGGAAGGTTGGTGTGTTAATAGCGCATCAAATTGACGTTAAATACAGAAGAAGCACCGGC	TGGGGAATATTGCGCAATGGGGGGAACCCTGACGCAGCCATGCCGCGTGAATGAAGAAGGCCTTCGGGTTGTAAAGTTCTTTCGGTATTGAGGAAGGTTGGTGTGTTAATAGCGCATCAAATTGACGTTAAATACAGAAGAAGCACCGGC	1.0
TGGGGAATATTGGACAATGGACCAAGAGTCTGATCCAGCAATTCTGTGTGCACGATGAAGTTTTTCGGAATGTAAAGTGCTTTCAGTTGGGAAGAAAAAAATGACGGTACCAACAGAAGAAGTGACGGCTAAATACGTGCCAGCAGCCGC	TGGGGAATATTGGACAATGGACCAAGAGTCTGATCCAGCAATTCTGTGTGCACGATGAAGTTTTTCGGAATGTAAAGTGCTTTCAGTTGGGAAGAAAAAAATGACGGTACCAACAGAAGAAGTGACGGCTAAATACGTGCCAGCAGCCGC	1.0
TGGGGAATATTGGACAATGGACCAAGAGTCTGATCCAGCAATTCTGTGTGCACGATGAAGTTTTTCGGAATGTAAAGTGCTTTCAGTTGGGAAGAAACAAATGACGGTACCAACAGAAGAAGTGACGGCTAAATACGTGCCAGCAGCCGC	TGGGGAATATTGGACAATGGACCAAGAGTCTGATCCAGCAATTCTGTGTGCACGATGAAGTTTTTCGGAATGTAAAGTGCTTTCAGTTGGGAAGAAACAAATGACGGTACCAACAGAAGAAGTGACGGCTAAATACGTGCCAGCAGCCGC	1.0
TGGGGAATATTGGACAATGGACCGAGAGTCTGATCCAGCAATTCTGTGTGCACGATGAAGTTTTTCGGAATGTAAAGTGCTTTCAGTTGGGAAGAAATAAATGACGGTACCAACAGAAGAAGTGACGGCTAAATACGTGCCAGCAGCCGC	TGGGGAATATTGGACAATGGACCGAGAGTCTGATCCAGCAATTCTGTGTGCACGATGAAGTTTTTCGGAATGTAAAGTGCTTTCAGTTGGGAAGAAATAAATGACGGTACCAACAGAAGAAGTGACGGCTAAATACGTGCCAGCAGCCGC	1.0
TGGGGAATATTGGACAATGGAGGAGACTCTGATCCAGCAATTCTGTGTGCACGAAGACGGTTTTCGGATTGTAAAGTGCTTTCAGCAGGGAAGAAGAAATTGACGGTACCTGCAGAAGAAGCGACGGCTAAATACGTGCCAGCAGCCGCG	TGGGGAATATTGGACAATGGAGGAGACTCTGATCCAGCAATTCTGTGTGCACGAAGACGGTTTTCGGATTGTAAAGTGCTTTCAGCAGGGAAGAAGAAATTGACGGTACCTGCAGAAGAAGCGACGGCTAAATACGTGCCAGCAGCCGCG	1.0
TGGGGAATATTGGACAATGGAGGGAACTCTGATCCAGCAATTCTGTGTGCATGAAGAAGGTTTTCGGATTGTAAAGTGCTTTCAGCAGGGAAGAAGAAAGTGACGGTACCTGCAGAAGAAGCGACGGCTAAATACGTGCCAGCAGCCGCG	TGGGGAATATTGGACAATGGAGGGAACTCTGATCCAGCAATTCTGTGTGCATGAAGAAGGTTTTCGGATTGTAAAGTGCTTTCAGCAGGGAAGAAGAAAGTGACGGTACCTGCAGAAGAAGCGACGGCTAAATACGTGCCAGCAGCCGCG	1.0
TGGGGAATATTGGACAATGGAGGTAACTCTGATCCAGCAATTCTGTGTGCATGAAGAAGGTTTTCGGATTGTAAAGTGCTTTCAGCAGGGAAGAAGAAAGTGACGGTACCTGCAGAAGAAGCGACGGCTAAATACGTGCCAGCAGCCGCG	TGGGGAATATTGGACAATGGAGGTAACTCTGATCCAGCAATTCTGTGTGCATGAAGAAGGTTTTCGGATTGTAAAGTGCTTTCAGCAGGGAAGAAGAAAGTGACGGTACCTGCAGAAGAAGCGACGGCTAAATACGTGCCAGCAGCCGCG	1.0
TGGGGAATATTGGACAATGGAGGTAACTCTGATCCAGCAATTCTGTGTGCATGAAGAAGGTTTTCGGATTGTAAAGTGCTTTCAGCAGGGAAGAAGAAGATGACGGTACCTGCAGAAGAAGCGACGGCTAAATACGTGCCAGCAGCCGCG	TGGGGAATATTGGACAATGGAGGTAACTCTGATCCAGCAATTCTGTGTGCATGAAGAAGGTTTTCGGATTGTAAAGTGCTTTCAGCAGGGAAGAAGAAGATGACGGTACCTGCAGAAGAAGCGACGGCTAAATACGTGCCAGCAGCCGCG	1.0
TGGGGAATATTGGACAATGGGGGCAACCCTGATCCAGCAATGCCGCGTGTGTGAAGAAGGCCTTCGGGTTGTAAAGCACTTTCAGTAGGGAGGAAAGGTGCGTAGCTAATACCTACGCAATTGACGTTACCTACAGAAGAAGCACCGGCT	TGGGGAATATTGGACAATGGGGGCAACCCTGATCCAGCAATGCCGCGTGTGTGAAGAAGGCCTTCGGGTTGTAAAGCACTTTCAGTAGGGAGGAAAGGTGCGTAGCTAATACCTACGCAATTGACGTTACCTACAGAAGAAGCACCGGCT	1.0
TGGGGAATATTGGACAATGGGGGCAACCCTGATCCAGCAATGCCGCGTGTGTGAAGAAGGCCTTCGGGTTGTAAAGCACTTTCAGTAGGGAGGAAAGGTGCGTAGCTAATACCTGCGCAATTGACGTTACCTACAGAAGAAGCACCGGCT	TGGGGAATATTGGACAATGGGGGCAACCCTGATCCAGCAATGCCGCGTGTGTGAAGAAGGCCTTCGGGTTGTAAAGCACTTTCAGTAGGGAGGAAAGGTGCGTAGCTAATACCTGCGCAATTGACGTTACCTACAGAAGAAGCACCGGCT	1.0
TGGGGAATATTGGACAATGGGGGCAACCCTGATCCAGCAATTCTGTGTGCACGAAGAAGGTTTTCGGATCGTAAAGTGCTTTCAGCAGGGAGGAAGGAAGTGACTGTACCTGCAGAAGAAGCGACGGCTAAATACGTGCCAGCAGCCGCG	TGGGGAATATTGGACAATGGGGGCAACCCTGATCCAGCAATTCTGTGTGCACGAAGAAGGTTTTCGGATCGTAAAGTGCTTTCAGCAGGGAGGAAGGAAGTGACTGTACCTGCAGAAGAAGCGACGGCTAAATACGTGCCAGCAGCCGCG	1.0
TGGGGAATATTGGACAATGGGGGCAACCCTGATCCAGCAATTCTGTGTGCACGAAGAAGGTTTTCGGATTGTAAAGTGCTTTCAGCAGGGAAGAAAAAAATGACGGTACCTGCAGAAGAAGCGACGGCTAAATACGTGCCAGCAGCCGCG	TGGGGAATATTGGACAATGGGGGCAACCCTGATCCAGCAATTCTGTGTGCACGAAGAAGGTTTTCGGATTGTAAAGTGCTTTCAGCAGGGAAGAAAAAAATGACGGTACCTGCAGAAGAAGCGACGGCTAAATACGTGCCAGCAGCCGCG	1.0
TGGGGAATATTGGACAATGGGGGCAACCCTGATCCAGCAATTCTGTGTGCACGAAGAAGGTTTTCGGATTGTAAAGTGCTTTCAGCAGGGAAGAAGAAAGTGACGGTACCTGCAGAAGAAGCGACGGCTAAATACGTGCCAGCAGCCGCG	TGGGGAATATTGGACAATGGGGGCAACCCTGATCCAGCAATTCTGTGTGCACGAAGAAGGTTTTCGGATTGTAAAGTGCTTTCAGCAGGGAAGAAGAAAGTGACGGTACCTGCAGAAGAAGCGACGGCTAAATACGTGCCAGCAGCCGCG	1.0
TGGGGAATATTGGACAATGGGGGCAACCCTGATCCAGCAATTCTGTGTGCACGATGAAGGTCTTCGGATTGTAAAGTGCTTTCAGCAGGGAAGAAAAAAATGACGGTACCTGCAGAAGAAGCGACGGCTAAATACGTGCCAGCAGCCGCG	TGGGGAATATTGGACAATGGGGGCAACCCTGATCCAGCAATTCTGTGTGCACGATGAAGGTCTTCGGATTGTAAAGTGCTTTCAGCAGGGAAGAAAAAAATGACGGTACCTGCAGAAGAAGCGACGGCTAAATACGTGCCAGCAGCCGCG	1.0
TGGGGAATATTGGACAATGGGGGCAACCCTGATCCAGCGACGCCGCGTGAGTGAAGAAGTATTTCGGTATGTAAAGCTCTATCGATAACGGAAGAAGATGACAAGCCGTTAAGGAAGAAGCCCCGGCTAACTACGTGCCAGCAGCCGCGG	TGGGGAATATTGGACAATGGGGGCAACCCTGATCCAGCGACGCCGCGTGAGTGAAGAAGTATTTCGGTATGTAAAGCTCTATCGATAACGGAAGAAGATGACAAGCCGTTAAGGAAGAAGCCCCGGCTAACTACGTGCCAGCAGCCGCGG	1.0
TGGGGAATATTGGACAATGGGGGGAACCCTGATCCAGCAATGCCGCGTGTGTGAAGAAGGCCTTCGGGTTGTAAAGCACTTTCAGCAGGGAGGAAAGCATCATGGTTAATACCCATGGTAGTGACGTTACCTGCAGAAGAAGCACCGGCT	TGGGGAATATTGGACAATGGGGGGAACCCTGATCCAGCAATGCCGCGTGTGTGAAGAAGGCCTTCGGGTTGTAAAGCACTTTCAGCAGGGAGGAAAGCATCATGGTTAATACCCATGGTAGTGACGTTACCTGCAGAAGAAGCACCGGCT	1.0
TGGGGAATATTGGACAATGGGGGGAACCCTGATCCAGCAATGCCGCGTGTGTGAAGAAGGCCTTCGGGTTGTAAAGCACTTTCAGCAGGGAGGAAAGGTGCGTAGTTAATAGCTGCGCAATTGACGTTACCTGCAGAAGAAGCACCGGCT	TGGGGAATATTGGACAATGGGGGGAACCCTGATCCAGCAATGCCGCGTGTGTGAAGAAGGCCTTCGGGTTGTAAAGCACTTTCAGCAGGGAGGAAAGGTGCGTAGTTAATAGCTGCGCAATTGACGTTACCTGCAGAAGAAGCACCGGCT	1.0
TGGGGAATCTTCCACAATGGGCGAAAGCCTGATGGAGCAACGCCGCGTGAGTGAAGAAGGTCTTCGGATCGTAAAGCTCTGTTGCACGGGACGAAAACCGAGCTTGAAAACATTGAGTTTGGGTGACGGTACCGAGCGAGGAAGCCACGG	TGGGGAATCTTCCACAATGGGCGAAAGCCTGATGGAGCAACGCCGCGTGAGTGAAGAAGGTCTTCGGATCGTAAAGCTCTGTTGCACGGGACGAAAACCGAGCTTGAAAACATTGAGTTTGGGTGACGGTACCGAGCGAGGAAGCCACGG	1.0
TGGGGAATCTTCCACAATGGGCGAAAGCCTGATGGAGCAACGCCGCGTGAGTGAAGAAGGTCTTCGGATCGTAAAGCTCTGTTGCACGGGACGAAAACCGAGCTTGAAAATATTGAGCTTGGGTGACGGTACCGAGCGAGGAAGCCACGG	TGGGGAATCTTCCACAATGGGCGAAAGCCTGATGGAGCAACGCCGCGTGAGTGAAGAAGGTCTTCGGATCGTAAAGCTCTGTTGCACGGGACGAAAACCGAGCTTGAAAATATTGAGCTTGGGTGACGGTACCGAGCGAGGAAGCCACGG	1.0
TGGGGAATCTTCCACAATGGGCGAAAGCCTGATGGAGCAACGCCGCGTGAGTGAAGAAGGTCTTCGGATCGTAAAGCTCTGTTGCACGGGACGAAAACCGAGCTTGAAAATATTGAGTTTGGGTGACGGTACCGAGCGAGGAAGCCACGG	TGGGGAATCTTCCACAATGGGCGAAAGCCTGATGGAGCAACGCCGCGTGAGTGAAGAAGGTCTTCGGATCGTAAAGCTCTGTTGCACGGGACGAAAACCGAGCTTGAAAATATTGAGTTTGGGTGACGGTACCGAGCGAGGAAGCCACGG	1.0
TGGGGAATCTTCCACAATGGGCGAAAGCCTGATGGAGCAACGCCGCGTGAGTGAAGAAGGTCTTCGGATCGTAAAGCTCTGTTGCACGGGACGAAAACCGAGCTTGAGAATATTGAGTTTGGGTGACGGTACCGAGCGAGGAAGCCACGG	TGGGGAATCTTCCACAATGGGCGAAAGCCTGATGGAGCAACGCCGCGTGAGTGAAGAAGGTCTTCGGATCGTAAAGCTCTGTTGCACGGGACGAAAACCGAGCTTGAGAATATTGAGTTTGGGTGACGGTACCGAGCGAGGAAGCCACGG	1.0
TGGGGAATCTTCCACAATGGGCGAAAGCCTGATGGAGCAACGCCGCGTGAGTGAAGAAGGTCTTCGGATCGTAAAGCTCTGTTGCACGGGACGAAAACCGGGTTTGAAAATATTGAACCTGGGTGACGGTACCGAGCGAGGAAGCCACGG	TGGGGAATCTTCCACAATGGGCGAAAGCCTGATGGAGCAACGCCGCGTGAGTGAAGAAGGTCTTCGGATCGTAAAGCTCTGTTGCACGGGACGAAAACCGGGTTTGAAAATATTGAACCTGGGTGACGGTACCGAGCGAGGAAGCCACGG	1.0
TGGGGAATCTTCCACAATGGGCGAAAGCCTGATGGAGCAACGCCGCGTGAGTGAAGAAGGTCTTCGGATCGTAAAGCTCTGTTGCACGGGACGAAAACCGGGTTTGAGAATATTGAACCCGGGTGACGGTACCGAGCGAGGAAGCCACGG	TGGGGAATCTTCCACAATGGGCGAAAGCCTGATGGAGCAACGCCGCGTGAGTGAAGAAGGTCTTCGGATCGTAAAGCTCTGTTGCACGGGACGAAAACCGGGTTTGAGAATATTGAACCCGGGTGACGGTACCGAGCGAGGAAGCCACGG	1.0
TGGGGAATCTTCCACAATGGGCGAAAGCCTGATGGAGCAACGCCGCGTGAGTGAAGAAGGTCTTCGGATCGTAAAGCTCTGTTGCACGGGACGAAAACTGGGTTTGAAAACATTGAACCTGGGTGACGGTACCGAGCGAGGAAGCCACGG	TGGGGAATCTTCCACAATGGGCGAAAGCCTGATGGAGCAACGCCGCGTGAGTGAAGAAGGTCTTCGGATCGTAAAGCTCTGTTGCACGGGACGAAAACTGGGTTTGAAAACATTGAACCTGGGTGACGGTACCGAGCGAGGAAGCCACGG	1.0
TGGGGAATCTTCCACAATGGGCGAAAGCCTGATGGAGCAACGCCGCGTGAGTGAAGAAGGTCTTCGGATCGTAAAGCTCTGTTGCACGGGACGAAAACTGGGTTTGAGAACATTGAACCTGGGTGACGGTACCGAGCGAGGAAGCCACGG	TGGGGAATCTTCCACAATGGGCGAAAGCCTGATGGAGCAACGCCGCGTGAGTGAAGAAGGTCTTCGGATCGTAAAGCTCTGTTGCACGGGACGAAAACTGGGTTTGAGAACATTGAACCTGGGTGACGGTACCGAGCGAGGAAGCCACGG	1.0
TGGGGAATCTTCCGCAATGGACGAAAGTCTGACGGAGCAACGCCGCGTGAGTGATGACGGCCTTCGGGTTGTAAAGCTCTGTTAATCGGGACGAAAGGCCTTCTTGCGAACAGTTAGAAGGATTGACGGTACCGGAATAGAAAGCCACGG	TGGGGAATCTTCCGCAATGGACGAAAGTCTGACGGAGCAACGCCGCGTGAGTGATGACGGCCTTCGGGTTGTAAAGCTCTGTTAATCGGGACGAAAGGCCTTCTTGCGAACAGTTAGAAGGATTGACGGTACCGGAATAGAAAGCCACGG	1.0
TGGGGAATCTTCCGCAATGGACGAAAGTCTGACGGAGCAACGCCGCGTGAGTGATGACGGCCTTCGGGTTGTAAAGCTCTGTTAATCGGGACGAAAGGCCTTCTTGCGAATAGTGAGAAGGATTGACGGTACCGGAATAGAAAGCCACGG	TGGGGAATCTTCCGCAATGGACGAAAGTCTGACGGAGCAACGCCGCGTGAGTGATGACGGCCTTCGGGTTGTAAAGCTCTGTTAATCGGGACGAAAGGCCTTCTTGCGAATAGTGAGAAGGATTGACGGTACCGGAATAGAAAGCCACGG	1.0
TGGGGAATCTTCCGCAATGGGCGAAAGCCTGACGGAGCAACGCCGCGTGAGTGAAGAAGGTCTTCGGATCGTAAAGCTCTGTTGTCGGGGACGAAAGAGTAGACGAGGAAATGCGTCTACTAAGACGGTACCTGACGAGGAAGCCACGGC	TGGGGAATCTTCCGCAATGGGCGAAAGCCTGACGGAGCAACGCCGCGTGAGTGAAGAAGGTCTTCGGATCGTAAAGCTCTGTTGTCGGGGACGAAAGAGTAGACGAGGAAATGCGTCTACTAAGACGGTACCTGACGAGGAAGCCACGGC	1.0
TGGGGAATCTTCCGCAATGGGCGAAAGCCTGACGGAGCAACGCCGCGTGAGTGAAGAAGGTCTTCGGATCGTAAAGCTCTGTTGTCGGGGACGAAAGGGTAGACGAGGTAATGCGTTTACTAAGACGGTACCCGACGAGGAAGCCACGGC	TGGGGAATCTTCCGCAATGGGCGAAAGCCTGACGGAGCAACGCCGCGTGAGTGAAGAAGGTCTTCGGATCGTAAAGCTCTGTTGTCGGGGACGAAAGGGTAGACGAGGTAATGCGTTTACTAAGACGGTACCCGACGAGGAAGCCACGGC	1.0
TGGGGAATCTTCCGCAATGGGCGAAAGCCTGACGGAGCAACGCCGCGTGAGTGAAGACGGCCTTCGGGTTGTAAAGCTCTGTTATAGGGGACGAACGGCCGGGTAGCGAAGAGGTAGCCGGCATGACGGTACCGTAAGAGAAAGCCACGG	TGGGGAATCTTCCGCAATGGGCGAAAGCCTGACGGAGCAACGCCGCGTGAGTGAAGACGGCCTTCGGGTTGTAAAGCTCTGTTATAGGGGACGAACGGCCGGGTAGCGAAGAGGTAGCCGGCATGACGGTACCGTAAGAGAAAGCCACGG	1.0
TGGGGAATCTTCCGCAATGGGCGAAAGCCTGACGGAGCAACGCCGCGTGAGTGATGACGGCCTTCGGGTTGTAAAACTCTGTGATCCGGGACGAAAAGGCAGAGTGCGAAGAACAAACTGCATTGACGGTACCGGAAAAGCAAGCCACGG	TGGGGAATCTTCCGCAATGGGCGAAAGCCTGACGGAGCAACGCCGCGTGAGTGATGACGGCCTTCGGGTTGTAAAACTCTGTGATCCGGGACGAAAAGGCAGAGTGCGAAGAACAAACTGCATTGACGGTACCGGAAAAGCAAGCCACGG	1.0
TGGGGAATCTTCCGCAATGGGCGAAAGCCTGACGGAGCAACGCCGCGTGGGTGAAGAAGGTCTTCGGATCGTAAAGCCCTGTTGCCCGGGACGAACGCCCCCGGCGCGAACAGCGCCGGGGGGTGACGGTACCGGGCGAGGAAGCCACGG	TGGGGAATCTTCCGCAATGGGCGAAAGCCTGACGGAGCAACGCCGCGTGGGTGAAGAAGGTCTTCGGATCGTAAAGCCCTGTTGCCCGGGACGAACGCCCCCGGCGCGAACAGCGCCGGGGGGTGACGGTACCGGGCGAGGAAGCCACGG	1.0
TGGGGAATCTTCCGCAATGGGCGCAAGCCTGACGGAGCAACGCCGCGTGAGTGAAGAAGGTCTTCGGATCGTAAAGCTCTGTTGAAGGGGACGAACGATCGAGGGGCGAACAGGCTCTCGGTATGACGGTACCTTTTGAGGAAGCCACGG	TGGGGAATCTTCCGCAATGGGCGCAAGCCTGACGGAGCAACGCCGCGTGAGTGAAGAAGGTCTTCGGATCGTAAAGCTCTGTTGAAGGGGACGAACGATCGAGGGGCGAACAGGCTCTCGGTATGACGGTACCTTTTGAGGAAGCCACGG	1.0
TGGGGAATCTTCCGCAATGGGCGCAAGCCTGACGGAGCAACGCCGCGTGAGTGAAGAAGGTCTTCGGATCGTAAAGCTCTGTTGAAGGGGACGAACGTACACAGTGCGAATAGCGCTGTGTAATGACGGTACCTTTTGAGGAAGCCACGG	TGGGGAATCTTCCGCAATGGGCGCAAGCCTGACGGAGCAACGCCGCGTGAGTGAAGAAGGTCTTCGGATCGTAAAGCTCTGTTGAAGGGGACGAACGTACACAGTGCGAATAGCGCTGTGTAATGACGGTACCTTTTGAGGAAGCCACGG	1.0
TGGGGAATCTTCCGCAATGGGCGCAAGCCTGACGGAGCAACGCCGCGTGAGTGAAGAAGGTCTTCGGATCGTAAAGCTCTGTTGAAGGGGACGAACGTACATAGTGCGAATAGTGCTGTGTAATGACGGTACCTTTTGAGGAAGCCACGG	TGGGGAATCTTCCGCAATGGGCGCAAGCCTGACGGAGCAACGCCGCGTGAGTGAAGAAGGTCTTCGGATCGTAAAGCTCTGTTGAAGGGGACGAACGTACATAGTGCGAATAGTGCTGTGTAATGACGGTACCTTTTGAGGAAGCCACGG	1.0
TGGGGAATCTTCCGCAATGGGCGCAAGCCTGACGGAGCAACGCCGCGTGAGTGAAGAAGGTCTTCGGATCGTAAAGCTCTGTTGAAGGGGACGAACGTATATAGTGCGAATAGTGCTGTGTAATGACGGTACCTTTTGAGGAAGCCACGG	TGGGGAATCTTCCGCAATGGGCGCAAGCCTGACGGAGCAACGCCGCGTGAGTGAAGAAGGTCTTCGGATCGTAAAGCTCTGTTGAAGGGGACGAACGTATATAGTGCGAATAGTGCTGTGTAATGACGGTACCTTTTGAGGAAGCCACGG	1.0
TGGGGAATCTTCCGCAATGGGCGCAAGCCTGACGGAGCAACGCCGCGTGAGTGAAGAAGGTCTTCGGATCGTAAAGCTCTGTTGAAGGGGACGAACGTGCGCAGTGCGAATAGCGCTGTGTAATGACGGTACCTTTTGAGGAAGCCACGG	TGGGGAATCTTCCGCAATGGGCGCAAGCCTGACGGAGCAACGCCGCGTGAGTGAAGAAGGTCTTCGGATCGTAAAGCTCTGTTGAAGGGGACGAACGTGCGCAGTGCGAATAGCGCTGTGTAATGACGGTACCTTTTGAGGAAGCCACGG	1.0
TGGGGAATCTTCCGCAATGGGCGCAAGCCTGACGGAGCAACGCCGCGTGAGTGAAGAAGGTCTTCGGATCGTAAAGCTCTGTTGACGGGGACGAACGTACGGAGTGCAAATAGTGCTCTGTAATGACGGTACCTGTCGAGGAAGCCACGG	TGGGGAATCTTCCGCAATGGGCGCAAGCCTGACGGAGCAACGCCGCGTGAGTGAAGAAGGTCTTCGGATCGTAAAGCTCTGTTGACGGGGACGAACGTACGGAGTGCAAATAGTGCTCTGTAATGACGGTACCTGTCGAGGAAGCCACGG	1.0
TGGGGAATCTTCCGCAATGGGCGCAAGCCTGACGGAGCAACGCCGCGTGAGTGAAGAAGGTCTTCGGATCGTAAAGCTCTGTTGACGGGGACGAACGTGCCTAGTGCAAATAGTATTAGGTAATGACGGTACCTGTCGAGGAAGCCACGG	TGGGGAATCTTCCGCAATGGGCGCAAGCCTGACGGAGCAACGCCGCGTGAGTGAAGAAGGTCTTCGGATCGTAAAGCTCTGTTGACGGGGACGAACGTGCCTAGTGCAAATAGTATTAGGTAATGACGGTACCTGTCGAGGAAGCCACGG	1.0
TGGGGAATCTTCCGCAATGGGCGCAAGCCTGACGGAGCAACGCCGCGTGAGTGAAGAAGGTCTTCGGATCGTAAAGCTCTGTTGACGGGGACGAACGTGCGAAGGGTGAATAATCCTTTGCAATGACGGTACCTGTCGAGGAAGCCACGG	TGGGGAATCTTCCGCAATGGGCGCAAGCCTGACGGAGCAACGCCGCGTGAGTGAAGAAGGTCTTCGGATCGTAAAGCTCTGTTGACGGGGACGAACGTGCGAAGGGTGAATAATCCTTTGCAATGACGGTACCTGTCGAGGAAGCCACGG	1.0
TGGGGAATCTTCCGCAATGGGCGCAAGCCTGACGGAGCAACGCCGCGTGAGTGAAGAAGGTCTTCGGATCGTAAAGCTCTGTTGACGGGGACGAACGTGCGAAGGGTGAATAATCCTTTGTAATGACGGTACCTGTCGAGGAAGCCACGG	TGGGGAATCTTCCGCAATGGGCGCAAGCCTGACGGAGCAACGCCGCGTGAGTGAAGAAGGTCTTCGGATCGTAAAGCTCTGTTGACGGGGACGAACGTGCGAAGGGTGAATAATCCTTTGTAATGACGGTACCTGTCGAGGAAGCCACGG	1.0
TGGGGAATCTTCCGCAATGGGCGCAAGCCTGACGGAGCAACGCCGCGTGAGTGAAGAAGGTCTTCGGATCGTAAAGCTCTGTTGACGGGGACGAACGTGCGAGAGGTGAATAAACTCTAGCAATGACGGTACCTGTCGAGGAAGCCACGG	TGGGGAATCTTCCGCAATGGGCGCAAGCCTGACGGAGCAACGCCGCGTGAGTGAAGAAGGTCTTCGGATCGTAAAGCTCTGTTGACGGGGACGAACGTGCGAGAGGTGAATAAACTCTAGCAATGACGGTACCTGTCGAGGAAGCCACGG	1.0
TGGGGAATCTTCCGCAATGGGCGCAAGCCTGACGGAGCAACGCCGCGTGAGTGAAGAAGGTCTTCGGATCGTAAAGCTCTGTTGACGGGGACGAACGTGCGGAGTGCGAACAGCGCTTTGTAATGACGGTACCTGTCGAGGAAGCCACGG	TGGGGAATCTTCCGCAATGGGCGCAAGCCTGACGGAGCAACGCCGCGTGAGTGAAGAAGGTCTTCGGATCGTAAAGCTCTGTTGACGGGGACGAACGTGCGGAGTGCGAACAGCGCTTTGTAATGACGGTACCTGTCGAGGAAGCCACGG	1.0
TGGGGAATCTTCCGCAATGGGCGCAAGCCTGACGGAGCAACGCCGCGTGAGTGAAGAAGGTCTTCGGATCGTAAAGCTCTGTTGACGGGGACGAACGTGCGGAGTGCGAATAGCGCTTTGTAATGACGGTACCTGTCGAGGAAGCCACGG	TGGGGAATCTTCCGCAATGGGCGCAAGCCTGACGGAGCAACGCCGCGTGAGTGAAGAAGGTCTTCGGATCGTAAAGCTCTGTTGACGGGGACGAACGTGCGGAGTGCGAATAGCGCTTTGTAATGACGGTACCTGTCGAGGAAGCCACGG	1.0
TGGGGAATCTTCCGCAATGGGCGCAAGCCTGACGGAGCAACGCCGCGTGAGTGAAGAAGGTCTTCGGATCGTAAAGCTCTGTTGACGGGGACGAACGTGCGTGATGCGAACAGTGTCATGCAATGACGGTACCTGTCGAGGAAGCCACGG	TGGGGAATCTTCCGCAATGGGCGCAAGCCTGACGGAGCAACGCCGCGTGAGTGAAGAAGGTCTTCGGATCGTAAAGCTCTGTTGACGGGGACGAACGTGCGTGATGCGAACAGTGTCATGCAATGACGGTACCTGTCGAGGAAGCCACGG	1.0
TGGGGAATCTTCCGCAATGGGCGCAAGCCTGACGGAGCAACGCCGCGTGAGTGAAGAAGGTCTTCGGATCGTAAAGCTCTGTTGATGGGGACGAACGTACGGAGTGCGAATAGTGCTCTGTAATGACGGTACCTATCGAGGAAGCCACGG	TGGGGAATCTTCCGCAATGGGCGCAAGCCTGACGGAGCAACGCCGCGTGAGTGAAGAAGGTCTTCGGATCGTAAAGCTCTGTTGATGGGGACGAACGTACGGAGTGCGAATAGTGCTCTGTAATGACGGTACCTATCGAGGAAGCCACGG	1.0
TGGGGAATCTTCCGCAATGGGCGCAAGCCTGACGGAGCAACGCCGCGTGAGTGAAGAAGGTCTTCGGATCGTAAAGCTCTGTTGATGGGGACGAACGTGCCTAATGCGAATAGTTTTAGGCAATGACGGTACCCATCGAGGAAGCCACGG	TGGGGAATCTTCCGCAATGGGCGCAAGCCTGACGGAGCAACGCCGCGTGAGTGAAGAAGGTCTTCGGATCGTAAAGCTCTGTTGATGGGGACGAACGTGCCTAATGCGAATAGTTTTAGGCAATGACGGTACCCATCGAGGAAGCCACGG	1.0
TGGGGAATCTTCCGCAATGGGCGCAAGCCTGACGGAGCAACGCCGCGTGAGTGAAGAAGGTCTTCGGATCGTAAAGCTCTGTTGATGGGGACGAACGTGCGAAGGGTGAATAATCCTTTGCAATGACGGTACCTATCGAGGAAGCCACGG	TGGGGAATCTTCCGCAATGGGCGCAAGCCTGACGGAGCAACGCCGCGTGAGTGAAGAAGGTCTTCGGATCGTAAAGCTCTGTTGATGGGGACGAACGTGCGAAGGGTGAATAATCCTTTGCAATGACGGTACCTATCGAGGAAGCCACGG	1.0
TGGGGAATCTTCCGCAATGGGCGCAAGCCTGACGGAGCAACGCCGCGTGAGTGAAGAAGGTCTTCGGATCGTAAAGCTCTGTTGATGGGGACGAACGTGCGAAGGGTGAATAATCCTTTGTAATGACGGTACCTATCGAGGAAGCCACGG	TGGGGAATCTTCCGCAATGGGCGCAAGCCTGACGGAGCAACGCCGCGTGAGTGAAGAAGGTCTTCGGATCGTAAAGCTCTGTTGATGGGGACGAACGTGCGAAGGGTGAATAATCCTTTGTAATGACGGTACCTATCGAGGAAGCCACGG	1.0
TGGGGAATCTTCCGCAATGGGCGCAAGCCTGACGGAGCAACGCCGCGTGAGTGAAGAAGGTCTTCGGATCGTAAAGCTCTGTTGATGGGGACGAACGTGCGAAGGGTGAATAATCCTTTGTAATGACGGTACCTGTCGAGGAAGCCACGG	TGGGGAATCTTCCGCAATGGGCGCAAGCCTGACGGAGCAACGCCGCGTGAGTGAAGAAGGTCTTCGGATCGTAAAGCTCTGTTGATGGGGACGAACGTGCGAAGGGTGAATAATCCTTTGTAATGACGGTACCTGTCGAGGAAGCCACGG	1.0
TGGGGAATCTTCCGCAATGGGCGCAAGCCTGACGGAGCAACGCCGCGTGAGTGAAGAAGGTCTTCGGATCGTAAAGCTCTGTTGATGGGGACGAATGTACGGAGTGCGAATAGTGCTCTGTAATGACGGTACCTATCGAGGAAGCCACGG	TGGGGAATCTTCCGCAATGGGCGCAAGCCTGACGGAGCAACGCCGCGTGAGTGAAGAAGGTCTTCGGATCGTAAAGCTCTGTTGATGGGGACGAATGTACGGAGTGCGAATAGTGCTCTGTAATGACGGTACCTATCGAGGAAGCCACGG	1.0
TGGGGAATCTTCCGCAATGGGCGCAAGCCTGACGGAGCAACGCCGCGTGAGTGAAGAAGGTCTTCGGATCGTAAAGCTCTGTTGATGGGGACGAATGTGCGTGATGCGAATAGTGTCATGCAATGACGGTACCTATCGAGGAAGCCACGG	TGGGGAATCTTCCGCAATGGGCGCAAGCCTGACGGAGCAACGCCGCGTGAGTGAAGAAGGTCTTCGGATCGTAAAGCTCTGTTGATGGGGACGAATGTGCGTGATGCGAATAGTGTCATGCAATGACGGTACCTATCGAGGAAGCCACGG	1.0
TGGGGAATCTTGCACAATGGGCGAAAGCCTGATGCAGCGACGCCGCGTGCGGGAAGAAGGCCTTCGGGTTGTAAACCGCTTTCAGCAGGGACGAGGCGATAAGTGACGGTACCTGCAGAAGAAGCCCCGGCTAACTACGTGCCAGCAGCC	TGGGGAATCTTGCACAATGGGCGAAAGCCTGATGCAGCGACGCCGCGTGCGGGAAGAAGGCCTTCGGGTTGTAAACCGCTTTCAGCAGGGACGAGGCGATAAGTGACGGTACCTGCAGAAGAAGCCCCGGCTAACTACGTGCCAGCAGCC	1.0
TGGGGAATCTTGCACAATGGGCGAAAGCCTGATGCAGCGACGCCGCGTGCGGGACGAAGGCCTTCGGGTCGTAAACCGCTTTCAGCAGGGACGAGGCCGAAAGGTGACGGTACCTGCAGAAGAAGCCCCGGCTAACTACGTGCCAGCAGC	TGGGGAATCTTGCACAATGGGCGAAAGCCTGATGCAGCGACGCCGCGTGCGGGACGAAGGCCTTCGGGTCGTAAACCGCTTTCAGCAGGGACGAGGCCGAAAGGTGACGGTACCTGCAGAAGAAGCCCCGGCTAACTACGTGCCAGCAGC	1.0
TGGGGAATCTTGCACAATGGGCGAAAGCCTGATGCAGCGACGCCGCGTGCGGGACGAAGGCCTTCGGGTCGTAAACCGCTTTCAGCAGGGACGAGGCCGCAAGGTGACGGTACCTGCAGAAGAAGCCCCGGCTAACTACGTGCCAGCAGC	TGGGGAATCTTGCACAATGGGCGAAAGCCTGATGCAGCGACGCCGCGTGCGGGACGAAGGCCTTCGGGTCGTAAACCGCTTTCAGCAGGGACGAGGCCGCAAGGTGACGGTACCTGCAGAAGAAGCCCCGGCTAACTACGTGCCAGCAGC	1.0
TGGGGAATCTTGCACAATGGGCGAAAGCCTGATGCAGCGACGCCGCGTGCGGGACGAAGGCCTTCGGGTTGTAAACCGCTTTCAGCAGGGACGAGGCGAAAGTGACGGTACCTGCAGAAGAAGCCCCGGCTAACTACGTGCCAGCAGCCG	TGGGGAATCTTGCACAATGGGCGAAAGCCTGATGCAGCGACGCCGCGTGCGGGACGAAGGCCTTCGGGTTGTAAACCGCTTTCAGCAGGGACGAGGCGAAAGTGACGGTACCTGCAGAAGAAGCCCCGGCTAACTACGTGCCAGCAGCCG	1.0
TGGGGAATCTTGCACAATGGGCGAAAGCCTGATGCAGCGACGCCGCGTGCGGGACGAAGGCCTTCGGGTTGTAAACCGCTTTCAGCAGGGACGAGGCGATAAGTGACGGTACCTGCAGAAGAAGCCCCGGCTAACTACGTGCCAGCAGCC	TGGGGAATCTTGCACAATGGGCGAAAGCCTGATGCAGCGACGCCGCGTGCGGGACGAAGGCCTTCGGGTTGTAAACCGCTTTCAGCAGGGACGAGGCGATAAGTGACGGTACCTGCAGAAGAAGCCCCGGCTAACTACGTGCCAGCAGCC	1.0
TGGGGAATCTTGCGCAATGGGCGGAAGCCTGACGCAGCGACGCCGCGTGCGGGAAGGAGGCCTTCGGGTCGTAAACCGCTTTCAGCAGGGACGAGGCCGCGAGGTGACGGTACCTGCAGAAGAAGCCCCGGCTAACTACGTGCCAGCAGC	TGGGGAATCTTGCGCAATGGGCGGAAGCCTGACGCAGCGACGCCGCGTGCGGGAAGGAGGCCTTCGGGTCGTAAACCGCTTTCAGCAGGGACGAGGCCGCGAGGTGACGGTACCTGCAGAAGAAGCCCCGGCTAACTACGTGCCAGCAGC	1.0
TGGGGAATCTTGCGCAATGGGGGAAACCCTGACGCAGCGACGCCGCGTGCGGGATGGAGGCCTTCGGGCCGTGAACCGCTTTCAGCAGGGAAGACATTAAGGACGGTACCTGCAGAAGAAGCCCCGGCTAACTACGTGCCAGCAGCCGCG	TGGGGAATCTTGCGCAATGGGGGAAACCCTGACGCAGCGACGCCGCGTGCGGGATGGAGGCCTTCGGGCCGTGAACCGCTTTCAGCAGGGAAGACATTAAGGACGGTACCTGCAGAAGAAGCCCCGGCTAACTACGTGCCAGCAGCCGCG	1.0
TGGGGAATTTTCCGCAATGGGCGAAAGCCTGACGGAGCAATGCCGCGTGGAGGTGGAAGGCCTACGGGTCGTCAACTTCTTTTCTCGGAGAAGAAACAATGACGGTATCTGAGGAATAAGCATCGGCTAACTCTGTGCCAGCAGCCGCGG	TGGGGAATTTTCCGCAATGGGCGAAAGCCTGACGGAGCAATGCCGCGTGGAGGTGGAAGGCCTACGGGTCGTCAACTTCTTTTCTCGGAGAAGAAACAATGACGGTATCTGAGGAATAAGCATCGGCTAACTCTGTGCCAGCAGCCGCGG	1.0
TGGGGAATTTTGGACAATGGGCGAAAGCCTGATCCAGCAATGCCGCGTGTGTGATGAAGGCCTTCGGGTTGTAAAGCACTTTTGGCGGGAACGAAAAGGACTGTGCCAATACCACGGTTCGATGACGGTACCCGCAGAATAAGCACCGGC	TGGGGAATTTTGGACAATGGGCGAAAGCCTGATCCAGCAATGCCGCGTGTGTGATGAAGGCCTTCGGGTTGTAAAGCACTTTTGGCGGGAACGAAAAGGACTGTGCCAATACCACGGTTCGATGACGGTACCCGCAGAATAAGCACCGGC	1.0
TGGGGAATTTTGGACAATGGGCGCAAGCCTGATCCAGCCATGCCGCGTGTCTGAAGAAGGCCTTCGGGTTGTAAAGGACTTTTGTCAGGGAAGAAAAGGGCGGGGTTAATACCCCTGTCTGATGACGGTACCTGAAGAATAAGCACCGGC	TGGGGAATTTTGGACAATGGGCGCAAGCCTGATCCAGCCATGCCGCGTGTCTGAAGAAGGCCTTCGGGTTGTAAAGGACTTTTGTCAGGGAAGAAAAGGGCGGGGTTAATACCCCTGTCTGATGACGGTACCTGAAGAATAAGCACCGGC	1.0
TGGGGAATTTTGGACAATGGGCGCAAGCCTGATCCAGCCATGCCGCGTGTCTGAAGAAGGCCTTCGGGTTGTAAAGGACTTTTGTTAGGGAAGAAAAAGGAGCGGTTAATACCCGTTTCTGCTGACGGTACCTAAAGAATAAGCACCGGC	TGGGGAATTTTGGACAATGGGCGCAAGCCTGATCCAGCCATGCCGCGTGTCTGAAGAAGGCCTTCGGGTTGTAAAGGACTTTTGTTAGGGAAGAAAAAGGAGCGGTTAATACCCGTTTCTGCTGACGGTACCTAAAGAATAAGCACCGGC	1.0
TGGGGAATTTTGGACAATGGGCGCAAGCCTGATCCAGCCATGCCGCGTGTCTGAAGAAGGCCTTCGGGTTGTAAAGGACTTTTGTTAGGGAAGAAAAGGATAGTGTTAATACCATTATCTGCTGACGGTACCTAAAGAATAAGCACCGGC	TGGGGAATTTTGGACAATGGGCGCAAGCCTGATCCAGCCATGCCGCGTGTCTGAAGAAGGCCTTCGGGTTGTAAAGGACTTTTGTTAGGGAAGAAAAGGATAGTGTTAATACCATTATCTGCTGACGGTACCTAAAGAATAAGCACCGGC	1.0
TGGGGAATTTTGGACAATGGGCGCAAGCCTGATCCAGCCATTCCGCGTGCAGGATGAAGGCCCTCGGGTTGTAAACTGCTTTTGTACAGAACGAAAAAGGCCTGGCTAATATCTGGGTCTCATGACGGTACTGTAAGAATAAGCACCGGC	TGGGGAATTTTGGACAATGGGCGCAAGCCTGATCCAGCCATTCCGCGTGCAGGATGAAGGCCCTCGGGTTGTAAACTGCTTTTGTACAGAACGAAAAAGGCCTGGCTAATATCTGGGTCTCATGACGGTACTGTAAGAATAAGCACCGGC	1.0
TGGGGAATTTTGGACAATGGGCGCAAGCCTGATCCAGCCATTCCGCGTGCAGGATGAAGGCCCTCGGGTTGTAAACTGCTTTTGTACAGAACGAAAAGGGCCTGGCTAATATCTAGGTCTCATGACGGTACTGTAAGAATAAGCACCGGC	TGGGGAATTTTGGACAATGGGCGCAAGCCTGATCCAGCCATTCCGCGTGCAGGATGAAGGCCCTCGGGTTGTAAACTGCTTTTGTACAGAACGAAAAGGGCCTGGCTAATATCTAGGTCTCATGACGGTACTGTAAGAATAAGCACCGGC	1.0
TGGGGAATTTTGGACAATGGGGGCAACCCTGATCCAGCCATGCCGCGTGTATGAAGAAGGCCTTCGGGTTGTAAAGTACTTTTGTTAGGGAAGAAAAGGGAAGTGCTAATACCACTTTTTGCTGACGGTACCTAAAGAATAAGCACCGGC	TGGGGAATTTTGGACAATGGGGGCAACCCTGATCCAGCCATGCCGCGTGTATGAAGAAGGCCTTCGGGTTGTAAAGTACTTTTGTTAGGGAAGAAAAGGGAAGTGCTAATACCACTTTTTGCTGACGGTACCTAAAGAATAAGCACCGGC	1.0
TGGGGAATTTTGGACAATGGGGGCAACCCTGATCCAGCCATGCCGCGTGTCTGAAGAAGGCCTTCGGGTTGTAAAGGACTTTTGTCCGGGAAGAAAAGCGCGATGTTAATACCATTGCGTGCTGACGGTACCGGAAGAATAAGCACCGGC	TGGGGAATTTTGGACAATGGGGGCAACCCTGATCCAGCCATGCCGCGTGTCTGAAGAAGGCCTTCGGGTTGTAAAGGACTTTTGTCCGGGAAGAAAAGCGCGATGTTAATACCATTGCGTGCTGACGGTACCGGAAGAATAAGCACCGGC	1.0
TGGGGGATATTGCACAATGGGCGGAAGCCTGATGCAGCGACGTCGCGTGAGGGATGGAGGCCTTCGGGTTGTGAACCTCTTTCGCCGGTGAAGAAGGTCCTGCTTTTTGGGTGGGGTTGACGGTAGCCGGGTTATGAAGCGCCGGCTAAC	TGGGGGATATTGCACAATGGGCGGAAGCCTGATGCAGCGACGTCGCGTGAGGGATGGAGGCCTTCGGGTTGTGAACCTCTTTCGCCGGTGAAGAAGGTCCTGCTTTTTGGGTGGGGTTGACGGTAGCCGGGTTATGAAGCGCCGGCTAAC	1.0
TGGGGGATATTGCACAATGGGGGGAACCCTGATGCAGCAACGCCGCGTGAGTGAAGAAGGCCCTAGGGTCGTAAAGCTCTGTCGTATGGGAAGAAGAAAATGACTGTACCATACAAGAAAGCCCCGGCTAACTACGTGCCAGCAGCCGCG	TGGGGGATATTGCACAATGGGGGGAACCCTGATGCAGCAACGCCGCGTGAGTGAAGAAGGCCCTAGGGTCGTAAAGCTCTGTCGTATGGGAAGAAGAAAATGACTGTACCATACAAGAAAGCCCCGGCTAACTACGTGCCAGCAGCCGCG	1.0
TGGGGGATATTGCACAATGGGGGGAACCCTGATGCAGCGACGCCGCGTGAGTGAAGAAGTATTTCGGTATGTAAAGCTCTATCAGCAGGGAAGATAATGACAGTACCTGAATAAGAAGCCCCGGCTAACTACGTGCCAGCAGCCGCGGTA	TGGGGGATATTGCACAATGGGGGGAACCCTGATGCAGCGACGCCGCGTGAGTGAAGAAGTATTTCGGTATGTAAAGCTCTATCAGCAGGGAAGATAATGACAGTACCTGAATAAGAAGCCCCGGCTAACTACGTGCCAGCAGCCGCGGTA	1.0
TGGGGGGTATTGCACAATGGGCGGAAGCCTGATGCAGCGACGTCGCGTGAGGGATGGAGGCCTTCGGGTTGTGAACCTCTGTTTCCGGTGGTGAAGGCCCCGCCCTTGGTGGTGGGGTTGACGGTAGCCGGGTATGAAGCGCCGGCTAAC	TGGGGGGTATTGCACAATGGGCGGAAGCCTGATGCAGCGACGTCGCGTGAGGGATGGAGGCCTTCGGGTTGTGAACCTCTGTTTCCGGTGGTGAAGGCCCCGCCCTTGGTGGTGGGGTTGACGGTAGCCGGGTATGAAGCGCCGGCTAAC	1.0
TGGGGGGTATTGCACAATGGGCGGAAGCCTGATGCAGCGACGTCGCGTGAGGGATGGAGGCCTTCGGGTTGTGAACCTCTTTCTCCGGTGGTGAAGGCCCTGTCCGTTGCGGCGGGGTTGACGGTAGCCGGGTATGAAGCGCCGGCTAAC	TGGGGGGTATTGCACAATGGGCGGAAGCCTGATGCAGCGACGTCGCGTGAGGGATGGAGGCCTTCGGGTTGTGAACCTCTTTCTCCGGTGGTGAAGGCCCTGTCCGTTGCGGCGGGGTTGACGGTAGCCGGGTATGAAGCGCCGGCTAAC	1.0
TGGGGGGTATTGCGCAATGGGCGGAAGCCTGACGCAGCGACGCCGCGTGAGGGACGGAGGCCTTCGGGTTGTGAACCTCTTTCGCCGGTGGAGAAGGCGCCCCCGTGTGGGGTGCTGACTGTAGCCGGGTTAAGAAGCGCCGGCTAACTA	TGGGGGGTATTGCGCAATGGGCGGAAGCCTGACGCAGCGACGCCGCGTGAGGGACGGAGGCCTTCGGGTTGTGAACCTCTTTCGCCGGTGGAGAAGGCGCCCCCGTGTGGGGTGCTGACTGTAGCCGGGTTAAGAAGCGCCGGCTAACTA	1.0
TAGAGAATCTTCGGCAATGGGGGAAACCCTGACCGAGCGATACCGCGTGAGTGATGAAATACTTCGGTATGTAAAACTCTTTTATTAAAGAAGAATGATATAAATAGGCAATGATTTATAAGTGACGTTATTTAATGAATAAGTCCCGGC	TAGAGAATCTTCGGCAATGGGGGAAACCCTGACCGAGCGATACCGCGTGAGTGATGAAATACTTCGGTATGTAAAACTCTTTTATTAAAGAAGAATGATATAAATAGGCAATGATTTATAAGTGACGTTATTTAATGAATAAGTCCCGGC	0.0
TAGGGAATCTTCCGCAATGGACGCAAGTCTGACGGAGCAACGCCGCGTGAGTGAAGAAGGATTTCGGTTCGTAAAACTCTGTTGTTAGAGAAGAACAGCGCATAGAGTAACTGTTATGCGTGTGACGGTATCTAACCAGAAAGCCACGGC	TAGGGAATCTTCCGCAATGGACGCAAGTCTGACGGAGCAACGCCGCGTGAGTGAAGAAGGATTTCGGTTCGTAAAACTCTGTTGTTAGAGAAGAACAGCGCATAGAGTAACTGTTATGCGTGTGACGGTATCTAACCAGAAAGCCACGGC	0.0
TAGGGAATCTTCGGCAATGGACGGAAGTCTGACCGAGCAACGCCGCGTGAGTGAAGAAGGTTTTCGGATCGTAAAGCTCTGTTGTAAGAGAAGAACGAGTGTGAGAGTGGAAAGTTCACACTGTGACGGTATCTTACCAGAAAGGGACGG	TAGGGAATCTTCGGCAATGGACGGAAGTCTGACCGAGCAACGCCGCGTGAGTGAAGAAGGTTTTCGGATCGTAAAGCTCTGTTGTAAGAGAAGAACGAGTGTGAGAGTGGAAAGTTCACACTGTGACGGTATCTTACCAGAAAGGGACGG	0.0
TAGGGAATCTTCGGCAATGGGGGCAACCCTGACCGAGCAACGCCGCGTGAGTGAAGAAGGTTTTCGGATCGTAAAGCTCTGTTGTAAGAGAAGAACGAGTGTGAGAGTGGAAAGTTCACGCTGTGACGGTATCTTACCAGAAAGGGACGG	TAGGGAATCTTCGGCAATGGGGGCAACCCTGACCGAGCAACGCCGCGTGAGTGAAGAAGGTTTTCGGATCGTAAAGCTCTGTTGTAAGAGAAGAACGAGTGTGAGAGTGGAAAGTTCACGCTGTGACGGTATCTTACCAGAAAGGGACGG	0.0
TCGGGAATATTGCACAATGGAGGAAACTCTGATGCAGTGACGCCGCGTATAGGAAGAAGGTCTTAGGATTGTAAGCTATTGTCGTGCAAGAAGAAAATGACTATTGCAGGAGGAAGCCCTGGCTAAATATGTGCCAGCAGCCGCGGTAAT	TCGGGAATATTGCACAATGGAGGAAACTCTGATGCAGTGACGCCGCGTATAGGAAGAAGGTCTTAGGATTGTAAGCTATTGTCGTGCAAGAAGAAAATGACTATTGCAGGAGGAAGCCCTGGCTAAATATGTGCCAGCAGCCGCGGTAAT	0.0
TGAGGAATATTGGACAATGGGTGGGAGCCTGATCCAGCCATTCCGCGTGCAGGAAGAAGGTCTTATGGATTGTAAACTGCTTTTATATAGGGATAAACCTACTCTCGAGAGGGTAGCTGAAGGTACTATATGAATAAGCACCGGCTAACT	TGAGGAATATTGGACAATGGGTGGGAGCCTGATCCAGCCATTCCGCGTGCAGGAAGAAGGTCTTATGGATTGTAAACTGCTTTTATATAGGGATAAACCTACTCTCGAGAGGGTAGCTGAAGGTACTATATGAATAAGCACCGGCTAACT	0.0
TGAGGAATATTGGTCAATGGACGCAAGTCTGAACCAGCCAAGTAGCGTGCAGGATGACGGCCCTCCGGGTTGTAAACTGCTTTTAGTTGGGAATAAAAAAAGGGACGTGTCCCTTATTGTATGTACCTTCAGAAAAAGGACCGGCTAATT	TGAGGAATATTGGTCAATGGACGCAAGTCTGAACCAGCCAAGTAGCGTGCAGGATGACGGCCCTCCGGGTTGTAAACTGCTTTTAGTTGGGAATAAAAAAAGGGACGTGTCCCTTATTGTATGTACCTTCAGAAAAAGGACCGGCTAATT	0.0
TGAGGAATATTGGTCAATGGACGTAAGTCTGAACCAGCCAAGTAGCGTGCAGGATGACGGCCCTATGGGTTGTAAACTGCTTTTGTTAGGGAGTAAATGAAGGCACGTGTGCTTTTTTGCATTTACCTTTCGAATAAGGACCGGCTAATT	TGAGGAATATTGGTCAATGGACGTAAGTCTGAACCAGCCAAGTAGCGTGCAGGATGACGGCCCTATGGGTTGTAAACTGCTTTTGTTAGGGAGTAAATGAAGGCACGTGTGCTTTTTTGCATTTACCTTTCGAATAAGGACCGGCTAATT	0.0
TGAGGAATATTGGTCAATGGGCGAGAGCCTGAACCAGCCAAGTAGCGTGCAGGATGACGGCCCTATGGGTTGTAAACTGCTTTTATAGGGGAATAAAGTGAGCTACGTGTAGTTTATTGCATGTACCCTATGAATAAGGACCGGCTAATT	TGAGGAATATTGGTCAATGGGCGAGAGCCTGAACCAGCCAAGTAGCGTGCAGGATGACGGCCCTATGGGTTGTAAACTGCTTTTATAGGGGAATAAAGTGAGCTACGTGTAGTTTATTGCATGTACCCTATGAATAAGGACCGGCTAATT	0.0
TGAGGAATATTGGTCAATGGGCGAGAGCCTGAACCAGCCAAGTCGCGTGAAGGACGACGGTTCTATGGATTGTAAACTTCTTTTGTAGAGGAATAATGGCAGCTACGCGTAGCTGAGATGCATGTACTCTACGAATAAGTATCGGCTAAC	TGAGGAATATTGGTCAATGGGCGAGAGCCTGAACCAGCCAAGTCGCGTGAAGGACGACGGTTCTATGGATTGTAAACTTCTTTTGTAGAGGAATAATGGCAGCTACGCGTAGCTGAGATGCATGTACTCTACGAATAAGTATCGGCTAAC	0.0
TGAGGAATATTGGTCAATGGGCGAGAGCCTGAACCAGCCAAGTCGCGTGAAGGATGACGGCCCTATGGGTTGTAAACTTCTTTTGCAGGGGAATAAAGATATTCACGTGTGGATAGTTGTATGTACCCTGCGAATAAGCATCGGCTAACT	TGAGGAATATTGGTCAATGGGCGAGAGCCTGAACCAGCCAAGTCGCGTGAAGGATGACGGCCCTATGGGTTGTAAACTTCTTTTGCAGGGGAATAAAGATATTCACGTGTGGATAGTTGTATGTACCCTGCGAATAAGCATCGGCTAACT	0.0
TGAGGAATATTGGTCAATGGGCGAGAGCCTGAACCAGCCAAGTCGCGTGAAGGATGACTGTCTTATGGATTGTAAACTTCTTTTGTAGGGGAATAAAGAACGGCACGTGTGCCGTAGTGAATGTACCCTACGAATAAGCATCGGCTAACT	TGAGGAATATTGGTCAATGGGCGAGAGCCTGAACCAGCCAAGTCGCGTGAAGGATGACTGTCTTATGGATTGTAAACTTCTTTTGTAGGGGAATAAAGAACGGCACGTGTGCCGTAGTGAATGTACCCTACGAATAAGCATCGGCTAACT	0.0
TGAGGAATATTGGTCAATGGGCGAGAGCCTGAACCAGCCAAGTCGCGTGAAGGATGACTGTCTTATGGATTGTAAACTTCTTTTGTAGGGGAATAAAGACTAGTACGTGTACTGGAGTGAATGTACCCTACGAATAAGCATCGGCTAACT	TGAGGAATATTGGTCAATGGGCGAGAGCCTGAACCAGCCAAGTCGCGTGAAGGATGACTGTCTTATGGATTGTAAACTTCTTTTGTAGGGGAATAAAGACTAGTACGTGTACTGGAGTGAATGTACCCTACGAATAAGCATCGGCTAACT	0.0
TGAGGAATATTGGTCAATGGGCGAGAGCCTGAACCAGCCAAGTCGCGTGAAGGATGACTGTCTTATGGATTGTAAACTTCTTTTGTAGGGGAATAAAGAGGGGCACGAGTGCCTCAGTGAATGTACCCTACGAATAAGCATCGGCTAACT	TGAGGAATATTGGTCAATGGGCGAGAGCCTGAACCAGCCAAGTCGCGTGAAGGATGACTGTCTTATGGATTGTAAACTTCTTTTGTAGGGGAATAAAGAGGGGCACGAGTGCCTCAGTGAATGTACCCTACGAATAAGCATCGGCTAACT	0.0
TGAGGAATATTGGTCAATGGGCGGAAGCCTGAACCAGCCAAGTAGCGTGCAGGATGACGGCCCTATGGGTTGTAAACTGCTTTTATGCGGGGATAAAAGAGCCTACGTGTGGGTTTTTGCAGGTACCGCATGAATAAGGACCGGCTAATT	TGAGGAATATTGGTCAATGGGCGGAAGCCTGAACCAGCCAAGTAGCGTGCAGGATGACGGCCCTATGGGTTGTAAACTGCTTTTATGCGGGGATAAAAGAGCCTACGTGTGGGTTTTTGCAGGTACCGCATGAATAAGGACCGGCTAATT	0.0
TGAGGAATATTGGTCAATGGGCGGAAGCCTGAACCAGCCATGCCGCGTGCCGGAAGAAGGCCCTACGGGCTGTAAACGGCTTTTGGCGGGGAGGAATGAGGGCCACGCGTGGCCCGATGCCGCGTACCCGCCGAATAAGGATCGGCTAAC	TGAGGAATATTGGTCAATGGGCGGAAGCCTGAACCAGCCATGCCGCGTGCCGGAAGAAGGCCCTACGGGCTGTAAACGGCTTTTGGCGGGGAGGAATGAGGGCCACGCGTGGCCCGATGCCGCGTACCCGCCGAATAAGGATCGGCTAAC	0.0
TGAGGAATATTGGTCAATGGGCGTAAGCCTGAACCAGCCAAGTAGCGTGCAGGATGACGGCCCTATGGGTTGTAAACTGCTTTTATGCGGGGATAAAAGAGCCCACGTGTGGGTTTTTGCAGGTACCGCATGAATAAGGACCGGCTAATT	TGAGGAATATTGGTCAATGGGCGTAAGCCTGAACCAGCCAAGTAGCGTGCAGGATGACGGCCCTATGGGTTGTAAACTGCTTTTATGCGGGGATAAAAGAGCCCACGTGTGGGTTTTTGCAGGTACCGCATGAATAAGGACCGGCTAATT	0.0
TGAGGAATATTGGTCAATGGTCGGAAGACTGAACCAGCCATGCCGCGTGCAGGAAGAATGCCTTATGGGTTGTAAACTGCTTTTATATGGGAAGAATAAGGTGTACGAGTACATTGATGACGGTACCATATGAATAAGCATCGGCTAACT	TGAGGAATATTGGTCAATGGTCGGAAGACTGAACCAGCCATGCCGCGTGCAGGAAGAATGCCTTATGGGTTGTAAACTGCTTTTATATGGGAAGAATAAGGTGTACGAGTACATTGATGACGGTACCATATGAATAAGCATCGGCTAACT	0.0
TGGGGAATATTGCACAATGGGCGAAAGCCTGATGCAGCGACGCCGCGTGAGGGATGACGGCCTTCGGGTTGTAAACCTCTTTCGCTCATGGTCAAGCCGCAACTGTGGGTTGTGGTGAGGGTAGTGGGTAAAGAAGCGCCGGCTAACTAC	TGGGGAATATTGCACAATGGGCGAAAGCCTGATGCAGCGACGCCGCGTGAGGGATGACGGCCTTCGGGTTGTAAACCTCTTTCGCTCATGGTCAAGCCGCAACTGTGGGTTGTGGTGAGGGTAGTGGGTAAAGAAGCGCCGGCTAACTAC	0.0
TGGGGAATATTGCACAATGGGCGAAAGCCTGATGCAGCGACGCCGCGTGAGGGATGGAGGCCTTCGGGTTGTAAACCTCTTTCGCTCATGGTCAAGCCGCGACTTTGGTTGTGGTGAGGGTAGTGGGTAAAGAAGCGCCGGCTAACTACG	TGGGGAATATTGCACAATGGGCGAAAGCCTGATGCAGCGACGCCGCGTGAGGGATGGAGGCCTTCGGGTTGTAAACCTCTTTCGCTCATGGTCAAGCCGCGACTTTGGTTGTGGTGAGGGTAGTGGGTAAAGAAGCGCCGGCTAACTACG	0.0
TGGGGAATATTGCACAATGGGCGCAAGCCTGATGCAGCGACGCCGCGTGGGGGATGACGGCCTTCGGGTTGTAAACTCCTTTCGTTAGGGACGAAGCCGCACCTGTTTTGGGTGTGGTGACGGTACCTTTGTTAAGAAGCACCGGCTAAC	TGGGGAATATTGCACAATGGGCGCAAGCCTGATGCAGCGACGCCGCGTGGGGGATGACGGCCTTCGGGTTGTAAACTCCTTTCGTTAGGGACGAAGCCGCACCTGTTTTGGGTGTGGTGACGGTACCTTTGTTAAGAAGCACCGGCTAAC	0.0
TGGGGAATATTGCACAATGGGGGAAACCCTGATGCAGCGACGCCGCGTGAGTGAAGAAGTACTTCGGTATGTAAAGCTCTATCAGCAGGGAAGAAAATGACGGTACCTGAGTAAGAAGCCCCGGCTAACTACGTGCCAGCAGCCGCGGTA	TGGGGAATATTGCACAATGGGGGAAACCCTGATGCAGCGACGCCGCGTGAGTGAAGAAGTACTTCGGTATGTAAAGCTCTATCAGCAGGGAAGAAAATGACGGTACCTGAGTAAGAAGCCCCGGCTAACTACGTGCCAGCAGCCGCGGTA	0.0
TGGGGAATATTGCGCAATGGGGGGAACCCTGACGCAGCCATGCCGCGTGAATGAAGAAGGCCTTCGGGTTGTAAAGTTCTTTCGGTATTGAGGAAGGTTGGTGTGTTAATAGCACATCAAATTGACGTTAAATACAGAAGAAGCACCGGC	TGGGGAATATTGCGCAATGGGGGGAACCCTGACGCAGCCATGCCGCGTGAATGAAGAAGGCCTTCGGGTTGTAAAGTTCTTTCGGTATTGAGGAAGGTTGGTGTGTTAATAGCACATCAAATTGACGTTAAATACAGAAGAAGCACCGGC	0.0
TGGGGAATATTGGACAATGGACCAAAAGTCTGATCCAGCAATTCTGTGTGCACGATGACGTTTTTCGGAATGTAAAGTGCTTTCAGTTGGGAAGAAAAAAATGACGGTACCAACAGAAGAAGTGACGGCTAAATACGTGCCAGCAGCCGC	TGGGGAATATTGGACAATGGACCAAAAGTCTGATCCAGCAATTCTGTGTGCACGATGACGTTTTTCGGAATGTAAAGTGCTTTCAGTTGGGAAGAAAAAAATGACGGTACCAACAGAAGAAGTGACGGCTAAATACGTGCCAGCAGCCGC	0.0
TGGGGAATATTGGACAATGGACCGAGAGTCTGATCCAGCAATTCTGTGTGCACGATGAAGTTTTTCGGAATGTAAAGTGCTTTCAGTTGGGAAGAAAAAATGACGGTACCAACAGAAGAAGTGACGGCTAAATACGTGCCAGCAGCCGCG	TGGGGAATATTGGACAATGGACCGAGAGTCTGATCCAGCAATTCTGTGTGCACGATGAAGTTTTTCGGAATGTAAAGTGCTTTCAGTTGGGAAGAAAAAATGACGGTACCAACAGAAGAAGTGACGGCTAAATACGTGCCAGCAGCCGCG	0.0
TGGGGAATATTGGACAATGGAGGGAACTCTGATCCAGCAATTCTGTGTGCACGAAGAAGGTTTTCGGATTGTAAAGTGCTTTCAGTAGGGAAGAAGAAAGTGACGGTACCTACAGAAGAAGCGACGGCTAAATACGTGCCAGCAGCCGCG	TGGGGAATATTGGACAATGGAGGGAACTCTGATCCAGCAATTCTGTGTGCACGAAGAAGGTTTTCGGATTGTAAAGTGCTTTCAGTAGGGAAGAAGAAAGTGACGGTACCTACAGAAGAAGCGACGGCTAAATACGTGCCAGCAGCCGCG	0.0
TGGGGAATATTGGACAATGGGCGCAAGCCTGATCCAGCCATGCCGCGTGAGTGATGAAGGCCCTAGGGTTGTAAAGCTCTTTTGTGCGGGAAGATAATGACGGTACCGCAAGAATAAGCCCCGGCTAACTTCGTGCCAGCAGCCGCGGTA	TGGGGAATATTGGACAATGGGCGCAAGCCTGATCCAGCCATGCCGCGTGAGTGATGAAGGCCCTAGGGTTGTAAAGCTCTTTTGTGCGGGAAGATAATGACGGTACCGCAAGAATAAGCCCCGGCTAACTTCGTGCCAGCAGCCGCGGTA	0.0
TGGGGAATATTGGACAATGGGGGCAACCCTGATCCAGCAATGCCGCGTGTGTGAAGAAGGCCTTCGGGTTGTAAAGCACTTTCAGCAGGGAGGAAAGCATCATGATTAACACCCATGGTAGTGACGTTACCTGCAGAAGAAGCACCGGCT	TGGGGAATATTGGACAATGGGGGCAACCCTGATCCAGCAATGCCGCGTGTGTGAAGAAGGCCTTCGGGTTGTAAAGCACTTTCAGCAGGGAGGAAAGCATCATGATTAACACCCATGGTAGTGACGTTACCTGCAGAAGAAGCACCGGCT	0.0
TGGGGAATATTGGACAATGGGGGCAACCCTGATCCAGCAATTCTGTGTGCACGAAGACGGTTTTCGGATTGTAAAGTGCTTTCAGCAGGGAAGAAGTGAGTGACGGTACCTGCAGAAGAAGCGACGGCTAAATACGTGCCAGCAGCCGCG	TGGGGAATATTGGACAATGGGGGCAACCCTGATCCAGCAATTCTGTGTGCACGAAGACGGTTTTCGGATTGTAAAGTGCTTTCAGCAGGGAAGAAGTGAGTGACGGTACCTGCAGAAGAAGCGACGGCTAAATACGTGCCAGCAGCCGCG	0.0
TGGGGAATATTGGACAATGGGGGCAACCCTGATCCAGCGACGCCGCGTGAGTGAAGAAGTATTTCGGTATGTAAAGCTCTATCGATAACGGAAGAAAATGACAAGCCGTTAAGGAAGAAGCCCCGGCTAACTACGTGCCAGCAGCCGCGG	TGGGGAATATTGGACAATGGGGGCAACCCTGATCCAGCGACGCCGCGTGAGTGAAGAAGTATTTCGGTATGTAAAGCTCTATCGATAACGGAAGAAAATGACAAGCCGTTAAGGAAGAAGCCCCGGCTAACTACGTGCCAGCAGCCGCGG	0.0
TGGGGAATCTTCCACAATGGGCGAAAGCCTGATGGAGCAACGCCGCGTGAGTGAAGAAGGTCTTCGGATCGTAAAGCTCTGTTGCACGGGACGAAAACCGGGTTTGAAAACATTGAGCCTGGGTGACGGTACTGTGCGAGGAAGCCACGG	TGGGGAATCTTCCACAATGGGCGAAAGCCTGATGGAGCAACGCCGCGTGAGTGAAGAAGGTCTTCGGATCGTAAAGCTCTGTTGCACGGGACGAAAACCGGGTTTGAAAACATTGAGCCTGGGTGACGGTACTGTGCGAGGAAGCCACGG	0.0
TGGGGAATCTTCCGCAATGGACGAAAGTCTGACGGAGCAACGCCGCGTGAGTGATGAAGGTCTTCGGATTGTAAAGCTCTGTTAATCGGGACGAAAGAGTTCTGTGTAAATAATGCAGAAAAGTGACGGTACCGGAATAGAAAGCCACGG	TGGGGAATCTTCCGCAATGGACGAAAGTCTGACGGAGCAACGCCGCGTGAGTGATGAAGGTCTTCGGATTGTAAAGCTCTGTTAATCGGGACGAAAGAGTTCTGTGTAAATAATGCAGAAAAGTGACGGTACCGGAATAGAAAGCCACGG	0.0
TGGGGAATCTTCCGCAATGGACGAAAGTCTGACGGAGCAACGCCGCGTGAGTGATGACGGCCTTCGGGTTGTAAAGCTCTGTTAATCGGGACGAAAGGTCCTCTTGCGAATAGTTAGAGGAATTGACGGTACCGGAATAGAAAGCCACGG	TGGGGAATCTTCCGCAATGGACGAAAGTCTGACGGAGCAACGCCGCGTGAGTGATGACGGCCTTCGGGTTGTAAAGCTCTGTTAATCGGGACGAAAGGTCCTCTTGCGAATAGTTAGAGGAATTGACGGTACCGGAATAGAAAGCCACGG	0.0
TGGGGAATCTTCCGCAATGGACGAAAGTCTGACGGAGCAACGCCGCGTGAGTGATGACGGCCTTCGGGTTGTAAAGCTCTGTTAATCGGGACGAAAGGTCTCCTTGCGAATAGTTAGGAGAATTGACGGTACCGGAATAGAAAGCCACGG	TGGGGAATCTTCCGCAATGGACGAAAGTCTGACGGAGCAACGCCGCGTGAGTGATGACGGCCTTCGGGTTGTAAAGCTCTGTTAATCGGGACGAAAGGTCTCCTTGCGAATAGTTAGGAGAATTGACGGTACCGGAATAGAAAGCCACGG	0.0
TGGGGAATCTTCCGCAATGGACGAAAGTCTGACGGAGCAACGCCGCGTGAGTGATGACGGCCTTCGGGTTGTAAAGCTCTGTTAATCGGGACGAAAGGTCTTCTTGCGAATAGTTAGAAGAATTGACGGTACCGGAATAGAAAGCCACGG	TGGGGAATCTTCCGCAATGGACGAAAGTCTGACGGAGCAACGCCGCGTGAGTGATGACGGCCTTCGGGTTGTAAAGCTCTGTTAATCGGGACGAAAGGTCTTCTTGCGAATAGTTAGAAGAATTGACGGTACCGGAATAGAAAGCCACGG	0.0
TGGGGAATCTTCCGCAATGGGCGAAAGCCTGACGGAGCAATGCCGCGTGAGTGAAGAAGGCCTTCGGGTTGTAAAACTCTGTCCTTATCGAAGAGAGAGTGTTGTAGTAACTGACAATACTAGGACGGTAGATGAGGAGGAAGCCCCGGC	TGGGGAATCTTCCGCAATGGGCGAAAGCCTGACGGAGCAATGCCGCGTGAGTGAAGAAGGCCTTCGGGTTGTAAAACTCTGTCCTTATCGAAGAGAGAGTGTTGTAGTAACTGACAATACTAGGACGGTAGATGAGGAGGAAGCCCCGGC	0.0
TGGGGAATCTTCCGCAATGGGCGCAAGCCTGACGGAGCAACGCCGCGTGAGTGAAGAAGGTCTTCGGATCGTAAAGCTCTGTTGACGGGGACGAACGTGCGGAGTGCGAATAGTGCTCTGTAATGACGGTACCTGTCGAGGAAGCCACGG	TGGGGAATCTTCCGCAATGGGCGCAAGCCTGACGGAGCAACGCCGCGTGAGTGAAGAAGGTCTTCGGATCGTAAAGCTCTGTTGACGGGGACGAACGTGCGGAGTGCGAATAGTGCTCTGTAATGACGGTACCTGTCGAGGAAGCCACGG	0.0
TGGGGAATTTTGGACAATGGGCGCAAGCCTGATCCAGCCATGCCGCGTGTCTGAAGAAGGCCTTCGGGTTGTAAAGGACTTTTGTCAGGGAAGAAAAGGAGTTGGTTAATACCCGACTCTGATGACGGTACCTGAAGAATAAGCACCGGC	TGGGGAATTTTGGACAATGGGCGCAAGCCTGATCCAGCCATGCCGCGTGTCTGAAGAAGGCCTTCGGGTTGTAAAGGACTTTTGTCAGGGAAGAAAAGGAGTTGGTTAATACCCGACTCTGATGACGGTACCTGAAGAATAAGCACCGGC	0.0
TGGGGAATTTTGGACAATGGGCGCAAGCCTGATCCAGCCATGCCGCGTGTCTGAAGAAGGCCTTCGGGTTGTAAAGGACTTTTGTCAGGGAAGAAAAGGCTGTTGCTAATACCGACAGTTGATGACGGTACCTGAAGAATAAGCACCGGC	TGGGGAATTTTGGACAATGGGCGCAAGCCTGATCCAGCCATGCCGCGTGTCTGAAGAAGGCCTTCGGGTTGTAAAGGACTTTTGTCAGGGAAGAAAAGGCTGTTGCTAATACCGACAGTTGATGACGGTACCTGAAGAATAAGCACCGGC	0.0
TGGGGAATTTTGGACAATGGGGGCAACCCTGATCCAGCCATGCCGCGTGTCTGAAGAAGGCCTTCGGGTTGTAAAGGACTTTTGTTAGGGAAGAAAAGGGAAGTGCTAATACCACTTTTTGCTGACGGTACCTAAAGAATAAGCACCGGC	TGGGGAATTTTGGACAATGGGGGCAACCCTGATCCAGCCATGCCGCGTGTCTGAAGAAGGCCTTCGGGTTGTAAAGGACTTTTGTTAGGGAAGAAAAGGGAAGTGCTAATACCACTTTTTGCTGACGGTACCTAAAGAATAAGCACCGGC	0.0
