	sequence	group
AACATAGGGGGCAAGCGTTGTCCGGAATCACTGGGCGTAAAGGGCGCGTAGGCGGTCTGTTAAGTCGGATGTGAAATGTAAGGGCTCAACCCTTAACGTGCATCCGATACTGGCAGACTTGAGTGCGGAAGAGGCAAGTGGAATTCCTAG	AACATAGGGGGCAAGCGTTGTCCGGAATCACTGGGCGTAAAGGGCGCGTAGGCGGTCTGTTAAGTCGGATGTGAAATGTAAGGGCTCAACCCTTAACGTGCATCCGATACTGGCAGACTTGAGTGCGGAAGAGGCAAGTGGAATTCCTAG	1.0
AACGTAGGGTGCGAGCGTTGTCCGGAATTACTGGGTGTAAAGGGAGCGTAGGCGGCTCAGCAAGTTGGGAGTATAATCTATGGGCTCAACCCATAGTCGCTTTCAAAACTGCAGGGCTTGAGTGAAGTAGAGGTAGGCGGAATTTCCGGT	AACGTAGGGTGCGAGCGTTGTCCGGAATTACTGGGTGTAAAGGGAGCGTAGGCGGCTCAGCAAGTTGGGAGTATAATCTATGGGCTCAACCCATAGTCGCTTTCAAAACTGCAGGGCTTGAGTGAAGTAGAGGTAGGCGGAATTTCCGGT	1.0
AACGTAGGGTGCTAGCGTTGTCCGGAATTACTGGGTGTAAAGGGAGCGCAGGCGGTTCTGCAAGTTGGACGTTTAATCTACGGGCTCAACCCGTATCAGCGTTCAAAACTGCAGGACTTGAGTGAAGTAGAGGTAGGCGGAATTTCCGGT	AACGTAGGGTGCTAGCGTTGTCCGGAATTACTGGGTGTAAAGGGAGCGCAGGCGGTTCTGCAAGTTGGACGTTTAATCTACGGGCTCAACCCGTATCAGCGTTCAAAACTGCAGGACTTGAGTGAAGTAGAGGTAGGCGGAATTTCCGGT	1.0
AACGTAGGTCACAAGCGTTGTCCGGAATTACTGGGTGTAAAGGGAGCGCAGGCGGGAAGACAAGTTGGAAGTGAAATCTATGGGCTCAACCCATAAACTGCTTTCAAAACTGTTTTTCTTGAGTAGTGCAGAGGTAGGCGGAATTCCCGG	AACGTAGGTCACAAGCGTTGTCCGGAATTACTGGGTGTAAAGGGAGCGCAGGCGGGAAGACAAGTTGGAAGTGAAATCTATGGGCTCAACCCATAAACTGCTTTCAAAACTGTTTTTCTTGAGTAGTGCAGAGGTAGGCGGAATTCCCGG	1.0
AACGTAGGTGGCAAGCGTTGTCCGGAATTACTGGGTGTAAAGGGAGCGCAGGCGGGTCTGCAAGTTGGAAGTGAAACTCATGGGCTCAACCCATGAACTGCTTTCAAAACTGCGGATCTTGAGTGGTGTAGAGGTAGGCGGAATTCCCGG	AACGTAGGTGGCAAGCGTTGTCCGGAATTACTGGGTGTAAAGGGAGCGCAGGCGGGTCTGCAAGTTGGAAGTGAAACTCATGGGCTCAACCCATGAACTGCTTTCAAAACTGCGGATCTTGAGTGGTGTAGAGGTAGGCGGAATTCCCGG	1.0
CACGTAGGGGGCGAGCGTTATCCGGATTCATTGGGCGTAAAGCGCGCGCAGGCGGCCGCTCAAGCGGGACCTCTAATCCCGGGGCTCAACCCCGGGCCGGGTCCCGAACTGGGCGGCTCGCTCCAGGTAGGGGCAGGCGGAATTCCCGGT	CACGTAGGGGGCGAGCGTTATCCGGATTCATTGGGCGTAAAGCGCGCGCAGGCGGCCGCTCAAGCGGGACCTCTAATCCCGGGGCTCAACCCCGGGCCGGGTCCCGAACTGGGCGGCTCGCTCCAGGTAGGGGCAGGCGGAATTCCCGGT	1.0
TACCGGCAGCTCAAGTGGTATCTGTTTTTATTGGGCCTAAAGCGTTCGTAGCCGGTTTAATAAGTCTTTGGTGAAAGCTTGTAGCTTAACTATAAGAATTGCTGGAGATACTATTAGACTTGAAGTCGGGAGAGGTTAGAGGTACTACCG	TACCGGCAGCTCAAGTGGTATCTGTTTTTATTGGGCCTAAAGCGTTCGTAGCCGGTTTAATAAGTCTTTGGTGAAAGCTTGTAGCTTAACTATAAGAATTGCTGGAGATACTATTAGACTTGAAGTCGGGAGAGGTTAGAGGTACTACCG	1.0
TACGAAGGTGACAAGCGTTATCCGGAATTATTGGGCGTAAAGGGTGCGCAGGCGGTTTGCTAAGTTTAAGCTTAAATTGTGGGGCTCAACCCCATCCAGGCTTAGAAACTGGTGAACTAGAGTGCAGAAGGGGCAAGTGGAATTCCATGT	TACGAAGGTGACAAGCGTTATCCGGAATTATTGGGCGTAAAGGGTGCGCAGGCGGTTTGCTAAGTTTAAGCTTAAATTGTGGGGCTCAACCCCATCCAGGCTTAGAAACTGGTGAACTAGAGTGCAGAAGGGGCAAGTGGAATTCCATGT	1.0
TACGGAAGGTCCGGGCGTTATCCGGATTTATTGGGTTTAAAGGGAGCGCAGGCGGACTCTTAAGTCAGTTGTGAAATACGGCGGCTCAACCGTCGGACTGCAGTTGATACTGGGAGTCTTGAGTACACGCAGAGATACTGGAATTCATGG	TACGGAAGGTCCGGGCGTTATCCGGATTTATTGGGTTTAAAGGGAGCGCAGGCGGACTCTTAAGTCAGTTGTGAAATACGGCGGCTCAACCGTCGGACTGCAGTTGATACTGGGAGTCTTGAGTACACGCAGAGATACTGGAATTCATGG	1.0
TACGGAAGGTCCGGGCGTTATCCGGATTTATTGGGTTTAAAGGGAGCGTAGGCCGGAGATTAAGCGTGTTGTGAAATGTAGACGCTCAACGTCTGCACTGCAGCGCGAACTGGTTTCCTTGAGTACGCACAAAGTGGGCGGAATTCGTGG	TACGGAAGGTCCGGGCGTTATCCGGATTTATTGGGTTTAAAGGGAGCGTAGGCCGGAGATTAAGCGTGTTGTGAAATGTAGACGCTCAACGTCTGCACTGCAGCGCGAACTGGTTTCCTTGAGTACGCACAAAGTGGGCGGAATTCGTGG	1.0
TACGGAAGGTCCGGGCGTTATCCGGATTTATTGGGTTTAAAGGGAGCGTAGGCCGGAGATTAAGCGTGTTGTGAAATGTAGATGCTCAACATCTGAACTGCAGCGCGAACTGGTTTCCTTGAGTACGCACAAAGTGGGCGGAATTCGTGG	TACGGAAGGTCCGGGCGTTATCCGGATTTATTGGGTTTAAAGGGAGCGTAGGCCGGAGATTAAGCGTGTTGTGAAATGTAGATGCTCAACATCTGAACTGCAGCGCGAACTGGTTTCCTTGAGTACGCACAAAGTGGGCGGAATTCGTGG	1.0
TACGGAAGGTTCGGGCGTTATCCGGATTTATTGGGTTTAAAGGGAGCGCAGGCGGACTCTTAAGTCAGTTGTGAAATACGGCGGCTCAACCGTCGGACTGCAGTTGATACTGGGAGTCTTGAGTACACGCAGAGATACTGGAATTCATGG	TACGGAAGGTTCGGGCGTTATCCGGATTTATTGGGTTTAAAGGGAGCGCAGGCGGACTCTTAAGTCAGTTGTGAAATACGGCGGCTCAACCGTCGGACTGCAGTTGATACTGGGAGTCTTGAGTACACGCAGAGATACTGGAATTCATGG	1.0
TACGGAGGATCCGAGCGTTATCCGGATTTATTGGGTTTAAAGGGAGCGTAGATGGATGTTTAAGTCAGTTGTGAAAGTTTGCGGCTCAACCGTAAAATTGCAGTTGATACTGGATATCTTGAGTGCAGTTGAGGCAGGCGGAATTCGTGG	TACGGAGGATCCGAGCGTTATCCGGATTTATTGGGTTTAAAGGGAGCGTAGATGGATGTTTAAGTCAGTTGTGAAAGTTTGCGGCTCAACCGTAAAATTGCAGTTGATACTGGATATCTTGAGTGCAGTTGAGGCAGGCGGAATTCGTGG	1.0
TACGGAGGATCCGAGCGTTATCCGGATTTATTGGGTTTAAAGGGAGCGTAGGTGGATTGTTAAGTCAGTTGTGAAAGTTTGCGGCTCAACCGTAAAATTGCAGTTGAAACTGGCAGTCTTGAGTACAGTAGAGGTGGGCGGAATTCGTGG	TACGGAGGATCCGAGCGTTATCCGGATTTATTGGGTTTAAAGGGAGCGTAGGTGGATTGTTAAGTCAGTTGTGAAAGTTTGCGGCTCAACCGTAAAATTGCAGTTGAAACTGGCAGTCTTGAGTACAGTAGAGGTGGGCGGAATTCGTGG	1.0
TACGGAGGATGCGAGCGTTATCCGGATTTATTGGGTTTAAAGGGAGCGCAGACGGGTTTTTAAGTCAGCTGTGAAAGTTTGGGGCTCAACCTTAAAATTGCAGTTGATACTGGAGACCTTGAGTGCAGTTGAGGCAGGCGGAATTCGTGG	TACGGAGGATGCGAGCGTTATCCGGATTTATTGGGTTTAAAGGGAGCGCAGACGGGTTTTTAAGTCAGCTGTGAAAGTTTGGGGCTCAACCTTAAAATTGCAGTTGATACTGGAGACCTTGAGTGCAGTTGAGGCAGGCGGAATTCGTGG	1.0
TACGGAGGATGCGAGCGTTATCCGGATTTATTGGGTTTAAAGGGTGCGCAGGCGGCCCGACAAGCCGGCGGTCAAATCGCGGGGCTCAACCCCGTCCAGCCGTCGGAACTGCCGGGCTAGAGTGGGCGAGAAGTGCGCGGAATGCGTGGT	TACGGAGGATGCGAGCGTTATCCGGATTTATTGGGTTTAAAGGGTGCGCAGGCGGCCCGACAAGCCGGCGGTCAAATCGCGGGGCTCAACCCCGTCCAGCCGTCGGAACTGCCGGGCTAGAGTGGGCGAGAAGTGCGCGGAATGCGTGGT	1.0
TACGGAGGATGCGAGCGTTATCCGGATTTATTGGGTTTAAAGGGTGCGCAGGCGGCGTGCCAAGTCAGCGGTAAAAATGCGGTGCTCAACGCCGTATAGCCGTTGAAACTGACATGCTAGAGTGAGCGAGAAGTATGCGGAATGCGTGGT	TACGGAGGATGCGAGCGTTATCCGGATTTATTGGGTTTAAAGGGTGCGCAGGCGGCGTGCCAAGTCAGCGGTAAAAATGCGGTGCTCAACGCCGTATAGCCGTTGAAACTGACATGCTAGAGTGAGCGAGAAGTATGCGGAATGCGTGGT	1.0
TACGGAGGATGCGAGCGTTATCCGGATTTATTGGGTTTAAAGGGTGCGTAGGCGGAACGCCAAGTCAGCGGTAAAATTTCGGGGCTCAACCCCGTCGTGCCGTTGAAACTGGTGTCCTTGAGTGGGCGAGAAGTATGCGGAATGCGTGGT	TACGGAGGATGCGAGCGTTATCCGGATTTATTGGGTTTAAAGGGTGCGTAGGCGGAACGCCAAGTCAGCGGTAAAATTTCGGGGCTCAACCCCGTCGTGCCGTTGAAACTGGTGTCCTTGAGTGGGCGAGAAGTATGCGGAATGCGTGGT	1.0
TACGGAGGATGCGAGCGTTATCCGGATTTATTGGGTTTAAAGGGTGCGTAGGCGGACTGTCAAGTCAGCGGTAAAATACGGGGGCTCAACCTCCGCCCGCCGTTGAAACTGACGGTCTTGAGTGGGCGAGAAGTATGCGGAATGCGTGGT	TACGGAGGATGCGAGCGTTATCCGGATTTATTGGGTTTAAAGGGTGCGTAGGCGGACTGTCAAGTCAGCGGTAAAATACGGGGGCTCAACCTCCGCCCGCCGTTGAAACTGACGGTCTTGAGTGGGCGAGAAGTATGCGGAATGCGTGGT	1.0
TACGGAGGATGCGAGCGTTATCCGGATTTATTGGGTTTAAAGGGTGCGTAGGCGGCGATGCAAGTCAGCGGTAAAAGCCCGGGGCTCAACCCCGGCGAGCCGTTGAAACTGCAGTGCTAGAGAAGGCGAGAGGTACGCGGAATGCGCAGT	TACGGAGGATGCGAGCGTTATCCGGATTTATTGGGTTTAAAGGGTGCGTAGGCGGCGATGCAAGTCAGCGGTAAAAGCCCGGGGCTCAACCCCGGCGAGCCGTTGAAACTGCAGTGCTAGAGAAGGCGAGAGGTACGCGGAATGCGCAGT	1.0
TACGGAGGGGGCAAGCGTTATCCGGAATTATTGGGCGTAAAGGGTACGTAGGTGGTTTACCAAGCGCAGGGTTTAAGGCAATGGCTCAACCATTGTTCGCCCTGCGAACTGGCAAACTTGAGTGCAGGAGAGGAAAGCGGAATTCCTAGT	TACGGAGGGGGCAAGCGTTATCCGGAATTATTGGGCGTAAAGGGTACGTAGGTGGTTTACCAAGCGCAGGGTTTAAGGCAATGGCTCAACCATTGTTCGCCCTGCGAACTGGCAAACTTGAGTGCAGGAGAGGAAAGCGGAATTCCTAGT	1.0
TACGGAGGGTGCAAGCGTTAATCGGAATTACTGGGCGTAAAGCGCACGCAGGCGGTCTGTCAAGTCGGATGTGAAATCCCCGGGCTCAACCTGGGAACTGCATTCGAAACTGGCAGGCTAGAGTCTTGTAGAGGGGGGTAGAATTCCAGG	TACGGAGGGTGCAAGCGTTAATCGGAATTACTGGGCGTAAAGCGCACGCAGGCGGTCTGTCAAGTCGGATGTGAAATCCCCGGGCTCAACCTGGGAACTGCATTCGAAACTGGCAGGCTAGAGTCTTGTAGAGGGGGGTAGAATTCCAGG	1.0
TACGGAGGGTGCAAGCGTTAATCGGAATTACTGGGCGTAAAGCGCACGCAGGCGGTTGGATAAGTTAGATGTGAAAGCCCCGGGCTCAACCTGGGAATTGCATTTAAAACTGTCCAGCTAGAGTCTTGTAGAGGGGGGTAGAATTCCAGG	TACGGAGGGTGCAAGCGTTAATCGGAATTACTGGGCGTAAAGCGCACGCAGGCGGTTGGATAAGTTAGATGTGAAAGCCCCGGGCTCAACCTGGGAATTGCATTTAAAACTGTCCAGCTAGAGTCTTGTAGAGGGGGGTAGAATTCCAGG	1.0
TACGTAAGGGGCAAGCGTTATCCGGATTTACTGGGTGTAAAGGGAGCGTAGACGGAATGGCAAGTCTGATGTGAAAGGCAGGGGCTTAACCCCTGGACTGCATTGGAAACTGTCAGTCTAGAGTGCCGGAGAGGTAAGCGGAATTCCTAG	TACGTAAGGGGCAAGCGTTATCCGGATTTACTGGGTGTAAAGGGAGCGTAGACGGAATGGCAAGTCTGATGTGAAAGGCAGGGGCTTAACCCCTGGACTGCATTGGAAACTGTCAGTCTAGAGTGCCGGAGAGGTAAGCGGAATTCCTAG	1.0
TACGTAGGGAGCAAGCGTTATCCGGATTTACTGGGTGTAAAGGGCGTGTAGGCGGGAAAGCAAGTCAGATGTGAAACCCAGTGGCTCAACCACTGGCCTGCATTTGAAACTGTTTTTCTTGAGTGATGGAGAGGCAGGCGGAATTCCGTG	TACGTAGGGAGCAAGCGTTATCCGGATTTACTGGGTGTAAAGGGCGTGTAGGCGGGAAAGCAAGTCAGATGTGAAACCCAGTGGCTCAACCACTGGCCTGCATTTGAAACTGTTTTTCTTGAGTGATGGAGAGGCAGGCGGAATTCCGTG	1.0
TACGTAGGGAGCAAGCGTTATCCGGATTTACTGGGTGTAAAGGGCGTGTAGGCGGGCTTGCAAGTTGGAAGTGAAATCCAGGGGCTTAACCCCTGAACTGCTTTCAAAACTGCGAGTCTTGAGTGATGGAGAGGCAGGCGGAATTCCCAG	TACGTAGGGAGCAAGCGTTATCCGGATTTACTGGGTGTAAAGGGCGTGTAGGCGGGCTTGCAAGTTGGAAGTGAAATCCAGGGGCTTAACCCCTGAACTGCTTTCAAAACTGCGAGTCTTGAGTGATGGAGAGGCAGGCGGAATTCCCAG	1.0
TACGTAGGGAGCAAGCGTTATCCGGATTTACTGGGTGTAAAGGGTGCGCAGGCGGCCAAGCAAGTCAGAAGTGAAATTCCGAGGCTCAACTTCGGAGCTGCTTTTGAAACTGCTAGGCTAGAGTGTGGGAGAGGAAAGTAGAACTTTGAG	TACGTAGGGAGCAAGCGTTATCCGGATTTACTGGGTGTAAAGGGTGCGCAGGCGGCCAAGCAAGTCAGAAGTGAAATTCCGAGGCTCAACTTCGGAGCTGCTTTTGAAACTGCTAGGCTAGAGTGTGGGAGAGGAAAGTAGAACTTTGAG	1.0
TACGTAGGGAGCAAGCGTTATCCGGATTTACTGGGTGTAAAGGGTGCGTAGGCGGCCTTTTAAGTCGGAAGTGAAATTTCGGGGCTCAACCCCGGAGCTGCTACCGAAACTGAGAGGCTAGAGTGTGGGAGAGGAAAGTGGAACTTTGAG	TACGTAGGGAGCAAGCGTTATCCGGATTTACTGGGTGTAAAGGGTGCGTAGGCGGCCTTTTAAGTCGGAAGTGAAATTTCGGGGCTCAACCCCGGAGCTGCTACCGAAACTGAGAGGCTAGAGTGTGGGAGAGGAAAGTGGAACTTTGAG	1.0
TACGTAGGGAGCAAGCGTTATCCGGATTTATTGGGTGTAAAGGGTGCGTAGACGGGAAGGTAAGTTAGTTGTGAAATCCCTCGGCTCAACTGAGGAACTGCGACTAAAACTGCTTTTCTTGAGTACTGGAGAGGAAAGTGGAATTCCTAG	TACGTAGGGAGCAAGCGTTATCCGGATTTATTGGGTGTAAAGGGTGCGTAGACGGGAAGGTAAGTTAGTTGTGAAATCCCTCGGCTCAACTGAGGAACTGCGACTAAAACTGCTTTTCTTGAGTACTGGAGAGGAAAGTGGAATTCCTAG	1.0
TACGTAGGGAGCAAGCGTTATCCGGATTTATTGGGTGTAAAGGGTGCGTAGACGGGAAGGTAAGTTAGTTGTGAAATCCCTCGGCTCAACTGAGGAACTGCGACTAAAACTGCTTTTCTTGAGTGCTGGAGAGGAAAGTGGAATTCCTAG	TACGTAGGGAGCAAGCGTTATCCGGATTTATTGGGTGTAAAGGGTGCGTAGACGGGAAGGTAAGTTAGTTGTGAAATCCCTCGGCTCAACTGAGGAACTGCGACTAAAACTGCTTTTCTTGAGTGCTGGAGAGGAAAGTGGAATTCCTAG	1.0
TACGTAGGGAGCAAGCGTTATCCGGATTTATTGGGTGTAAAGGGTGCGTAGACGGGAATGCAAGTTGGTTGTGAAATCCCTCGGCTCAACCGAGGAATTGCAACCAAAACTATATTTCTTGAGTGCTGGAGAGGAAAGTGGAATTCCTAG	TACGTAGGGAGCAAGCGTTATCCGGATTTATTGGGTGTAAAGGGTGCGTAGACGGGAATGCAAGTTGGTTGTGAAATCCCTCGGCTCAACCGAGGAATTGCAACCAAAACTATATTTCTTGAGTGCTGGAGAGGAAAGTGGAATTCCTAG	1.0
TACGTAGGGAGCAAGCGTTATCCGGATTTATTGGGTGTAAAGGGTGCGTAGACGGTAATGCAAGTTAGTTGTGAAATCCCTCGGCTTAACTGAGGAACTGCAACTAAAACTACATTTCTTGAGTATTGGAGGGGAAAGTGGAATTCCTAG	TACGTAGGGAGCAAGCGTTATCCGGATTTATTGGGTGTAAAGGGTGCGTAGACGGTAATGCAAGTTAGTTGTGAAATCCCTCGGCTTAACTGAGGAACTGCAACTAAAACTACATTTCTTGAGTATTGGAGGGGAAAGTGGAATTCCTAG	1.0
TACGTAGGGAGCGAGCGTTATCCGGATTCATTGGGCGTAAAGCGCGCGTAGGCGGTCCGTTAAGCGGTTATGTCAAAACCGGGGGCTCAACCCGCGGTCGCATTCCGAACTGGCGGACTCGAGTTCGGTAGAGGAAGACGGAATTCCCGG	TACGTAGGGAGCGAGCGTTATCCGGATTCATTGGGCGTAAAGCGCGCGTAGGCGGTCCGTTAAGCGGTTATGTCAAAACCGGGGGCTCAACCCGCGGTCGCATTCCGAACTGGCGGACTCGAGTTCGGTAGAGGAAGACGGAATTCCCGG	1.0
TACGTAGGGAGCGAGCGTTATCCGGATTTATTGGGTGTAAAGGGTGCGTAGACGGGAAAGCAAGTTAGCTGTGAAATCCCTCGGCTTAACTGAGGAACTGCAGCTAAAACTACTATTCTTGAGTGCTGGAGAGGAAAGTGGAATTCCTAG	TACGTAGGGAGCGAGCGTTATCCGGATTTATTGGGTGTAAAGGGTGCGTAGACGGGAAAGCAAGTTAGCTGTGAAATCCCTCGGCTTAACTGAGGAACTGCAGCTAAAACTACTATTCTTGAGTGCTGGAGAGGAAAGTGGAATTCCTAG	1.0
TACGTAGGGAGCGAGCGTTATCCGGATTTATTGGGTGTAAAGGGTGCGTAGACGGGAATATAAGTTAGTTGTGAAATCCCTCGGCTTAACTGAGGAACTGCAACTAAAACTGTATTTCTTGAGTACTGGAGAGGAAAGTGGAATTCCTAG	TACGTAGGGAGCGAGCGTTATCCGGATTTATTGGGTGTAAAGGGTGCGTAGACGGGAATATAAGTTAGTTGTGAAATCCCTCGGCTTAACTGAGGAACTGCAACTAAAACTGTATTTCTTGAGTACTGGAGAGGAAAGTGGAATTCCTAG	1.0
TACGTAGGGAGCGAGCGTTATCCGGATTTATTGGGTGTAAAGGGTGCGTAGACGGGATAGCAAGTTAGCTGTGAAATCCCTCGGCTTAACTGAGGAACTGCAACTAAAACTACTATTCTTGAGTGCTGGAGAGGAAAGTGGAATTCCTAG	TACGTAGGGAGCGAGCGTTATCCGGATTTATTGGGTGTAAAGGGTGCGTAGACGGGATAGCAAGTTAGCTGTGAAATCCCTCGGCTTAACTGAGGAACTGCAACTAAAACTACTATTCTTGAGTGCTGGAGAGGAAAGTGGAATTCCTAG	1.0
TACGTAGGGAGCGAGCGTTGTCCGGAATTACTGGGTGTAAAGGGAGCGTAGGCGGGAAAGCAAGTTGGAAGTGAAATGCATGGGCTCAACCCATGAGCTGCTTTCAAAACTGTTTTTCTTGAGTGAAGTAGAGGCAGGCGGAATTCCTAG	TACGTAGGGAGCGAGCGTTGTCCGGAATTACTGGGTGTAAAGGGAGCGTAGGCGGGAAAGCAAGTTGGAAGTGAAATGCATGGGCTCAACCCATGAGCTGCTTTCAAAACTGTTTTTCTTGAGTGAAGTAGAGGCAGGCGGAATTCCTAG	1.0
TACGTAGGGGACAAGCGTTGTCCGGAATGACTGGGCGTAAAGGGCGCGTAGGCGGTTTATTAAGTCTGATGTGAAAGGTACCGGCTCAACCGGTGAAGTGCATTGGAAACTGGTAGACTTGAGTATTGGAGAGGCAAGTGGAATTCCTAG	TACGTAGGGGACAAGCGTTGTCCGGAATGACTGGGCGTAAAGGGCGCGTAGGCGGTTTATTAAGTCTGATGTGAAAGGTACCGGCTCAACCGGTGAAGTGCATTGGAAACTGGTAGACTTGAGTATTGGAGAGGCAAGTGGAATTCCTAG	1.0
TACGTAGGGGACGAGCGTTGTCCGGAATGACTGGGCGTAAAGGGCGCGTAGGCGGTTTATTAAGTCTGATGTGAAAGGTACCGGCTCAACCGGTGAAGTGCATTGGAAACTGGTAGACTTGAGTATTGGAGAGGCAAGTGGAATTCCTAG	TACGTAGGGGACGAGCGTTGTCCGGAATGACTGGGCGTAAAGGGCGCGTAGGCGGTTTATTAAGTCTGATGTGAAAGGTACCGGCTCAACCGGTGAAGTGCATTGGAAACTGGTAGACTTGAGTATTGGAGAGGCAAGTGGAATTCCTAG	1.0
TACGTAGGGGGCAAGCGTTATCCGGAATTACTGGGTGTAAAGGGAGCGTAGGCGGCACGTCAAGCCAGATGTGAAAGCCCGGGGCTTAACCCCGCGGATTGCATTTGGAACTGGCGAGCTAGAGTACAGGAGAGGAAAGCGGAATTCCTA	TACGTAGGGGGCAAGCGTTATCCGGAATTACTGGGTGTAAAGGGAGCGTAGGCGGCACGTCAAGCCAGATGTGAAAGCCCGGGGCTTAACCCCGCGGATTGCATTTGGAACTGGCGAGCTAGAGTACAGGAGAGGAAAGCGGAATTCCTA	1.0
TACGTAGGGGGCAAGCGTTATCCGGAATTACTGGGTGTAAAGGGTGAGTAGGCGGCATGGCAAGTAAGATGTGAAAGCCCGAGGCTTAACCTCGGGATTGCATTTTAAACTGCTAAGCTAGAGTACAGGAGAGGAAAGCGGAATTCCTAG	TACGTAGGGGGCAAGCGTTATCCGGAATTACTGGGTGTAAAGGGTGAGTAGGCGGCATGGCAAGTAAGATGTGAAAGCCCGAGGCTTAACCTCGGGATTGCATTTTAAACTGCTAAGCTAGAGTACAGGAGAGGAAAGCGGAATTCCTAG	1.0
TACGTAGGGGGCAAGCGTTATCCGGAATTATTGGGCGTAAAGAGTACGTAGGCGGTCTTTTAAGCGCAGGGTATAAGGCAAGGGCTTAACCTTTGTTGGCCCTGTGAACTGGAGGACTTGAGTATCGGAGAGGGAAGCGGAATTCCTAGT	TACGTAGGGGGCAAGCGTTATCCGGAATTATTGGGCGTAAAGAGTACGTAGGCGGTCTTTTAAGCGCAGGGTATAAGGCAAGGGCTTAACCTTTGTTGGCCCTGTGAACTGGAGGACTTGAGTATCGGAGAGGGAAGCGGAATTCCTAGT	1.0
TACGTAGGGGGCAAGCGTTATCCGGAATTATTGGGCGTAAAGAGTGCGTAGGTGGTAACCTAAGCGCAGGGTTTAAGGCAATGGCCCAACCATTGTATGCCCTGCGAACTGGGCTACTTGAGTGCAGGAGAGGAAAGCGGAATTCCTAGT	TACGTAGGGGGCAAGCGTTATCCGGAATTATTGGGCGTAAAGAGTGCGTAGGTGGTAACCTAAGCGCAGGGTTTAAGGCAATGGCCCAACCATTGTATGCCCTGCGAACTGGGCTACTTGAGTGCAGGAGAGGAAAGCGGAATTCCTAGT	1.0
TACGTAGGGGGCAAGCGTTATCCGGATTTACTGGGTGTAAAGGGAGCGTAGACGGAACAGCAAGTCTGAAGTGAAATCATAGGGCTCAACCCTGTAACTGCTTTGGAAACTGTTGATCTTGAGTACCGGAGGGGTAGGCGGAATTCCTGG	TACGTAGGGGGCAAGCGTTATCCGGATTTACTGGGTGTAAAGGGAGCGTAGACGGAACAGCAAGTCTGAAGTGAAATCATAGGGCTCAACCCTGTAACTGCTTTGGAAACTGTTGATCTTGAGTACCGGAGGGGTAGGCGGAATTCCTGG	1.0
TACGTAGGGGGCAAGCGTTATCCGGATTTACTGGGTGTAAAGGGAGCGTAGACGGAAGTGCAAGTCTGATGTGAAAACCCGAGGCTCAACCACGGGACTGCATTGGAAACTGTGCTTCTAGAGTGCCGGAGAGGTAAGCGGAATTCCTAG	TACGTAGGGGGCAAGCGTTATCCGGATTTACTGGGTGTAAAGGGAGCGTAGACGGAAGTGCAAGTCTGATGTGAAAACCCGAGGCTCAACCACGGGACTGCATTGGAAACTGTGCTTCTAGAGTGCCGGAGAGGTAAGCGGAATTCCTAG	1.0
TACGTAGGGGGCAAGCGTTATCCGGATTTACTGGGTGTAAAGGGAGCGTAGACGGAATGGCAAGTCTGATGTGAAAGGCAGGGGCTCAACCCCTGGACTGCATTGGAAACTGTCAGTCTTGAGTACCGGAGGGGTAAGCGGAATTCCTAG	TACGTAGGGGGCAAGCGTTATCCGGATTTACTGGGTGTAAAGGGAGCGTAGACGGAATGGCAAGTCTGATGTGAAAGGCAGGGGCTCAACCCCTGGACTGCATTGGAAACTGTCAGTCTTGAGTACCGGAGGGGTAAGCGGAATTCCTAG	1.0
TACGTAGGGGGCAAGCGTTATCCGGATTTACTGGGTGTAAAGGGAGCGTAGACGGACTGGCAAGTCTGATGTGAAAACCCGGGGCTCAACCCCGGGACTGCATTGGAAACTGTCAGTCTAGAGTGTCGGAGGGGTAAGTGGAATTCCTAG	TACGTAGGGGGCAAGCGTTATCCGGATTTACTGGGTGTAAAGGGAGCGTAGACGGACTGGCAAGTCTGATGTGAAAACCCGGGGCTCAACCCCGGGACTGCATTGGAAACTGTCAGTCTAGAGTGTCGGAGGGGTAAGTGGAATTCCTAG	1.0
TACGTAGGGGGCAAGCGTTATCCGGATTTACTGGGTGTAAAGGGAGCGTAGACGGAGCAGCAAGTCTGATGTGAAAGGCAGGGGCTCAACCCCTGGACTGCATTGGAAACTGTTGATCTTGAGTACCGGAGGGGTAAGCGGAATTCCTAG	TACGTAGGGGGCAAGCGTTATCCGGATTTACTGGGTGTAAAGGGAGCGTAGACGGAGCAGCAAGTCTGATGTGAAAGGCAGGGGCTCAACCCCTGGACTGCATTGGAAACTGTTGATCTTGAGTACCGGAGGGGTAAGCGGAATTCCTAG	1.0
TACGTAGGGGGCAAGCGTTATCCGGATTTACTGGGTGTAAAGGGAGCGTAGACGGATGTGCAAGTCTGAAGTGAAAGCCCGGGGCTCAACCCCGGGACTGCTTTGGAAACTGTGTATCTAGAGTGCCGGAGAGGTAAGCGGAATTCCCAG	TACGTAGGGGGCAAGCGTTATCCGGATTTACTGGGTGTAAAGGGAGCGTAGACGGATGTGCAAGTCTGAAGTGAAAGCCCGGGGCTCAACCCCGGGACTGCTTTGGAAACTGTGTATCTAGAGTGCCGGAGAGGTAAGCGGAATTCCCAG	1.0
TACGTAGGGGGCAAGCGTTATCCGGATTTACTGGGTGTAAAGGGAGCGTAGACGGCAAGGCAAGTCTGATGTGAAAACCCAGGGCTTAACCCTGGGACTGCATTGGAAACTGTCTGGCTCGAGTGCCGGAGAGGTAAGCGGAATTCCTAG	TACGTAGGGGGCAAGCGTTATCCGGATTTACTGGGTGTAAAGGGAGCGTAGACGGCAAGGCAAGTCTGATGTGAAAACCCAGGGCTTAACCCTGGGACTGCATTGGAAACTGTCTGGCTCGAGTGCCGGAGAGGTAAGCGGAATTCCTAG	1.0
TACGTAGGGGGCAAGCGTTATCCGGATTTACTGGGTGTAAAGGGAGCGTAGACGGCACAGCAAGTCTGAAGTGAAATCCCCGGGCTCAACCCGGGAACTGCTTTGGAAACTGTTGGGCTAGAGTGCTGGAGAGGCAAGCGGAATTCCTAG	TACGTAGGGGGCAAGCGTTATCCGGATTTACTGGGTGTAAAGGGAGCGTAGACGGCACAGCAAGTCTGAAGTGAAATCCCCGGGCTCAACCCGGGAACTGCTTTGGAAACTGTTGGGCTAGAGTGCTGGAGAGGCAAGCGGAATTCCTAG	1.0
TACGTAGGGGGCAAGCGTTATCCGGATTTACTGGGTGTAAAGGGAGCGTAGACGGCACAGCAAGTCTGAAGTGAAATCCCCGGGCTCAACCCGGGAACTGCTTTGGAAACTGTTGGGCTGGAGTGCTGGAGAGGCAAGCGGAATTCCTAG	TACGTAGGGGGCAAGCGTTATCCGGATTTACTGGGTGTAAAGGGAGCGTAGACGGCACAGCAAGTCTGAAGTGAAATCCCCGGGCTCAACCCGGGAACTGCTTTGGAAACTGTTGGGCTGGAGTGCTGGAGAGGCAAGCGGAATTCCTAG	1.0
TACGTAGGGGGCAAGCGTTATCCGGATTTACTGGGTGTAAAGGGAGCGTAGACGGCATGGCAAGCCAGATGTGAAAGCCCGGGGCTCAACCCCGGGACTGCATTTGGAACTGTCAGGCTAGAGTGTCGGAGAGGAAAGCGGAATTCCTAG	TACGTAGGGGGCAAGCGTTATCCGGATTTACTGGGTGTAAAGGGAGCGTAGACGGCATGGCAAGCCAGATGTGAAAGCCCGGGGCTCAACCCCGGGACTGCATTTGGAACTGTCAGGCTAGAGTGTCGGAGAGGAAAGCGGAATTCCTAG	1.0
TACGTAGGGGGCAAGCGTTATCCGGATTTACTGGGTGTAAAGGGAGCGTAGACGGCATGGCAAGTCTGATGTGAAAACTTGGGGCTCAACCCCAAGACTGCATTGGAAACTGTTAAGCTAGAGTGCAGGAGAGGTAAGCGGAATTCCTAG	TACGTAGGGGGCAAGCGTTATCCGGATTTACTGGGTGTAAAGGGAGCGTAGACGGCATGGCAAGTCTGATGTGAAAACTTGGGGCTCAACCCCAAGACTGCATTGGAAACTGTTAAGCTAGAGTGCAGGAGAGGTAAGCGGAATTCCTAG	1.0
TACGTAGGGGGCAAGCGTTATCCGGATTTACTGGGTGTAAAGGGAGCGTAGACGGCATGGCAAGTCTGATGTGAAAGGCAGGGGCTCAACTCCTGGACTGCATTGGAAACTGCCAGGCTTGAGTGCCGGAGGGGTAAGCGGAATTCCTAG	TACGTAGGGGGCAAGCGTTATCCGGATTTACTGGGTGTAAAGGGAGCGTAGACGGCATGGCAAGTCTGATGTGAAAGGCAGGGGCTCAACTCCTGGACTGCATTGGAAACTGCCAGGCTTGAGTGCCGGAGGGGTAAGCGGAATTCCTAG	1.0
TACGTAGGGGGCAAGCGTTATCCGGATTTACTGGGTGTAAAGGGAGCGTAGACGGCGAAGCAAGTCTGAAGTGAAAGCCCGGGGCTTAACCCCGGGACTGCTTTGGAAACTGTTTTGCTAGAGTGCTGGAGAGGTAAGTGGAATTCCTAG	TACGTAGGGGGCAAGCGTTATCCGGATTTACTGGGTGTAAAGGGAGCGTAGACGGCGAAGCAAGTCTGAAGTGAAAGCCCGGGGCTTAACCCCGGGACTGCTTTGGAAACTGTTTTGCTAGAGTGCTGGAGAGGTAAGTGGAATTCCTAG	1.0
TACGTAGGGGGCAAGCGTTATCCGGATTTACTGGGTGTAAAGGGAGCGTAGACGGCGATGCAAGTCTGAAGTGAAAACCCAGGGCTCAACCCTGGGACTGCTTTGGAAACTGTGTTGCTAGAGTGCTGGAGAGGTAAGTGGAATTCCTAG	TACGTAGGGGGCAAGCGTTATCCGGATTTACTGGGTGTAAAGGGAGCGTAGACGGCGATGCAAGTCTGAAGTGAAAACCCAGGGCTCAACCCTGGGACTGCTTTGGAAACTGTGTTGCTAGAGTGCTGGAGAGGTAAGTGGAATTCCTAG	1.0
TACGTAGGGGGCAAGCGTTATCCGGATTTACTGGGTGTAAAGGGAGCGTAGACGGCTGTGCAAGTCTGAAGTGAAAGCCCGGGGCTCAACCCCGGGACTGCTTTGGAAACTGTATAGCTAGAGTGCTGGAGAGGTAAGTGGAATTCCTAG	TACGTAGGGGGCAAGCGTTATCCGGATTTACTGGGTGTAAAGGGAGCGTAGACGGCTGTGCAAGTCTGAAGTGAAAGCCCGGGGCTCAACCCCGGGACTGCTTTGGAAACTGTATAGCTAGAGTGCTGGAGAGGTAAGTGGAATTCCTAG	1.0
TACGTAGGGGGCAAGCGTTATCCGGATTTACTGGGTGTAAAGGGAGCGTAGACGGTCATGCAAGTCTGAAGTGAAAGCCCGGGGCTCAACCCCGGGACTGCTTTGGAAACTGTATGACTGGAGTGCAGGAGAGGTAAGCGGAATTCCTAG	TACGTAGGGGGCAAGCGTTATCCGGATTTACTGGGTGTAAAGGGAGCGTAGACGGTCATGCAAGTCTGAAGTGAAAGCCCGGGGCTCAACCCCGGGACTGCTTTGGAAACTGTATGACTGGAGTGCAGGAGAGGTAAGCGGAATTCCTAG	1.0
TACGTAGGGGGCAAGCGTTATCCGGATTTACTGGGTGTAAAGGGAGCGTAGACGGTGTGGCAAGTCTGATGTGAAAGGCATGGGCTCAACCTGTGGACTGCATTGGAAACTGTCATACTTGAGTGCCGGAGGGGTAAGCGGAATTCCTAG	TACGTAGGGGGCAAGCGTTATCCGGATTTACTGGGTGTAAAGGGAGCGTAGACGGTGTGGCAAGTCTGATGTGAAAGGCATGGGCTCAACCTGTGGACTGCATTGGAAACTGTCATACTTGAGTGCCGGAGGGGTAAGCGGAATTCCTAG	1.0
TACGTAGGGGGCAAGCGTTATCCGGATTTACTGGGTGTAAAGGGAGCGTAGACGGTTCTGCAAGTCTGATGTGAAAGGCAGAGGCTCAACTTCTGGATTGCATTGGAAACTGTGGGACTTGAGTGCCGGAGAGGTAAGCGGAATTCCTAG	TACGTAGGGGGCAAGCGTTATCCGGATTTACTGGGTGTAAAGGGAGCGTAGACGGTTCTGCAAGTCTGATGTGAAAGGCAGAGGCTCAACTTCTGGATTGCATTGGAAACTGTGGGACTTGAGTGCCGGAGAGGTAAGCGGAATTCCTAG	1.0
TACGTAGGGGGCAAGCGTTATCCGGATTTACTGGGTGTAAAGGGAGCGTAGGCGGCAGCGCAAGTCAGAAGTGAAAGCCCGGGGCTTAACTCCGGGACTGCTTTTGAAACTGTGCGGCTAGATTTCAGGAGAGGTAAGCGGAATTCCTAG	TACGTAGGGGGCAAGCGTTATCCGGATTTACTGGGTGTAAAGGGAGCGTAGGCGGCAGCGCAAGTCAGAAGTGAAAGCCCGGGGCTTAACTCCGGGACTGCTTTTGAAACTGTGCGGCTAGATTTCAGGAGAGGTAAGCGGAATTCCTAG	1.0
TACGTAGGGGGCAAGCGTTATCCGGATTTACTGGGTGTAAAGGGAGTGTAGACGGCAAGGCAAGTCTGAAGTGAAAGCCCGGTGCTCAACGCCGGGACTGCTTTGGAAACTGTTTAGCTAGAGTGCCGGAGAGGTAAGCGGAATTCCTAG	TACGTAGGGGGCAAGCGTTATCCGGATTTACTGGGTGTAAAGGGAGTGTAGACGGCAAGGCAAGTCTGAAGTGAAAGCCCGGTGCTCAACGCCGGGACTGCTTTGGAAACTGTTTAGCTAGAGTGCCGGAGAGGTAAGCGGAATTCCTAG	1.0
TACGTAGGGGGCAAGCGTTGTCCGGAATGATTGGGCGTAAAGGGCGTGTAGGCGGCCATGTAAGTCTGAAGTGAAAGTCCTGTTTTCAAGGTGGGAATTGCTTTGGATACTGTATGGCTAGAGTGCAGGAGAGGTTAGTGGAATTCCCAG	TACGTAGGGGGCAAGCGTTGTCCGGAATGATTGGGCGTAAAGGGCGTGTAGGCGGCCATGTAAGTCTGAAGTGAAAGTCCTGTTTTCAAGGTGGGAATTGCTTTGGATACTGTATGGCTAGAGTGCAGGAGAGGTTAGTGGAATTCCCAG	1.0
TACGTAGGGGGCGAGCGTTATCCGGATTCATTGGGCGTAAAGCGCGCGTAGGCGGCCAGTTAGGTCGGGAGTCAAATTTCGGGGCTCAACCCCGTCTCGCTCCCGATACCGGCTGGCTTGAGTGTGGTAGGGGAAGGCGGAATTCCCGGT	TACGTAGGGGGCGAGCGTTATCCGGATTCATTGGGCGTAAAGCGCGCGTAGGCGGCCAGTTAGGTCGGGAGTCAAATTTCGGGGCTCAACCCCGTCTCGCTCCCGATACCGGCTGGCTTGAGTGTGGTAGGGGAAGGCGGAATTCCCGGT	1.0
TACGTAGGGGGCGAGCGTTATCCGGATTCATTGGGCGTAAAGCGCGCGTAGGCGGCCGCCTAAGCGGAACCTCTAATCCCGGGGCTCAACCCCGCGGCCGGGTTCCGAACTGGGCGGCTCGAGTGCGGTAGGGGCAGGTGGAATTCCCGG	TACGTAGGGGGCGAGCGTTATCCGGATTCATTGGGCGTAAAGCGCGCGTAGGCGGCCGCCTAAGCGGAACCTCTAATCCCGGGGCTCAACCCCGCGGCCGGGTTCCGAACTGGGCGGCTCGAGTGCGGTAGGGGCAGGTGGAATTCCCGG	1.0
TACGTAGGGGGCGAGCGTTATCCGGATTCATTGGGCGTAAAGCGCGCGTAGGCGGCCGCCTAAGCGGAACCTCTAATCCCGGGGCTCAACCTCGGGCCGGGTTCCGGACTGGGCGGCTCGAGTGCGGTAGAGGCAGGCGGAATTCCCGGT	TACGTAGGGGGCGAGCGTTATCCGGATTCATTGGGCGTAAAGCGCGCGTAGGCGGCCGCCTAAGCGGAACCTCTAATCCCGGGGCTCAACCTCGGGCCGGGTTCCGGACTGGGCGGCTCGAGTGCGGTAGAGGCAGGCGGAATTCCCGGT	1.0
TACGTAGGGGGCGAGCGTTATCCGGATTCATTGGGCGTAAAGCGCGCGTAGGCGGCCTGTTAGGTCGGGGGTCAAATCCCGGGGCTCAACCCCGGTCCGCCCCCGATACCGGCAGGCTTGAGTCTGGTAGGGGAAGGCGGAATTCCCAGT	TACGTAGGGGGCGAGCGTTATCCGGATTCATTGGGCGTAAAGCGCGCGTAGGCGGCCTGTTAGGTCGGGGGTCAAATCCCGGGGCTCAACCCCGGTCCGCCCCCGATACCGGCAGGCTTGAGTCTGGTAGGGGAAGGCGGAATTCCCAGT	1.0
TACGTAGGGGGCGAGCGTTATCCGGATTCATTGGGCGTAAAGCGCGCGTAGGCGTCCCTTCAAGCGGCACCGTCGAAGCCGGGGGCTCAACCCCCGGAAGCGGGCCGAACTGGGGGGATCGAGTGCGGTAGGGGAAGGCGGAATTCCCGG	TACGTAGGGGGCGAGCGTTATCCGGATTCATTGGGCGTAAAGCGCGCGTAGGCGTCCCTTCAAGCGGCACCGTCGAAGCCGGGGGCTCAACCCCCGGAAGCGGGCCGAACTGGGGGGATCGAGTGCGGTAGGGGAAGGCGGAATTCCCGG	1.0
TACGTAGGGGGCGAGCGTTATCCGGATTTACTGGGTGTAAAGGGAGCGTAGACGGCTCGGCAAGTCTGAAGTGAAAGCCCGAGGCTTAACCACGGGACTGCTTTGGAAACTGTTGAGCTAGAGTACTGGAGAGGTAAGTGGAATTCCTAG	TACGTAGGGGGCGAGCGTTATCCGGATTTACTGGGTGTAAAGGGAGCGTAGACGGCTCGGCAAGTCTGAAGTGAAAGCCCGAGGCTTAACCACGGGACTGCTTTGGAAACTGTTGAGCTAGAGTACTGGAGAGGTAAGTGGAATTCCTAG	1.0
TACGTAGGGGGCGAGCGTTGTCCGGAATGATTGGGCGTAAAGGGCGCGTAGGCGGCCTGCTAAGTCTGGAGTGAAAGTCCTGCTTTCAAGGTGGGAATTGCTTTGGATACTGGTGGGCTGGAGTGCAGGAGAGGAAAGCGGAATTACCGG	TACGTAGGGGGCGAGCGTTGTCCGGAATGATTGGGCGTAAAGGGCGCGTAGGCGGCCTGCTAAGTCTGGAGTGAAAGTCCTGCTTTCAAGGTGGGAATTGCTTTGGATACTGGTGGGCTGGAGTGCAGGAGAGGAAAGCGGAATTACCGG	1.0
TACGTAGGGGGCTAGCGTTATCCGGAATTACTGGGCGTAAAGGGTGCGTAGGCGGTCTTTCAAGTCAGAAGTGAAAGGCTACGGCTCAACCGTAGTAAGCTTTTGAAACTGTAAGACTTGAGTGCAGGAGAGGAGAGTGGAATTCCTAGT	TACGTAGGGGGCTAGCGTTATCCGGAATTACTGGGCGTAAAGGGTGCGTAGGCGGTCTTTCAAGTCAGAAGTGAAAGGCTACGGCTCAACCGTAGTAAGCTTTTGAAACTGTAAGACTTGAGTGCAGGAGAGGAGAGTGGAATTCCTAGT	1.0
TACGTAGGGGGCTAGCGTTATCCGGAATTACTGGGCGTAAAGGGTGCGTAGGTGGTTTCTTAAGTCAGAGGTGAAAGGCTACGGCTCAACCGTAGTAAGCCTTTGAAACTGAGAAACTTGAGTGCAGGAGAGGAGAGTAGAATTCCTAGT	TACGTAGGGGGCTAGCGTTATCCGGAATTACTGGGCGTAAAGGGTGCGTAGGTGGTTTCTTAAGTCAGAGGTGAAAGGCTACGGCTCAACCGTAGTAAGCCTTTGAAACTGAGAAACTTGAGTGCAGGAGAGGAGAGTAGAATTCCTAGT	1.0
TACGTAGGGGGCTAGCGTTATCCGGAATTACTGGGCGTAAAGGGTGCGTAGGTGGTTTCTTAAGTCAGAGGTGAAAGGCTACGGCTCAACCGTAGTAAGCCTTTGAAACTGGGAAACTTGAGTGCAGGAGAGGAGAGTGGAATTCCTAGT	TACGTAGGGGGCTAGCGTTATCCGGAATTACTGGGCGTAAAGGGTGCGTAGGTGGTTTCTTAAGTCAGAGGTGAAAGGCTACGGCTCAACCGTAGTAAGCCTTTGAAACTGGGAAACTTGAGTGCAGGAGAGGAGAGTGGAATTCCTAGT	1.0
TACGTAGGGGGCTAGCGTTATCCGGATTTACTGGGCGTAAAGGGTGCGTAGGTGGTTTCTTAAGTCAGGAGTGAAAGGCTACGGCTTAACCGTAGTAAGCTCTTGAAACTGGGAAACTTGAGTGCAGGAGAGGAAAGTGGAATTCCTAGT	TACGTAGGGGGCTAGCGTTATCCGGATTTACTGGGCGTAAAGGGTGCGTAGGTGGTTTCTTAAGTCAGGAGTGAAAGGCTACGGCTTAACCGTAGTAAGCTCTTGAAACTGGGAAACTTGAGTGCAGGAGAGGAAAGTGGAATTCCTAGT	1.0
TACGTAGGGTGCAAGCGTTATCCGGATTTACTGGGTGTAAAGGGCGAGTAGACGGGAGATTAAGTCAGATGTGAAAACTTAGGGCTCAACCTTAAGACTGCATCTGAAACTGGTTTTCTTGAGTGCTGGAGAGGTAAGCGGAATTCCTAG	TACGTAGGGTGCAAGCGTTATCCGGATTTACTGGGTGTAAAGGGCGAGTAGACGGGAGATTAAGTCAGATGTGAAAACTTAGGGCTCAACCTTAAGACTGCATCTGAAACTGGTTTTCTTGAGTGCTGGAGAGGTAAGCGGAATTCCTAG	1.0
TACGTAGGGTGCAAGCGTTATCCGGATTTATTGGGCGTAAAGGGCTCGTAGGCGGTTCGTCGCGTCCGGTGTGAAAGTCCATCGCTTAACGGTGGATCCGCGCCGGGTACGGGCGGGCTTGAGTGCGGTAGGGGAGACTGGAATTCCCGG	TACGTAGGGTGCAAGCGTTATCCGGATTTATTGGGCGTAAAGGGCTCGTAGGCGGTTCGTCGCGTCCGGTGTGAAAGTCCATCGCTTAACGGTGGATCCGCGCCGGGTACGGGCGGGCTTGAGTGCGGTAGGGGAGACTGGAATTCCCGG	1.0
TACGTAGGGTGCGAGCGTTAATCGGAATTACTGGGCGTAAAGGGTGCGCAGGCGGTTGAGTAAGACAGATGTGAAATCCCCGAGCTTAACTCGGGAATGGCATATGTGACTGCTCGACTAGAGTGTGTCAGAGGGAGGTGGAATTCCACG	TACGTAGGGTGCGAGCGTTAATCGGAATTACTGGGCGTAAAGGGTGCGCAGGCGGTTGAGTAAGACAGATGTGAAATCCCCGAGCTTAACTCGGGAATGGCATATGTGACTGCTCGACTAGAGTGTGTCAGAGGGAGGTGGAATTCCACG	1.0
TACGTAGGGTGCGAGCGTTATCCGGATTTATTGGGCGTAAAGGGCTCGTAGGCGGTTCGTCGCGTCCGGTGTGAAAGTCCATCGCCTAACGGTGGATCTGCGCCGGGTACGGGCGGGCTGGAGTGCGGTAGGGGAGACTGGAATTCCCGG	TACGTAGGGTGCGAGCGTTATCCGGATTTATTGGGCGTAAAGGGCTCGTAGGCGGTTCGTCGCGTCCGGTGTGAAAGTCCATCGCCTAACGGTGGATCTGCGCCGGGTACGGGCGGGCTGGAGTGCGGTAGGGGAGACTGGAATTCCCGG	1.0
TACGTAGGTCCCGAGCGTTGTCCGGATTTATTGGGCGTAAAGCGAGCGCAGGCGGTTTAATAAGTCTGAAGTTAAAGGCAGTGGCTTAACCATTGTTCGCTTTGGAAACTGTTAGACTTGAGTGCAGAAGGGGAGAGTGGAATTCCATGT	TACGTAGGTCCCGAGCGTTGTCCGGATTTATTGGGCGTAAAGCGAGCGCAGGCGGTTTAATAAGTCTGAAGTTAAAGGCAGTGGCTTAACCATTGTTCGCTTTGGAAACTGTTAGACTTGAGTGCAGAAGGGGAGAGTGGAATTCCATGT	1.0
TACGTAGGTGACAAGCGTTGTCCGGATTTACTGGGTGTAAAGGGCGCGTAGGCGGACTGTCAAGTCAGTCGTGAAATACCGGGGCTTAACCCCGGGGCTGCGATTGAAACTGACAGCCTTGAGTATCGGAGAGGAAAGCGGAATTCCTAG	TACGTAGGTGACAAGCGTTGTCCGGATTTACTGGGTGTAAAGGGCGCGTAGGCGGACTGTCAAGTCAGTCGTGAAATACCGGGGCTTAACCCCGGGGCTGCGATTGAAACTGACAGCCTTGAGTATCGGAGAGGAAAGCGGAATTCCTAG	1.0
TACGTAGGTGGCAAGCGTTATCCGGAATGATTGGGCGTAAAGGGTGAGCAGGCGGTTGTTCAAGTCATGAGTGAAAGGCAGAAGCTTAACTTCTGTTGGCTGATGATACTGGAGAACTTGAGTACAGGAGAGGGCGGCGGAACTCCATGT	TACGTAGGTGGCAAGCGTTATCCGGAATGATTGGGCGTAAAGGGTGAGCAGGCGGTTGTTCAAGTCATGAGTGAAAGGCAGAAGCTTAACTTCTGTTGGCTGATGATACTGGAGAACTTGAGTACAGGAGAGGGCGGCGGAACTCCATGT	1.0
TACGTAGGTGGCAAGCGTTATCCGGAATGATTGGGCGTAAAGGGTGCGCAGGCGGCGCGTCAAGTCTGAAGTGAAAGGTACAGGCTCAACCTGTACAGGCTTTGGAAACTGGCGCGCTCGAGGACAGGAGAGGGCGGTGGAACTCCATGT	TACGTAGGTGGCAAGCGTTATCCGGAATGATTGGGCGTAAAGGGTGCGCAGGCGGCGCGTCAAGTCTGAAGTGAAAGGTACAGGCTCAACCTGTACAGGCTTTGGAAACTGGCGCGCTCGAGGACAGGAGAGGGCGGTGGAACTCCATGT	1.0
TACGTAGGTGGCAAGCGTTATCCGGAATGATTGGGCGTAAAGGGTGCGCAGGCGGCGTGGCAAGTCTGAAGTGAAAGGTACGGGCTCAACCTGTACAGGCTTTGGAAACTGTCACGCTCGAGGACAGGAGAGGGCGGTGGAACTCCATGT	TACGTAGGTGGCAAGCGTTATCCGGAATGATTGGGCGTAAAGGGTGCGCAGGCGGCGTGGCAAGTCTGAAGTGAAAGGTACGGGCTCAACCTGTACAGGCTTTGGAAACTGTCACGCTCGAGGACAGGAGAGGGCGGTGGAACTCCATGT	1.0
TACGTAGGTGGCAAGCGTTATCCGGAATGATTGGGCGTAAAGGGTGCGCAGGCGGCTGTGCAAGTCTGAAGTAAAAGGGACCGGCTCAACCGGTTCAGGCTTTGGAAACTGCACGGCTTGAGGACAGGAGAGGGCGGTGGAACTCCATGT	TACGTAGGTGGCAAGCGTTATCCGGAATGATTGGGCGTAAAGGGTGCGCAGGCGGCTGTGCAAGTCTGAAGTAAAAGGGACCGGCTCAACCGGTTCAGGCTTTGGAAACTGCACGGCTTGAGGACAGGAGAGGGCGGTGGAACTCCATGT	1.0
TACGTAGGTGGCAAGCGTTATCCGGAATGATTGGGCGTAAAGGGTGCGCAGGCTGCATGCCAAGTCTGAAGTGAAAGGTACGGGCTTAACCTGTATATGCTTCGGAAACTGGCAGGCTAGAGGACAGGAGAGGGCGGTGGAACTCCATGT	TACGTAGGTGGCAAGCGTTATCCGGAATGATTGGGCGTAAAGGGTGCGCAGGCTGCATGCCAAGTCTGAAGTGAAAGGTACGGGCTTAACCTGTATATGCTTCGGAAACTGGCAGGCTAGAGGACAGGAGAGGGCGGTGGAACTCCATGT	1.0
TACGTAGGTGGCAAGCGTTATCCGGAATGATTGGGCGTAAAGGGTGCGCAGGCTGCGCGTCAAGTCTGAAGTGAAAGGTACGGGCTTAACCGGTACAGGCTTTGGAAACTGGCACGCTAGAGGACAGGAGAGGGCGGTGGAACTCCATGT	TACGTAGGTGGCAAGCGTTATCCGGAATGATTGGGCGTAAAGGGTGCGCAGGCTGCGCGTCAAGTCTGAAGTGAAAGGTACGGGCTTAACCGGTACAGGCTTTGGAAACTGGCACGCTAGAGGACAGGAGAGGGCGGTGGAACTCCATGT	1.0
TACGTAGGTGGCAAGCGTTATCCGGAATTATTGGGCGTAAAGAGCGCGCAGGTGGTTAATTAAGTCTGATGTGAAAGCCCACGGCTTAACCGTGGAGGGTCATTGGAAACTGGTTGACTTGAGTGCAGAAGAGGGAAGTGGAATTCCATG	TACGTAGGTGGCAAGCGTTATCCGGAATTATTGGGCGTAAAGAGCGCGCAGGTGGTTAATTAAGTCTGATGTGAAAGCCCACGGCTTAACCGTGGAGGGTCATTGGAAACTGGTTGACTTGAGTGCAGAAGAGGGAAGTGGAATTCCATG	1.0
TACGTAGGTGGCAAGCGTTATCCGGAATTATTGGGCGTAAAGAGGGAGCAGGCGGCAGCAAGGGTCTGTGGTGAAAGCCTGAAGCTTAACTTCAGTAAGCCATAGAAACCAGGCAGCTAGAGTGCAGGAGAGGATCGTGGAATTCCATGT	TACGTAGGTGGCAAGCGTTATCCGGAATTATTGGGCGTAAAGAGGGAGCAGGCGGCAGCAAGGGTCTGTGGTGAAAGCCTGAAGCTTAACTTCAGTAAGCCATAGAAACCAGGCAGCTAGAGTGCAGGAGAGGATCGTGGAATTCCATGT	1.0
TACGTAGGTGGCAAGCGTTATCCGGAATTATTGGGCGTAAAGAGGGAGCAGGCGGCGGCAAAGGTCTGTGGTGAAAGACTGAAGCTTAACTTCAGTAAGCCATAGAAACCGGGCGGCTAGAGTGCAGGAGAGGATCGTGGAATTCCATGT	TACGTAGGTGGCAAGCGTTATCCGGAATTATTGGGCGTAAAGAGGGAGCAGGCGGCGGCAAAGGTCTGTGGTGAAAGACTGAAGCTTAACTTCAGTAAGCCATAGAAACCGGGCGGCTAGAGTGCAGGAGAGGATCGTGGAATTCCATGT	1.0
TACGTAGGTGGCAAGCGTTATCCGGAATTATTGGGCGTAAAGGGTGCGCAGGCGGTCTATTAAGTTTAGGGTGAAAGCGTTGAGCTCAACTCAATATAGCCTTAAAAACTGATAGACTAGAGTGCAGAAGAGGGTAGTGGAATTCCATGT	TACGTAGGTGGCAAGCGTTATCCGGAATTATTGGGCGTAAAGGGTGCGCAGGCGGTCTATTAAGTTTAGGGTGAAAGCGTTGAGCTCAACTCAATATAGCCTTAAAAACTGATAGACTAGAGTGCAGAAGAGGGTAGTGGAATTCCATGT	1.0
TACGTAGGTGGCAAGCGTTATCCGGAATTATTGGGCGTAAAGGGTGCGCAGGCGGTCTATTAAGTTTAGGGTGAAAGCGTTGGGCTTAACCCAATATAGCCTTAAAAACTGGTAGACTAGAGTGCAGAAGAGGGTAGTGGAATTCCATGT	TACGTAGGTGGCAAGCGTTATCCGGAATTATTGGGCGTAAAGGGTGCGCAGGCGGTCTATTAAGTTTAGGGTGAAAGCGTTGGGCTTAACCCAATATAGCCTTAAAAACTGGTAGACTAGAGTGCAGAAGAGGGTAGTGGAATTCCATGT	1.0
TACGTAGGTGGCAAGCGTTATCCGGATTTATTGGGCGTAAAGCGAGCGCAGGCGGTTGCTTAGGTCTGATGTGAAAGCCTTCGGCTTAACCGAAGAAGTGCATCGGAAACCGGGCAACTTGAGTGCAGAAGAGGACAGTGGAACTCCATG	TACGTAGGTGGCAAGCGTTATCCGGATTTATTGGGCGTAAAGCGAGCGCAGGCGGTTGCTTAGGTCTGATGTGAAAGCCTTCGGCTTAACCGAAGAAGTGCATCGGAAACCGGGCAACTTGAGTGCAGAAGAGGACAGTGGAACTCCATG	1.0
TACGTAGGTGGCAAGCGTTATCCGGATTTATTGGGCGTAAAGCGAGCGCAGGCGGTTGCTTAGGTCTGATGTGAAAGCCTTCGGCTTAACCGAAGAAGTGCATCGGAAACCGGGCGACTTGAGTGCAGAAGAGGACAGTGGAACTCCATG	TACGTAGGTGGCAAGCGTTATCCGGATTTATTGGGCGTAAAGCGAGCGCAGGCGGTTGCTTAGGTCTGATGTGAAAGCCTTCGGCTTAACCGAAGAAGTGCATCGGAAACCGGGCGACTTGAGTGCAGAAGAGGACAGTGGAACTCCATG	1.0
TACGTAGGTGGCAAGCGTTATCCGGATTTATTGGGCGTAAAGGGAACGCAGGCGGTCTTTTAAGTCTGATGTGAAAGCCTTCGGCTTAACCGGAGTAGTGCATTGGAAACTGGGAGACTTGAGTGCAGAAGAGGAGAGTGGAACTCCATG	TACGTAGGTGGCAAGCGTTATCCGGATTTATTGGGCGTAAAGGGAACGCAGGCGGTCTTTTAAGTCTGATGTGAAAGCCTTCGGCTTAACCGGAGTAGTGCATTGGAAACTGGGAGACTTGAGTGCAGAAGAGGAGAGTGGAACTCCATG	1.0
TACGTAGGTGGCAAGCGTTGTCCGGAATTACTGGGTGTAAAGGGAGCGTAGGCGGGGAGACAAGTTGAATGTTTAAACTATCGGCTTAACTGATAGTCGCGTTCAAAACTATCACTCTTGAGTGCAGTAGAGGTAGGCGGAATTCCTAGT	TACGTAGGTGGCAAGCGTTGTCCGGAATTACTGGGTGTAAAGGGAGCGTAGGCGGGGAGACAAGTTGAATGTTTAAACTATCGGCTTAACTGATAGTCGCGTTCAAAACTATCACTCTTGAGTGCAGTAGAGGTAGGCGGAATTCCTAGT	1.0
TACGTAGGTGGCAAGCGTTGTCCGGAATTACTGGGTGTAAAGGGAGCGTAGGCGGGGAGGCAAGTTGAATGTCTAAACTATCGGCTCAACTGATAGTCGCGTTCAAAACTGCCACTCTTGAGTGCAGTAGAGGTAGGCGGAATTCCTAGT	TACGTAGGTGGCAAGCGTTGTCCGGAATTACTGGGTGTAAAGGGAGCGTAGGCGGGGAGGCAAGTTGAATGTCTAAACTATCGGCTCAACTGATAGTCGCGTTCAAAACTGCCACTCTTGAGTGCAGTAGAGGTAGGCGGAATTCCTAGT	1.0
TACGTAGGTGGCAAGCGTTGTCCGGAATTACTGGGTGTAAAGGGAGCGTAGGCGGGGAGGCAAGTTGAATGTTTAAACTATCGGCTCAACTGATAGTCGCGTTCAAAACTGCCACTCTTGAGTGCAGTAGAGGTAGGCGGAATTCCTAGT	TACGTAGGTGGCAAGCGTTGTCCGGAATTACTGGGTGTAAAGGGAGCGTAGGCGGGGAGGCAAGTTGAATGTTTAAACTATCGGCTCAACTGATAGTCGCGTTCAAAACTGCCACTCTTGAGTGCAGTAGAGGTAGGCGGAATTCCTAGT	1.0
TACGTAGGTGGCAAGCGTTGTCCGGAATTATTGGGCGTAAAGCGCGCGCAGGCGGATGCGTAAGTCTATCTTAAAAGTGCGGGGCTTAACCCCGTGAGGGGATGGAAACTGGGCATCTAGAGTATCGGAGAGGAAAGCGGAATTCCTAGT	TACGTAGGTGGCAAGCGTTGTCCGGAATTATTGGGCGTAAAGCGCGCGCAGGCGGATGCGTAAGTCTATCTTAAAAGTGCGGGGCTTAACCCCGTGAGGGGATGGAAACTGGGCATCTAGAGTATCGGAGAGGAAAGCGGAATTCCTAGT	1.0
TACGTAGGTGGCAAGCGTTGTCCGGATTTACTGGGCGTAAAGGGAGCGTAGGCGGATTTTTAAGTGAGATGTGAAATACCCGGGCTTAACTTGGGTGCTGCATTTCAAACTGGAAGTCTAGAGTGCAGGAGAGGAGAAGGGAATTCCTAG	TACGTAGGTGGCAAGCGTTGTCCGGATTTACTGGGCGTAAAGGGAGCGTAGGCGGATTTTTAAGTGAGATGTGAAATACCCGGGCTTAACTTGGGTGCTGCATTTCAAACTGGAAGTCTAGAGTGCAGGAGAGGAGAAGGGAATTCCTAG	1.0
TACGTAGGTGGCAAGCGTTGTCCGGATTTATTGGGCGTAAAGCGAGCGCAGGCGGAAGAATAAGTCTGATGTGAAAGCCCTCGGCTTAACCGAGGAACTGCATCGGAAACTGTTTTTCTTGAGTGCAGAAGAGGAGAGTGGAACTCCATG	TACGTAGGTGGCAAGCGTTGTCCGGATTTATTGGGCGTAAAGCGAGCGCAGGCGGAAGAATAAGTCTGATGTGAAAGCCCTCGGCTTAACCGAGGAACTGCATCGGAAACTGTTTTTCTTGAGTGCAGAAGAGGAGAGTGGAACTCCATG	1.0
TACGTAGGTGGCAAGCGTTGTCCGGATTTATTGGGCGTAAAGCGAGCGCAGGCGGTTTCTTAAGTCTGATGTGAAAGCCCCCGGCTCAACCGGGGAGGGTCATTGGAAACTGGGAGACTTGAGTGCAGAAGAGGAGAGTGGAATTCCATG	TACGTAGGTGGCAAGCGTTGTCCGGATTTATTGGGCGTAAAGCGAGCGCAGGCGGTTTCTTAAGTCTGATGTGAAAGCCCCCGGCTCAACCGGGGAGGGTCATTGGAAACTGGGAGACTTGAGTGCAGAAGAGGAGAGTGGAATTCCATG	1.0
TACGTAGGTGGCAAGCGTTGTCCGGATTTATTGGGCGTAAAGCGAGTGCAGGCGGTTCAATAAGTCTGATGTGAAAGCCTTCGGCTCAACCGGAGAATTGCATCAGAAACTGTTGAACTTGAGTGCAGAAGAGGAGAGTGGAACTCCATG	TACGTAGGTGGCAAGCGTTGTCCGGATTTATTGGGCGTAAAGCGAGTGCAGGCGGTTCAATAAGTCTGATGTGAAAGCCTTCGGCTCAACCGGAGAATTGCATCAGAAACTGTTGAACTTGAGTGCAGAAGAGGAGAGTGGAACTCCATG	1.0
TACGTAGGTGGCGAGCGTTATCCGGAATCATTGGGCGTAAAGAGGGAGCAGGCGGCCGCAAGGGTCTGTGGTGAAAGACCGAAGCTAAACTTCGGTAAGCCATGGAAACCGGGCGGCTAGAGTGCGGAAGAGGATCGTGGAATTCCATGT	TACGTAGGTGGCGAGCGTTATCCGGAATCATTGGGCGTAAAGAGGGAGCAGGCGGCCGCAAGGGTCTGTGGTGAAAGACCGAAGCTAAACTTCGGTAAGCCATGGAAACCGGGCGGCTAGAGTGCGGAAGAGGATCGTGGAATTCCATGT	1.0
TACGTAGGTGGCGAGCGTTATCCGGAATGATTGGGCGTAAAGGGTGCGCAGGCGGCAGACTGCGTCTGGAGTGAAAAGGAGGGGCTCAACCCCTGCTTGCTTTGGAAACGGGTCTGCTGGAGTGCAGGAGAGGGCGGTGGAACTCCATGT	TACGTAGGTGGCGAGCGTTATCCGGAATGATTGGGCGTAAAGGGTGCGCAGGCGGCAGACTGCGTCTGGAGTGAAAAGGAGGGGCTCAACCCCTGCTTGCTTTGGAAACGGGTCTGCTGGAGTGCAGGAGAGGGCGGTGGAACTCCATGT	1.0
TACGTAGGTGGCGAGCGTTATCCGGAATGATTGGGCGTAAAGGGTGCGCAGGCGGCCGGGCAAGTCCGCAGTAAAAACTGGAGGCTCAACCTTCAGGGGCTGCGGAAACTGTCCGGCTGGAGAGCAGGAGAGGACGGTGGAACTCCATGT	TACGTAGGTGGCGAGCGTTATCCGGAATGATTGGGCGTAAAGGGTGCGCAGGCGGCCGGGCAAGTCCGCAGTAAAAACTGGAGGCTCAACCTTCAGGGGCTGCGGAAACTGTCCGGCTGGAGAGCAGGAGAGGACGGTGGAACTCCATGT	1.0
TACGTAGGTGGCGAGCGTTATCCGGAATGATTGGGCGTAAAGGGTGCGCAGGCGGCGCGTCAAGTCTGAAGTAAAAGGTACAGGCTCAACCTGTGCAGGCTTTGGAAACTGGCGCGCTCGAGGACAGGAGAGGGCGGTGGAACTCCATGT	TACGTAGGTGGCGAGCGTTATCCGGAATGATTGGGCGTAAAGGGTGCGCAGGCGGCGCGTCAAGTCTGAAGTAAAAGGTACAGGCTCAACCTGTGCAGGCTTTGGAAACTGGCGCGCTCGAGGACAGGAGAGGGCGGTGGAACTCCATGT	1.0
TACGTAGGTGGCGAGCGTTATCCGGAATGATTGGGCGTAAAGGGTGCGCAGGCGGCGTGACAAGTCTGAAGTGAAAGGTACGGGCTCAACCTGTACAGGCTTTGGAAACTGTCACGCTAGAGGACAGGAGAGGGCGGTGGAACTCCATGT	TACGTAGGTGGCGAGCGTTATCCGGAATGATTGGGCGTAAAGGGTGCGCAGGCGGCGTGACAAGTCTGAAGTGAAAGGTACGGGCTCAACCTGTACAGGCTTTGGAAACTGTCACGCTAGAGGACAGGAGAGGGCGGTGGAACTCCATGT	1.0
TACGTAGGTGGCGAGCGTTATCCGGAATGATTGGGCGTAAAGGGTGCGCAGGCGGTCCTGCAAGTCTGGAGTGAAACGCATGAGCTCAACTCATGCATGGCTTTGGAAACTGGAGGACTGGAGAGCAGGAGAGGGCGGTGGAACTCCATG	TACGTAGGTGGCGAGCGTTATCCGGAATGATTGGGCGTAAAGGGTGCGCAGGCGGTCCTGCAAGTCTGGAGTGAAACGCATGAGCTCAACTCATGCATGGCTTTGGAAACTGGAGGACTGGAGAGCAGGAGAGGGCGGTGGAACTCCATG	1.0
TACGTAGGTGGCGAGCGTTATCCGGAATGATTGGGCGTAAAGGGTGCGCAGGCGGTCTGTTAAGTCTGAAGGCAAAGGGATGAGCTCAACTCATTCATGATTCAGAAACTGGCAGACTTGAGGACAGGAGAGGGCGGTGGAACTCCATGT	TACGTAGGTGGCGAGCGTTATCCGGAATGATTGGGCGTAAAGGGTGCGCAGGCGGTCTGTTAAGTCTGAAGGCAAAGGGATGAGCTCAACTCATTCATGATTCAGAAACTGGCAGACTTGAGGACAGGAGAGGGCGGTGGAACTCCATGT	1.0
TACGTAGGTGGCGAGCGTTATCCGGAATGATTGGGCGTAAAGGGTGCGCAGGCTGCCGGTCAAGTCTTCAGTGAAAGATCGAAGCTCAACTTCGGTTTGCTGAGGAAACTGGCCGGCTGGAGAGCAGGAGAGGGCGGTGGAACTCCATGT	TACGTAGGTGGCGAGCGTTATCCGGAATGATTGGGCGTAAAGGGTGCGCAGGCTGCCGGTCAAGTCTTCAGTGAAAGATCGAAGCTCAACTTCGGTTTGCTGAGGAAACTGGCCGGCTGGAGAGCAGGAGAGGGCGGTGGAACTCCATGT	1.0
TACGTAGGTGGCGAGCGTTATCCGGAATGATTGGGCGTAAAGGGTGCGTAGGCGGCATGGCAAGTCTGAAGTGAAAGGTACGGGCTCAACCTGTACAGGCTTTGGAAACGGTCATGCTCGAGGACAGGAGAGGGCAGCGGAACTCCATGT	TACGTAGGTGGCGAGCGTTATCCGGAATGATTGGGCGTAAAGGGTGCGTAGGCGGCATGGCAAGTCTGAAGTGAAAGGTACGGGCTCAACCTGTACAGGCTTTGGAAACGGTCATGCTCGAGGACAGGAGAGGGCAGCGGAACTCCATGT	1.0
TACGTAGGTGGCGAGCGTTATCCGGAATGATTGGGCGTAAAGGGTGCGTAGGCGGCCTGTTAAGTCTGAAGTGAAAGGTACCGGCTCAACCGGTACAGGCTTTGGAAACTGGCAGGCTAGAGGACAGGAGAGGGCGGTGGAACTCCATGT	TACGTAGGTGGCGAGCGTTATCCGGAATGATTGGGCGTAAAGGGTGCGTAGGCGGCCTGTTAAGTCTGAAGTGAAAGGTACCGGCTCAACCGGTACAGGCTTTGGAAACTGGCAGGCTAGAGGACAGGAGAGGGCGGTGGAACTCCATGT	1.0
TACGTAGGTGGCGAGCGTTATCCGGAATGATTGGGCGTAAAGGGTGCGTAGGCGGCCTGTTAAGTCTGAAGTGAAAGGTACCGGCTCAACCGGTACAGGCTTTGGAAACTGGCAGGCTGGAGGACAGGAGAGGGCGGTGGAACTCCATGT	TACGTAGGTGGCGAGCGTTATCCGGAATGATTGGGCGTAAAGGGTGCGTAGGCGGCCTGTTAAGTCTGAAGTGAAAGGTACCGGCTCAACCGGTACAGGCTTTGGAAACTGGCAGGCTGGAGGACAGGAGAGGGCGGTGGAACTCCATGT	1.0
TACGTAGGTGGCGAGCGTTATCCGGAATGATTGGGCGTAAAGGGTGCGTAGGTGGCAGATCAAGTCTGGAGTAAAAGGTATGGGCTCAACCCGTACTTGCTCTGGAAACTGATCAGCTAGAGAACAGAAGAGGACGGCGGAACTCCATGT	TACGTAGGTGGCGAGCGTTATCCGGAATGATTGGGCGTAAAGGGTGCGTAGGTGGCAGATCAAGTCTGGAGTAAAAGGTATGGGCTCAACCCGTACTTGCTCTGGAAACTGATCAGCTAGAGAACAGAAGAGGACGGCGGAACTCCATGT	1.0
TACGTAGGTGGCGAGCGTTATCCGGAATTATTGGGCGTAAAGAGCGCGCAGGTGGTTGATTAAGTCTGATGTGAAAGCCCACGGCTTAACCGTGGAGGGTCATTGGAAACTGGTCGACTTGAGTGCAGAAGAGGGAAGTGGAATTCCATG	TACGTAGGTGGCGAGCGTTATCCGGAATTATTGGGCGTAAAGAGCGCGCAGGTGGTTGATTAAGTCTGATGTGAAAGCCCACGGCTTAACCGTGGAGGGTCATTGGAAACTGGTCGACTTGAGTGCAGAAGAGGGAAGTGGAATTCCATG	1.0
TACGTAGGTGGCGAGCGTTATCCGGAATTATTGGGCGTAAAGAGGGAGCAGGCGGCACTAAGGGTCTGTGGTGAAAGATCGAAGCTTAACTTCGGTAAGCCATGGAAACCGTAGAGCTAGAGTGTGTGAGAGGATCGTGGAATTCCATGT	TACGTAGGTGGCGAGCGTTATCCGGAATTATTGGGCGTAAAGAGGGAGCAGGCGGCACTAAGGGTCTGTGGTGAAAGATCGAAGCTTAACTTCGGTAAGCCATGGAAACCGTAGAGCTAGAGTGTGTGAGAGGATCGTGGAATTCCATGT	1.0
TACGTAGGTGGCGAGCGTTATCCGGAATTATTGGGCGTAAAGAGGGAGCAGGCGGCCATGAGGGTCTAGTGTTAAAAACCCGATGCTCAACATCGGGAAGGCAAAGAAACCGTGTGGCTAGAGTACAGCAGAGGATCGTGGAATTCCATG	TACGTAGGTGGCGAGCGTTATCCGGAATTATTGGGCGTAAAGAGGGAGCAGGCGGCCATGAGGGTCTAGTGTTAAAAACCCGATGCTCAACATCGGGAAGGCAAAGAAACCGTGTGGCTAGAGTACAGCAGAGGATCGTGGAATTCCATG	1.0
TACGTAGGTGGCGAGCGTTATCCGGAATTATTGGGCGTAAAGAGGGAGCAGGCGGCCTAAAGGGTCTAACGTTAAAAGGCAACAGCTTAACTGTTGTAAGGCGAAGAAACCGGTAGGCTAGAGTTCTATAGAGGATCGTGGAATTCCATG	TACGTAGGTGGCGAGCGTTATCCGGAATTATTGGGCGTAAAGAGGGAGCAGGCGGCCTAAAGGGTCTAACGTTAAAAGGCAACAGCTTAACTGTTGTAAGGCGAAGAAACCGGTAGGCTAGAGTTCTATAGAGGATCGTGGAATTCCATG	1.0
TACGTAGGTGGCGAGCGTTATCCGGAATTATTGGGCGTAAAGGGAGCGTAGGCGGATAATTAAGTGGGATGTGAAATACTCAGGCTCAACCTGGGGGCTGCATTCCAAACTGATTATCTAGAGTGCAGGAGAGGAGAGTGGAATTCCTAG	TACGTAGGTGGCGAGCGTTATCCGGAATTATTGGGCGTAAAGGGAGCGTAGGCGGATAATTAAGTGGGATGTGAAATACTCAGGCTCAACCTGGGGGCTGCATTCCAAACTGATTATCTAGAGTGCAGGAGAGGAGAGTGGAATTCCTAG	1.0
TACGTAGGTGGCGAGCGTTATCCGGATTTATTGGGCGTAAAGGGAGCGTAGGCGGATACTTAAGTGGGATGTGAAATACTTGGGCTCAACCCGAGTACTGCATTCCAAACTGAGTATCTAGAGTGCAGGAGAGGAGAGTGGAATTCCTAG	TACGTAGGTGGCGAGCGTTATCCGGATTTATTGGGCGTAAAGGGAGCGTAGGCGGATACTTAAGTGGGATGTGAAATACTTGGGCTCAACCCGAGTACTGCATTCCAAACTGAGTATCTAGAGTGCAGGAGAGGAGAGTGGAATTCCTAG	1.0
TACGTAGGTGGCGAGCGTTGTCCGGATTTACTGGGCGTAAAGGGAGCGTAGGCGGACTTTTAAGTGAGATGTGAAATACCCGGGCTCAACTTGGGTGCTGCATTTCAAACTGGAAGTCTAGAGTGCAGGAGAGGAGAATGGAATTCCTAG	TACGTAGGTGGCGAGCGTTGTCCGGATTTACTGGGCGTAAAGGGAGCGTAGGCGGACTTTTAAGTGAGATGTGAAATACCCGGGCTCAACTTGGGTGCTGCATTTCAAACTGGAAGTCTAGAGTGCAGGAGAGGAGAATGGAATTCCTAG	1.0
TACGTAGGTGGCGAGCGTTGTCCGGATTTACTGGGCGTAAAGGGAGCGTAGGCGGATTTTTAAGTGAGATGTGAAATACCCGGGCTCAACTTGGGTGCTGCATTTCAAACTGGAAGTCTAGAGTGCAGGAGAGGAGAATGGAATTCCTAG	TACGTAGGTGGCGAGCGTTGTCCGGATTTACTGGGCGTAAAGGGAGCGTAGGCGGATTTTTAAGTGAGATGTGAAATACCCGGGCTCAACTTGGGTGCTGCATTTCAAACTGGAAGTCTAGAGTGCAGGAGAGGAGAATGGAATTCCTAG	1.0
TACGTAGGTTGCAAGCGTTGTCCGGAATTACTGGGTGTAAAGGGCGTGTAGGCGGAGCTGCAAGTCAGATGTGAAATCCCGGGGCTCAACCCCGGAACTGCATTTGAAACTGTAGCCCTTGAGTATCGGAGAGGCAAGCGGAATTCCTAG	TACGTAGGTTGCAAGCGTTGTCCGGAATTACTGGGTGTAAAGGGCGTGTAGGCGGAGCTGCAAGTCAGATGTGAAATCCCGGGGCTCAACCCCGGAACTGCATTTGAAACTGTAGCCCTTGAGTATCGGAGAGGCAAGCGGAATTCCTAG	1.0
TACGTAGGTTGCAAGCGTTGTCCGGATTTACTGGGTGTAAAGGGCGTGTAGGCGGAGGTGCAAGTTGGGAGTGAAATCCCGGGGCTCAACCCCGGAACTGCTTTCAAAACTGTACCCCTTGAGTGTCGGAGAGGCAAGCGGAATTCCTAG	TACGTAGGTTGCAAGCGTTGTCCGGATTTACTGGGTGTAAAGGGCGTGTAGGCGGAGGTGCAAGTTGGGAGTGAAATCCCGGGGCTCAACCCCGGAACTGCTTTCAAAACTGTACCCCTTGAGTGTCGGAGAGGCAAGCGGAATTCCTAG	1.0
TACGTATGGAGCAAGCGTTATCCGGATTTACTGGGTGTAAAGGGAGCGTAGACGGCTTAGCAAGTCTGATGTGAAAGGCTGGGGCTCAACCCCGGGACTGCATTGGAAACTGTTAAGCTAGAGTGCCGGAGAGGTAAGCGGAATTCCTAG	TACGTATGGAGCAAGCGTTATCCGGATTTACTGGGTGTAAAGGGAGCGTAGACGGCTTAGCAAGTCTGATGTGAAAGGCTGGGGCTCAACCCCGGGACTGCATTGGAAACTGTTAAGCTAGAGTGCCGGAGAGGTAAGCGGAATTCCTAG	1.0
TACGTATGGAGCAAGCGTTATCCGGATTTACTGGGTGTAAAGGGAGTGTAGGTGGCACAGCAAGTCAGAAGTGAAAGCCCGGGGCTCAACCCCGGGACTGCTTTTGAAACTGCTGGGCTGGAGTGCAGGAGAGGTAAGTGGAATTCCTAG	TACGTATGGAGCAAGCGTTATCCGGATTTACTGGGTGTAAAGGGAGTGTAGGTGGCACAGCAAGTCAGAAGTGAAAGCCCGGGGCTCAACCCCGGGACTGCTTTTGAAACTGCTGGGCTGGAGTGCAGGAGAGGTAAGTGGAATTCCTAG	1.0
TACGTATGGAGCAAGCGTTATCCGGATTTACTGGGTGTAAAGGGAGTGTAGGTGGCCAGGCAAGTCAGAAGTGAAAGCCCGGGGCTCAACCCCGGGACTGCTTTTGAAACTGCAGGGCTAGAGTGCAGGAGGGGCAAGTGGAATTCCTAG	TACGTATGGAGCAAGCGTTATCCGGATTTACTGGGTGTAAAGGGAGTGTAGGTGGCCAGGCAAGTCAGAAGTGAAAGCCCGGGGCTCAACCCCGGGACTGCTTTTGAAACTGCAGGGCTAGAGTGCAGGAGGGGCAAGTGGAATTCCTAG	1.0
TACGTATGGAGCAAGCGTTATCCGGATTTACTGGGTGTAAAGGGAGTGTAGGTGGCCATGCAAGTCAGAAGTGAAAATCCGGGGCTCAACCCCGGAACTGCTTTTGAAACTGTAAGGCTAGAGTGCAGGAGGGGTGAGTGGAATTCCTAG	TACGTATGGAGCAAGCGTTATCCGGATTTACTGGGTGTAAAGGGAGTGTAGGTGGCCATGCAAGTCAGAAGTGAAAATCCGGGGCTCAACCCCGGAACTGCTTTTGAAACTGTAAGGCTAGAGTGCAGGAGGGGTGAGTGGAATTCCTAG	1.0
TACGTATGGAGCAAGCGTTATCCGGATTTACTGGGTGTAAAGGGAGTGTAGGTGGCCATGCAAGTCAGAAGTGAAAATCCGGGGCTCAACCCCGGAACTGCTTTTGAAACTGTGAGGCTAGAGTGCAGGAGGGGTGAGTGGAATTCCTAG	TACGTATGGAGCAAGCGTTATCCGGATTTACTGGGTGTAAAGGGAGTGTAGGTGGCCATGCAAGTCAGAAGTGAAAATCCGGGGCTCAACCCCGGAACTGCTTTTGAAACTGTGAGGCTAGAGTGCAGGAGGGGTGAGTGGAATTCCTAG	1.0
TACGTATGGAGCAAGCGTTATCCGGATTTACTGGGTGTAAAGGGTGCGTAGGCGGCAAGGCAAGTCAGATGTGAAAGACCGGGGCTCAACCCCGGGGCTGCATTTGAAACTGTTTTGCTGGAGTCCAGGAGAGGCAGGCGGAATTCCTAG	TACGTATGGAGCAAGCGTTATCCGGATTTACTGGGTGTAAAGGGTGCGTAGGCGGCAAGGCAAGTCAGATGTGAAAGACCGGGGCTCAACCCCGGGGCTGCATTTGAAACTGTTTTGCTGGAGTCCAGGAGAGGCAGGCGGAATTCCTAG	1.0
TACGTATGGGGCGAGCGTTATCCGGATTCATTGGGCGTAAAGCGCGCGTAGGCGGCCCGTTAGGTCGGAGGTAAAAGCCCGGGGCTCAACCCCGGCGAGCCTCCGATACCGGCGGGCTCGAGTGTGGTAGGGGAAGGCGGAATTCCCGGT	TACGTATGGGGCGAGCGTTATCCGGATTCATTGGGCGTAAAGCGCGCGTAGGCGGCCCGTTAGGTCGGAGGTAAAAGCCCGGGGCTCAACCCCGGCGAGCCTCCGATACCGGCGGGCTCGAGTGTGGTAGGGGAAGGCGGAATTCCCGGT	1.0
TACGTATGGTGCAAGCGTTATCCGGATTTACTGGGTGTAAAGGGAGCGTAGGTGGCAAGGCAAGCCAGAAGTGAAAACCCGGGGCTCAACCGCGGGATTGCTTTTGGAACTGTCATGCTAGAGTGCAGGAGGGGTGAGCGGAATTCCTAG	TACGTATGGTGCAAGCGTTATCCGGATTTACTGGGTGTAAAGGGAGCGTAGGTGGCAAGGCAAGCCAGAAGTGAAAACCCGGGGCTCAACCGCGGGATTGCTTTTGGAACTGTCATGCTAGAGTGCAGGAGGGGTGAGCGGAATTCCTAG	1.0
TACGTATGGTTCAAGCGTTATCCGGATTTACTGGGTGTAAAGGGTGAGTAGGCGGTTATGCAAGTCATATGTGAAATGTCGGGGCTCAACTCCGGCCTGCATAAGAAACTGTATAACTAGAGTGCAGGAGAGGCAAGCGGAATTCCTAGT	TACGTATGGTTCAAGCGTTATCCGGATTTACTGGGTGTAAAGGGTGAGTAGGCGGTTATGCAAGTCATATGTGAAATGTCGGGGCTCAACTCCGGCCTGCATAAGAAACTGTATAACTAGAGTGCAGGAGAGGCAAGCGGAATTCCTAGT	1.0
TACGTATGTCGCAAGCGTTATCCGGATTTATTGGGCGTAAAGCGCGTCTAGGCGGAAAGATAAGTCTGATGTGAAAATGCGGGGCTCAACTCCGTATTGCGTTGGAAACTGTCTTTCTAGAGTACTGGAGAGGTGGGCGGAACTACAAGT	TACGTATGTCGCAAGCGTTATCCGGATTTATTGGGCGTAAAGCGCGTCTAGGCGGAAAGATAAGTCTGATGTGAAAATGCGGGGCTCAACTCCGTATTGCGTTGGAAACTGTCTTTCTAGAGTACTGGAGAGGTGGGCGGAACTACAAGT	1.0
TACGTATGTCGCAAGCGTTATCCGGATTTATTGGGCGTAAAGCGCGTCTAGGCGGATTGGTAAGTCTGATGTTAAAATGCGGGGCTCAACTCCGTATTGCGTTGGAAACTGCCAATCTAGAGTACTGGAGAGGTGGGCGGAACTACAAGT	TACGTATGTCGCAAGCGTTATCCGGATTTATTGGGCGTAAAGCGCGTCTAGGCGGATTGGTAAGTCTGATGTTAAAATGCGGGGCTCAACTCCGTATTGCGTTGGAAACTGCCAATCTAGAGTACTGGAGAGGTGGGCGGAACTACAAGT	1.0
TACGTATGTCGCAAGCGTTATCCGGATTTATTGGGCGTAAAGCGCGTCTAGGTGGTTTGGTAAGTCTGATGTGAAAATGCGGGGCTCAACTCCGTATTGCGTTGGAAACTGTCAAACTAGAGTACTGGAGAGGTGGGCGGAACTACAAGT	TACGTATGTCGCAAGCGTTATCCGGATTTATTGGGCGTAAAGCGCGTCTAGGTGGTTTGGTAAGTCTGATGTGAAAATGCGGGGCTCAACTCCGTATTGCGTTGGAAACTGTCAAACTAGAGTACTGGAGAGGTGGGCGGAACTACAAGT	1.0
AACATAGGGGGCAAGCGTTGTCCGGAATCACTGGGCGTAAAGGGCGCGTAGGCGGTCTGTTAAGTCGGATGTGAAATGTAAGGGCTCAACCCTTAACGTGCATCTGATACTGGCAGACTTGAGTGCGGAAGAGGCAAGTGGAATTCCTAG	AACATAGGGGGCAAGCGTTGTCCGGAATCACTGGGCGTAAAGGGCGCGTAGGCGGTCTGTTAAGTCGGATGTGAAATGTAAGGGCTCAACCCTTAACGTGCATCTGATACTGGCAGACTTGAGTGCGGAAGAGGCAAGTGGAATTCCTAG	0.0
TACGGAAGGTCCAGGCGTTATCCGGATTTATTGGGTTTAAAGGGAGCGCAGGCGGACTCTTAAGTCAGTTGTGAAATACGGCGGCTCAACCGTCGGACTGCAGTTGATACTGGGAGTCTTGAGTACACGCAGAGATACTGGAATTCATGG	TACGGAAGGTCCAGGCGTTATCCGGATTTATTGGGTTTAAAGGGAGCGCAGGCGGACTCTTAAGTCAGTTGTGAAATACGGCGGCTCAACCGTCGGACTGCAGTTGATACTGGGAGTCTTGAGTACACGCAGAGATACTGGAATTCATGG	0.0
TACGGAAGGTCCAGGCGTTATCCGGATTTATTGGGTTTAAAGGGAGCGCAGGCGGATTTTTAAGTCAGTTGTGAAATACGGCGGCTCAACCGTCGGACTGCAGTTGATACTGGAAGTCTTGAGTGCACACAGGGATACTGGAATTCATGG	TACGGAAGGTCCAGGCGTTATCCGGATTTATTGGGTTTAAAGGGAGCGCAGGCGGATTTTTAAGTCAGTTGTGAAATACGGCGGCTCAACCGTCGGACTGCAGTTGATACTGGAAGTCTTGAGTGCACACAGGGATACTGGAATTCATGG	0.0
TACGGAGGATCCGAGCGTTATCCGGATTTATTGGGTTTAAAGGGAGCGTAGATGGGCGTTTAAGTCAGTTGTGAAAGTTTGCGGCTCAACCGTAAAATTGCAGTTGATACTGGACGCCTTGAGTGCAGTTGAGGCAGGCGGAATTCGTGG	TACGGAGGATCCGAGCGTTATCCGGATTTATTGGGTTTAAAGGGAGCGTAGATGGGCGTTTAAGTCAGTTGTGAAAGTTTGCGGCTCAACCGTAAAATTGCAGTTGATACTGGACGCCTTGAGTGCAGTTGAGGCAGGCGGAATTCGTGG	0.0
TACGGAGGATCCGAGCGTTATCCGGATTTATTGGGTTTAAAGGGAGCGTAGATGGGTGTTTAAGTCAGTTGTGAAAGTTTGCGGCTCAACCGTAAAATTGCAGTTGATACTGGACGCCTTGAGTGCAGTTGAGGCAGGCGGAATTCGTGG	TACGGAGGATCCGAGCGTTATCCGGATTTATTGGGTTTAAAGGGAGCGTAGATGGGTGTTTAAGTCAGTTGTGAAAGTTTGCGGCTCAACCGTAAAATTGCAGTTGATACTGGACGCCTTGAGTGCAGTTGAGGCAGGCGGAATTCGTGG	0.0
TACGGAGGATCCGAGCGTTATCCGGATTTATTGGGTTTAAAGGGAGCGTAGGCGGAATTTTAAGTCAGTTGTGAAAGTTTGCGGCTCAACCGTAAAATTGCAGTTGATACTGGAGTTCTTGAGTGCGGTAAAGGCAGGCGGAATTCGTGG	TACGGAGGATCCGAGCGTTATCCGGATTTATTGGGTTTAAAGGGAGCGTAGGCGGAATTTTAAGTCAGTTGTGAAAGTTTGCGGCTCAACCGTAAAATTGCAGTTGATACTGGAGTTCTTGAGTGCGGTAAAGGCAGGCGGAATTCGTGG	0.0
TACGGAGGATCCGAGCGTTATCCGGATTTATTGGGTTTAAAGGGAGCGTAGGTGGAAGATTAAGTCAGCCTGTGAAAGTTTGCGGCTCAACCGTAAAATTGCAGTTGATACTGGTTTTCTTGAGTGCAGTAGAGGTGGGCGGAATTCGTG	TACGGAGGATCCGAGCGTTATCCGGATTTATTGGGTTTAAAGGGAGCGTAGGTGGAAGATTAAGTCAGCCTGTGAAAGTTTGCGGCTCAACCGTAAAATTGCAGTTGATACTGGTTTTCTTGAGTGCAGTAGAGGTGGGCGGAATTCGTG	0.0
TACGGAGGATGCGAGCGTTATCCGGATTTATTGGGTTTAAAGGGAGCGCAGACGGGTTTTTAAGTCAGCTGTGAAAGTTCGGGGCTCAACCTTGAAATTGCAGTTGATACTGGAGACCTTGAGTGCAGTTGAGGCAGGCGGAATTCGTGG	TACGGAGGATGCGAGCGTTATCCGGATTTATTGGGTTTAAAGGGAGCGCAGACGGGTTTTTAAGTCAGCTGTGAAAGTTCGGGGCTCAACCTTGAAATTGCAGTTGATACTGGAGACCTTGAGTGCAGTTGAGGCAGGCGGAATTCGTGG	0.0
TACGGAGGGTGCAAGCGTTAATCGGAATTACTGGGCGTAAAGCGCACGCAGGCGGTTTGTTAAGTCAGATGTGAAATCCCCGAGCTCAACTTGGGAACTGCATTTGAAACTGGCAAGCTAGAGTCTTGTAGAGGGGGGTAGAATTCCAGG	TACGGAGGGTGCAAGCGTTAATCGGAATTACTGGGCGTAAAGCGCACGCAGGCGGTTTGTTAAGTCAGATGTGAAATCCCCGAGCTCAACTTGGGAACTGCATTTGAAACTGGCAAGCTAGAGTCTTGTAGAGGGGGGTAGAATTCCAGG	0.0
TACGTAGGGCGCAAGCGTTATCCGGAATTATTGGGCGTAAAGAGCTCGTAGGCGGTTTGTCGCGTCTGCCGTGAAAGTCCGGGGCTCAACTCCGGATCTGCGGTGGGTACGGGCAGACTAGAGTGATGTAGGGGAGACTGGAATTCCTGG	TACGTAGGGCGCAAGCGTTATCCGGAATTATTGGGCGTAAAGAGCTCGTAGGCGGTTTGTCGCGTCTGCCGTGAAAGTCCGGGGCTCAACTCCGGATCTGCGGTGGGTACGGGCAGACTAGAGTGATGTAGGGGAGACTGGAATTCCTGG	0.0
TACGTAGGGCGCGAGCGTTGTCCGGAATTATTGGGCGTAAAGAGCTTGTAGGCGGTTTGTCGCGTCTGCTGTGAAAGCCCGGGGCTTAACCCCGGGTTTGCAGTGGGTACGGGCAGACTAGAGTGCAGTAGGGGAGACTGGAATTCCTGG	TACGTAGGGCGCGAGCGTTGTCCGGAATTATTGGGCGTAAAGAGCTTGTAGGCGGTTTGTCGCGTCTGCTGTGAAAGCCCGGGGCTTAACCCCGGGTTTGCAGTGGGTACGGGCAGACTAGAGTGCAGTAGGGGAGACTGGAATTCCTGG	0.0
TACGTAGGGCGCGAGCGTTGTCCGGAATTATTGGGCGTAAAGGGCTTGTAGGCGGCTTGTCGCGTCTGCCGTGAAATCCCGGGGCTTAACCTTGGGCTTGCGGTGGGTACGGGCTGGCTTGAGTGCGGTAGGGGAGACTGGAATTCCTGG	TACGTAGGGCGCGAGCGTTGTCCGGAATTATTGGGCGTAAAGGGCTTGTAGGCGGCTTGTCGCGTCTGCCGTGAAATCCCGGGGCTTAACCTTGGGCTTGCGGTGGGTACGGGCTGGCTTGAGTGCGGTAGGGGAGACTGGAATTCCTGG	0.0
TACGTAGGGGGCAAGCGTTATCCGGATTTACTGGGTGTAAAGGGAGCGTAGACGGAAGTGCAAGTCTGAAGTGAAAACTTGGGGCTCAACCCCGAGACTGCTTTGGAAACTGTGCTTCTAGAGTGTCGGAGAGGTAAGCGGAATTCCTAG	TACGTAGGGGGCAAGCGTTATCCGGATTTACTGGGTGTAAAGGGAGCGTAGACGGAAGTGCAAGTCTGAAGTGAAAACTTGGGGCTCAACCCCGAGACTGCTTTGGAAACTGTGCTTCTAGAGTGTCGGAGAGGTAAGCGGAATTCCTAG	0.0
TACGTAGGGGGCAAGCGTTATCCGGATTTACTGGGTGTAAAGGGAGCGTAGACGGAAGTGCAAGTCTGAAGTGAAAGCCCGGGGCTCAACCCCGTGACTGCTTTGGAAACTGTGCTTCTAGAGTGTCGGAGAGGTAAGCGGAATTCCTAG	TACGTAGGGGGCAAGCGTTATCCGGATTTACTGGGTGTAAAGGGAGCGTAGACGGAAGTGCAAGTCTGAAGTGAAAGCCCGGGGCTCAACCCCGTGACTGCTTTGGAAACTGTGCTTCTAGAGTGTCGGAGAGGTAAGCGGAATTCCTAG	0.0
TACGTAGGGGGCAAGCGTTATCCGGATTTACTGGGTGTAAAGGGAGCGTAGACGGAGCAGCAAGTCTGATGTGAAAGGCGGGGGCTCAACCCCCGGACTGCATTGGAAACTGTTGATCTTGAGTACCGGAGAGGTAAGCGGAATTCCTAG	TACGTAGGGGGCAAGCGTTATCCGGATTTACTGGGTGTAAAGGGAGCGTAGACGGAGCAGCAAGTCTGATGTGAAAGGCGGGGGCTCAACCCCCGGACTGCATTGGAAACTGTTGATCTTGAGTACCGGAGAGGTAAGCGGAATTCCTAG	0.0
TACGTAGGGGGCAAGCGTTATCCGGATTTACTGGGTGTAAAGGGAGCGTAGACGGCAGTGCAAGTCTGAAGTGAAAGCCCGGGGCTCAACCCCGGGACTGCTTTGGAAACTGTGCAGCTAGAGTGTCGGAGAGGCAAGCGGAATTCCTAG	TACGTAGGGGGCAAGCGTTATCCGGATTTACTGGGTGTAAAGGGAGCGTAGACGGCAGTGCAAGTCTGAAGTGAAAGCCCGGGGCTCAACCCCGGGACTGCTTTGGAAACTGTGCAGCTAGAGTGTCGGAGAGGCAAGCGGAATTCCTAG	0.0
TACGTAGGGGGCAAGCGTTATCCGGATTTACTGGGTGTAAAGGGAGCGTAGACGGCATAGCAAGTCTGGAGTGAAAGCCCGGGGCTCAACCCCGGGACTGCTTTGGAAACTGTTAGGCTAGAGTGCTGGAGAGGTAAGTGGAATTCCTAG	TACGTAGGGGGCAAGCGTTATCCGGATTTACTGGGTGTAAAGGGAGCGTAGACGGCATAGCAAGTCTGGAGTGAAAGCCCGGGGCTCAACCCCGGGACTGCTTTGGAAACTGTTAGGCTAGAGTGCTGGAGAGGTAAGTGGAATTCCTAG	0.0
TACGTAGGGGGCAAGCGTTATCCGGATTTACTGGGTGTAAAGGGAGCGTAGACGGCATGGCAAGCCAGATGTGAAAGCCCGGGGCTCAACCCCGGGACTGCATTTGGAACTGTCAGGCTAGAGTGTCGGAGAGGTAAGCGGAATTCCTAG	TACGTAGGGGGCAAGCGTTATCCGGATTTACTGGGTGTAAAGGGAGCGTAGACGGCATGGCAAGCCAGATGTGAAAGCCCGGGGCTCAACCCCGGGACTGCATTTGGAACTGTCAGGCTAGAGTGTCGGAGAGGTAAGCGGAATTCCTAG	0.0
TACGTAGGGGGCGAGCGTTATCCGGATTCATTGGGCGTAAAGCGCGCGTAGGCGGCCCGGCAGGCAGGGGGTCAAATGGCGGGGCTCAACCCCGTCCCGCCCCCTGAACCGCCGGGCTCGGGTCCGGTAGGGGAGGGTGGAACACCCGGT	TACGTAGGGGGCGAGCGTTATCCGGATTCATTGGGCGTAAAGCGCGCGTAGGCGGCCCGGCAGGCAGGGGGTCAAATGGCGGGGCTCAACCCCGTCCCGCCCCCTGAACCGCCGGGCTCGGGTCCGGTAGGGGAGGGTGGAACACCCGGT	0.0
TACGTAGGGGGCGAGCGTTATCCGGATTCATTGGGCGTAAAGCGCGCGTAGGCGGCCGCGTAGGCGGGGGGTCAAATCCCGGGGCTCAACCCCGGTCCGCCCCCCGAACCCCGCGGCTCGGGTCCGGTAGGGGAGGGTGGAACACCCGGT	TACGTAGGGGGCGAGCGTTATCCGGATTCATTGGGCGTAAAGCGCGCGTAGGCGGCCGCGTAGGCGGGGGGTCAAATCCCGGGGCTCAACCCCGGTCCGCCCCCCGAACCCCGCGGCTCGGGTCCGGTAGGGGAGGGTGGAACACCCGGT	0.0
TACGTAGGGGGCGAGCGTTATCCGGATTCATTGGGCGTAAAGCGCGCGTAGGCGGCCGCGTAGGCGGGGGGTCAAATCCCGGGGCTCAACCCCGGTCCGCCCCCCGAACCCCGCGGCTCGGGTCCGGTAGGGGAGGGTGGAATTCCCGGT	TACGTAGGGGGCGAGCGTTATCCGGATTCATTGGGCGTAAAGCGCGCGTAGGCGGCCGCGTAGGCGGGGGGTCAAATCCCGGGGCTCAACCCCGGTCCGCCCCCCGAACCCCGCGGCTCGGGTCCGGTAGGGGAGGGTGGAATTCCCGGT	0.0
TACGTAGGGGGCGAGCGTTATCCGGATTCATTGGGCGTAAAGCGCGCGTAGGCGTCTCCTCAAGCGGCACCGTCGAAGCCGGGGGCTCAACCCCCGGAAGCGGGCCGAACTGGGGGGATCGAGTGCGGTAGGGGCAGGCGGAATTCCCGG	TACGTAGGGGGCGAGCGTTATCCGGATTCATTGGGCGTAAAGCGCGCGTAGGCGTCTCCTCAAGCGGCACCGTCGAAGCCGGGGGCTCAACCCCCGGAAGCGGGCCGAACTGGGGGGATCGAGTGCGGTAGGGGCAGGCGGAATTCCCGG	0.0
TACGTAGGGGGCTAGCGTTATCCGGAATTACTGGGCGTAAAGGGTGCGTAGGCGGTCTTTCAAGCCAGAAGTGAAAGGCTACGGCTCAACCGTAGTAAGCTTTTGGAACTGTAAGACTTGAGTGCAGGAGAGGAGAGTGGAATTCCTAGT	TACGTAGGGGGCTAGCGTTATCCGGAATTACTGGGCGTAAAGGGTGCGTAGGCGGTCTTTCAAGCCAGAAGTGAAAGGCTACGGCTCAACCGTAGTAAGCTTTTGGAACTGTAAGACTTGAGTGCAGGAGAGGAGAGTGGAATTCCTAGT	0.0
TACGTAGGGGGCTAGCGTTATCCGGAATTACTGGGCGTAAAGGGTGCGTAGGCGGTCTTTCAAGCCAGAAGTGAAAGGCTACGGCTCAACCGTAGTAAGCTTTTGGAACTGTAGGACTTGAGTGCAGGAGAGGAGAGTGGAATTCCTAGT	TACGTAGGGGGCTAGCGTTATCCGGAATTACTGGGCGTAAAGGGTGCGTAGGCGGTCTTTCAAGCCAGAAGTGAAAGGCTACGGCTCAACCGTAGTAAGCTTTTGGAACTGTAGGACTTGAGTGCAGGAGAGGAGAGTGGAATTCCTAGT	0.0
TACGTAGGGGGCTAGCGTTATCCGGAATTACTGGGCGTAAAGGGTGCGTAGGCGGTCTTTCAAGTCAGGAGTGAAAGGCTACGGCTCAACCGTAGTAAGCTCTTGAAACTGTAAGACTTGAGTGCAGGAGAGGAGAGTAGAATTCCTAGT	TACGTAGGGGGCTAGCGTTATCCGGAATTACTGGGCGTAAAGGGTGCGTAGGCGGTCTTTCAAGTCAGGAGTGAAAGGCTACGGCTCAACCGTAGTAAGCTCTTGAAACTGTAAGACTTGAGTGCAGGAGAGGAGAGTAGAATTCCTAGT	0.0
TACGTAGGGGGCTAGCGTTGTCCGGAATTACTGGGCGTAAAGGGTTCGCAGGCGGAAATGCAAGTCAGATGTGAAAGGCAGAGGCTTAACCTCTGTAAGCATCTGAAACTGTATTTCTTGAGATGTGGAGAGGCAAGTGGAATTCCTAGT	TACGTAGGGGGCTAGCGTTGTCCGGAATTACTGGGCGTAAAGGGTTCGCAGGCGGAAATGCAAGTCAGATGTGAAAGGCAGAGGCTTAACCTCTGTAAGCATCTGAAACTGTATTTCTTGAGATGTGGAGAGGCAAGTGGAATTCCTAGT	0.0
TACGTAGGGTGCAAGCGTTAATCGGAATTACTGGGCGTAAAGCGTGCGCAGGCGGTTCTGTAAGACAGATGTGAAATCCCCGGGCTCAACCTGGGAATTGCATTTGTGACTGCAGGACTAGAGTTCATCAGAGGGGGGTGGAATTCCAAG	TACGTAGGGTGCAAGCGTTAATCGGAATTACTGGGCGTAAAGCGTGCGCAGGCGGTTCTGTAAGACAGATGTGAAATCCCCGGGCTCAACCTGGGAATTGCATTTGTGACTGCAGGACTAGAGTTCATCAGAGGGGGGTGGAATTCCAAG	0.0
TACGTAGGGTGCAAGCGTTGTCCGGAATTACTGGGCGTAAAGAGTTCGTAGGCGGTTTGTCGCGTCGTTTGTGAAAACCAGCAGCTCAACTGCTGGCTTGCAGGCGATACGGGCAGACTTGAGTACTGCAGGGGAGACTGGAATTCCTGG	TACGTAGGGTGCAAGCGTTGTCCGGAATTACTGGGCGTAAAGAGTTCGTAGGCGGTTTGTCGCGTCGTTTGTGAAAACCAGCAGCTCAACTGCTGGCTTGCAGGCGATACGGGCAGACTTGAGTACTGCAGGGGAGACTGGAATTCCTGG	0.0
TACGTAGGTCCCAAGCGTTGTCCGGATTTATTGGGCGTAAAGCGAGCGCAGGTGGTTTCTTAAGTCTGATGTAAAAGGCAGTGGCTCAACCATTGTGTGCATTGGAAACTGGGAGACTTGAGTGCAGGAGAGGAGAGTGGAATTCCATGT	TACGTAGGTCCCAAGCGTTGTCCGGATTTATTGGGCGTAAAGCGAGCGCAGGTGGTTTCTTAAGTCTGATGTAAAAGGCAGTGGCTCAACCATTGTGTGCATTGGAAACTGGGAGACTTGAGTGCAGGAGAGGAGAGTGGAATTCCATGT	0.0
TACGTAGGTCCCGAGCGTTGTCCGGATTTATTGGGCGTAAAGCGAGCGCAGGCGGTTTGATAAGTCTGAAGTAAAAGGCTGTGGCTTAACCATAGTATGCTTTGGAAACTGTTAAACTTGAGTGCAGAAGGGGAGAGTGGAATTCCATGT	TACGTAGGTCCCGAGCGTTGTCCGGATTTATTGGGCGTAAAGCGAGCGCAGGCGGTTTGATAAGTCTGAAGTAAAAGGCTGTGGCTTAACCATAGTATGCTTTGGAAACTGTTAAACTTGAGTGCAGAAGGGGAGAGTGGAATTCCATGT	0.0
TACGTAGGTCCCGAGCGTTGTCCGGATTTATTGGGCGTAAAGCGAGCGCAGGTGGTTTAATAAGTCTGATGTAAAAGGCAGTGGCTCAACCATTGTGTGCATTGGAAACTGTTAGACTTGAGTGCAGTAGAGGAGAGTGGAATTCCATGT	TACGTAGGTCCCGAGCGTTGTCCGGATTTATTGGGCGTAAAGCGAGCGCAGGTGGTTTAATAAGTCTGATGTAAAAGGCAGTGGCTCAACCATTGTGTGCATTGGAAACTGTTAGACTTGAGTGCAGTAGAGGAGAGTGGAATTCCATGT	0.0
TACGTAGGTCCCGAGCGTTGTCCGGATTTATTGGGCGTAAAGCGAGCGCAGGTGGTTTATTAAGTCTGGTGTAAAAGGCAGTGGCTCAACCATTGTATGCATTGGAAACTGGTAGACTTGAGTGCAGGAGAGGAGAGTGGAATTCCATGT	TACGTAGGTCCCGAGCGTTGTCCGGATTTATTGGGCGTAAAGCGAGCGCAGGTGGTTTATTAAGTCTGGTGTAAAAGGCAGTGGCTCAACCATTGTATGCATTGGAAACTGGTAGACTTGAGTGCAGGAGAGGAGAGTGGAATTCCATGT	0.0
TACGTAGGTCTCGAGCGTTGTCCGGATTTATTGGGCGTAAAGCGAGCGCAGGCGGTTATTTAAGTCTGAAGTTAAAGGCCGTGGCTCAACCATGGTTCGCTTTGGAAACTGGATAACTTGAGTGCAGAAGGGGAGAGTGGAATTCCATGT	TACGTAGGTCTCGAGCGTTGTCCGGATTTATTGGGCGTAAAGCGAGCGCAGGCGGTTATTTAAGTCTGAAGTTAAAGGCCGTGGCTCAACCATGGTTCGCTTTGGAAACTGGATAACTTGAGTGCAGAAGGGGAGAGTGGAATTCCATGT	0.0
TACGTAGGTCTCGAGCGTTGTCCGGATTTATTGGGCGTAAAGCGAGCGCAGGCGGTTCTATAAGTCTGAAGTAAAAGGCAGTGGCTCAACCATTGTATGCTTTGGAAACTGTAGAACTTGAGTGCAGAAGGGGAGAGTGGAATTCCATGT	TACGTAGGTCTCGAGCGTTGTCCGGATTTATTGGGCGTAAAGCGAGCGCAGGCGGTTCTATAAGTCTGAAGTAAAAGGCAGTGGCTCAACCATTGTATGCTTTGGAAACTGTAGAACTTGAGTGCAGAAGGGGAGAGTGGAATTCCATGT	0.0
TACGTAGGTGGCAAGCGTTATCCGGAATGATTGGGCGTAAAGGGTGCGTAGGTGGTACATTAAGTCTGAAGTAAAAGGCAGCAGCTCAACTGCTGTTCGCTTTGGAAACTGGTGAACTAGAGTGCAGGAGAGGGCGATGGAATTCCATGT	TACGTAGGTGGCAAGCGTTATCCGGAATGATTGGGCGTAAAGGGTGCGTAGGTGGTACATTAAGTCTGAAGTAAAAGGCAGCAGCTCAACTGCTGTTCGCTTTGGAAACTGGTGAACTAGAGTGCAGGAGAGGGCGATGGAATTCCATGT	0.0
TACGTAGGTGGCAAGCGTTATCCGGAATTATTGGGCGTAAAGCGCGCGTAGGCGGTCTCTTAAGTCTGATGTGAAAGCCCCCGGCTCAACCGGGGAGGGTCATTGGAAACTGGGAGACTTGAGTGCAGAAGAGGAGAGTGGAATTCCATG	TACGTAGGTGGCAAGCGTTATCCGGAATTATTGGGCGTAAAGCGCGCGTAGGCGGTCTCTTAAGTCTGATGTGAAAGCCCCCGGCTCAACCGGGGAGGGTCATTGGAAACTGGGAGACTTGAGTGCAGAAGAGGAGAGTGGAATTCCATG	0.0
TACGTAGGTGGCAAGCGTTATCCGGAATTATTGGGCGTAAAGCGCGCGTAGGCGGTTTTTTAAGTCTGATGTGAAAGCCCACGGCTCAACCGTGGAGGGTCATTGGAAACTGGAAAACTTGAGTGCAGAAGAGGAAAGTGGAATTCCATG	TACGTAGGTGGCAAGCGTTATCCGGAATTATTGGGCGTAAAGCGCGCGTAGGCGGTTTTTTAAGTCTGATGTGAAAGCCCACGGCTCAACCGTGGAGGGTCATTGGAAACTGGAAAACTTGAGTGCAGAAGAGGAAAGTGGAATTCCATG	0.0
TACGTAGGTGGCAAGCGTTATCCGGATTTATTGGGCGTAAAGCGAGCGCAGGCGGTTTTCTAAGTCTGATGTGAAAGCCTTCGGCTTAACCGAAGAAGTGCATCGGAAACTGGATGACTTGAGTGCAGAAGAGGGCAGTGGAACTCCATG	TACGTAGGTGGCAAGCGTTATCCGGATTTATTGGGCGTAAAGCGAGCGCAGGCGGTTTTCTAAGTCTGATGTGAAAGCCTTCGGCTTAACCGAAGAAGTGCATCGGAAACTGGATGACTTGAGTGCAGAAGAGGGCAGTGGAACTCCATG	0.0
TACGTAGGTGGCAAGCGTTATCCGGATTTATTGGGCGTAAAGCGAGCGCAGGCGGTTTTTTAAGTCTGATGTGAAAGCCCTTGGCTCAACCAAGGAAGTGCATCGGAAACTGGAAAACTTGAGTGCAGAAGAGGACAGTGGAACTCCATG	TACGTAGGTGGCAAGCGTTATCCGGATTTATTGGGCGTAAAGCGAGCGCAGGCGGTTTTTTAAGTCTGATGTGAAAGCCCTTGGCTCAACCAAGGAAGTGCATCGGAAACTGGAAAACTTGAGTGCAGAAGAGGACAGTGGAACTCCATG	0.0
TACGTAGGTGGCAAGCGTTGTCCGGAATTATTGGGCGTAAAGGGAGCGCAGGCGGGAAATTAAGCGGATCTTAAAAGTGCGGGGCTCAACCTCGTGAGGGGGTCCGAACTGATTTTCTTGAGTGCAGGAGAGGAAAGCGGAATTCCCAGT	TACGTAGGTGGCAAGCGTTGTCCGGAATTATTGGGCGTAAAGGGAGCGCAGGCGGGAAATTAAGCGGATCTTAAAAGTGCGGGGCTCAACCTCGTGAGGGGGTCCGAACTGATTTTCTTGAGTGCAGGAGAGGAAAGCGGAATTCCCAGT	0.0
TACGTAGGTGGCAAGCGTTGTCCGGATTTACTGGGCGTAAAGAGTATGTAGGTGGGCACTTAAGTCAGATGTGAAATTCCCGGGCTTAACCTGGGAGCTGCATTTGATACTGGGTGTCTAGAGTGCAGGAGAGGAAAGTGGAATTCCTAG	TACGTAGGTGGCAAGCGTTGTCCGGATTTACTGGGCGTAAAGAGTATGTAGGTGGGCACTTAAGTCAGATGTGAAATTCCCGGGCTTAACCTGGGAGCTGCATTTGATACTGGGTGTCTAGAGTGCAGGAGAGGAAAGTGGAATTCCTAG	0.0
TACGTAGGTGGCAAGCGTTGTCCGGATTTACTGGGCGTAAAGGATGCGTAGGCGGATATTTAAGTGGGATGTGAAATACCCGGGCTCAACTTGGGTGCTGCATTCCAAACTGGATATCTAGAGTGCAGGAGAGGAAAGCGGAATTCCTAG	TACGTAGGTGGCAAGCGTTGTCCGGATTTACTGGGCGTAAAGGATGCGTAGGCGGATATTTAAGTGGGATGTGAAATACCCGGGCTCAACTTGGGTGCTGCATTCCAAACTGGATATCTAGAGTGCAGGAGAGGAAAGCGGAATTCCTAG	0.0
TACGTAGGTGGCAAGCGTTGTCCGGATTTACTGGGCGTAAAGGGAGCGTAGGTGGATTCTTAAGTGAGATGTGAAATACCCGGGCTTAACTTGGGTGCTGCATTTCAAACTGGGAATCTAGAGTGCAGGAGAGGAAAGTGGAATTCCTAG	TACGTAGGTGGCAAGCGTTGTCCGGATTTACTGGGCGTAAAGGGAGCGTAGGTGGATTCTTAAGTGAGATGTGAAATACCCGGGCTTAACTTGGGTGCTGCATTTCAAACTGGGAATCTAGAGTGCAGGAGAGGAAAGTGGAATTCCTAG	0.0
TACGTAGGTGGCAAGCGTTGTCCGGATTTATTGGGCGTAAAGCGAGCGCAGGCGGTTCTTTAAGTCTGATGTGAAAGCCCCCGGCTCAACCGGGGAGGGTCATTGGAAACTGGAGAACTTGAGTGCAGAAGAGGAGAGTGGAATTCCATG	TACGTAGGTGGCAAGCGTTGTCCGGATTTATTGGGCGTAAAGCGAGCGCAGGCGGTTCTTTAAGTCTGATGTGAAAGCCCCCGGCTCAACCGGGGAGGGTCATTGGAAACTGGAGAACTTGAGTGCAGAAGAGGAGAGTGGAATTCCATG	0.0
TACGTAGGTGGCAAGCGTTGTCCGGATTTATTGGGCGTAAAGGGAACGCAGGCGGTCCTTTAAGTCTGATGTGAAAGCCTTCGGCTTAACCGAAGAATTGCATTGGAAACTGGAGGACTTGAGTGCAGAAGAGGAGAGTGGAACTCCATG	TACGTAGGTGGCAAGCGTTGTCCGGATTTATTGGGCGTAAAGGGAACGCAGGCGGTCCTTTAAGTCTGATGTGAAAGCCTTCGGCTTAACCGAAGAATTGCATTGGAAACTGGAGGACTTGAGTGCAGAAGAGGAGAGTGGAACTCCATG	0.0
TACGTAGGTGGCGAGCGTTATCCGGAATGATTGGGCGTAAAGGGTGCGTAGGTGGCTTGTTAAGTCTGAAGTCAAAGCCGGCAGCTCAACTGTCGTACGCTTTGGAAACTGGCAGGCTCGAGTGCAGGAGAGGGCGATGGAACTCCATGT	TACGTAGGTGGCGAGCGTTATCCGGAATGATTGGGCGTAAAGGGTGCGTAGGTGGCTTGTTAAGTCTGAAGTCAAAGCCGGCAGCTCAACTGTCGTACGCTTTGGAAACTGGCAGGCTCGAGTGCAGGAGAGGGCGATGGAACTCCATGT	0.0
TACGTAGGTGGCGAGCGTTATCCGGAATGATTGGGCGTAAAGGGTGCGTAGGTGGCTTGTTAAGTCTGGAGTCAAAGCCGGCAGCTCAACTGTCGTACGCTTTGGAAACTGGCAAGCTAGAGTGCAGGAGAGGGCAATGGAACTCCATGT	TACGTAGGTGGCGAGCGTTATCCGGAATGATTGGGCGTAAAGGGTGCGTAGGTGGCTTGTTAAGTCTGGAGTCAAAGCCGGCAGCTCAACTGTCGTACGCTTTGGAAACTGGCAAGCTAGAGTGCAGGAGAGGGCAATGGAACTCCATGT	0.0
TACGTAGGTGGCGAGCGTTATCCGGATTTACTGGGCGTAAAGGGAGCGTAGGCGGATGATTAAGTGGGATGTGAAATACCCGGGCTCAACTTGGGTGCTGCATTCCAAACTGGTTATCTAGAGTGCAGGAGAGGAGAGTGGAATTCCTAG	TACGTAGGTGGCGAGCGTTATCCGGATTTACTGGGCGTAAAGGGAGCGTAGGCGGATGATTAAGTGGGATGTGAAATACCCGGGCTCAACTTGGGTGCTGCATTCCAAACTGGTTATCTAGAGTGCAGGAGAGGAGAGTGGAATTCCTAG	0.0
TACGTAGGTGGCGAGCGTTGTCCGGAATTATTGGGCGTAAAGAGCATGTAGGCGGTTTCTTAAGTCTGGAGTGAAAATGCGGGGCTCAACCCCGTATGGCTCTGGATACTGGGAGACTTGAGTGCAGGAGAGGAAAGGGGAATTCCCAGT	TACGTAGGTGGCGAGCGTTGTCCGGAATTATTGGGCGTAAAGAGCATGTAGGCGGTTTCTTAAGTCTGGAGTGAAAATGCGGGGCTCAACCCCGTATGGCTCTGGATACTGGGAGACTTGAGTGCAGGAGAGGAAAGGGGAATTCCCAGT	0.0
TACGTAGGTGGCGAGCGTTGTCCGGATTTACTGGGCGTAAAGGGAGCGTAGGCGGATTCTTAAGTGGGATGTGAAATACCCGGGCTCAACCTGGGTGCTGCATTCCAAACTGGGAATCTAGAGTGCAGGAGGGGAGAGTGGAATTCCTAG	TACGTAGGTGGCGAGCGTTGTCCGGATTTACTGGGCGTAAAGGGAGCGTAGGCGGATTCTTAAGTGGGATGTGAAATACCCGGGCTCAACCTGGGTGCTGCATTCCAAACTGGGAATCTAGAGTGCAGGAGGGGAGAGTGGAATTCCTAG	0.0
TACGTAGGTGGCGAGCGTTGTCCGGATTTACTGGGCGTAAAGGGAGCGTAGGCGGATTCTTAAGTGGGATGTGAAATACTCGGGCTTAACCTGAGTGCTGCATTCCAAACTGGGAATCTAGAGTGCAGGAGGGGAGAGTGGAATTCCTAG	TACGTAGGTGGCGAGCGTTGTCCGGATTTACTGGGCGTAAAGGGAGCGTAGGCGGATTCTTAAGTGGGATGTGAAATACTCGGGCTTAACCTGAGTGCTGCATTCCAAACTGGGAATCTAGAGTGCAGGAGGGGAGAGTGGAATTCCTAG	0.0
TACGTAGGTGGCGAGCGTTGTCCGGATTTACTGGGCGTAAAGGGTGCGTAGGCGGACTTTTAAGTGAGATGTGAAATACCCGGGCTTAACTTGGGTGCTGCATTTCAAACTGGAAGTCTAGAGTGCAGGAGAGGAAAGTGGAATTCCTAG	TACGTAGGTGGCGAGCGTTGTCCGGATTTACTGGGCGTAAAGGGTGCGTAGGCGGACTTTTAAGTGAGATGTGAAATACCCGGGCTTAACTTGGGTGCTGCATTTCAAACTGGAAGTCTAGAGTGCAGGAGAGGAAAGTGGAATTCCTAG	0.0
TACGTAGGTGGCGAGCGTTGTCCGGATTTATTGGGCGTAAAGCATGCGTAGGCGGATACTTAAGTGGGATGTGAAATCCCGGGGCTCAACCCCGGTGCTGCATTCCAAACTGGGTATCTAGAGTACAGGAGAGGAAAGCGGAATTCCTAG	TACGTAGGTGGCGAGCGTTGTCCGGATTTATTGGGCGTAAAGCATGCGTAGGCGGATACTTAAGTGGGATGTGAAATCCCGGGGCTCAACCCCGGTGCTGCATTCCAAACTGGGTATCTAGAGTACAGGAGAGGAAAGCGGAATTCCTAG	0.0
TACGTATGGTGCAAGCGTTATCCGGATTTACTGGGTGTAAAGGGAGCGTAGACGGATGAGCAAGTCTGATGTGAAAACCCGGGGCTCAACCCCGGGACTGCATTGGAAACTGTTTATCTAGAGTGCTGGAGAGGTAAGTGGAATTCCTAG	TACGTATGGTGCAAGCGTTATCCGGATTTACTGGGTGTAAAGGGAGCGTAGACGGATGAGCAAGTCTGATGTGAAAACCCGGGGCTCAACCCCGGGACTGCATTGGAAACTGTTTATCTAGAGTGCTGGAGAGGTAAGTGGAATTCCTAG	0.0
TACGTATGTCGCAAGCGTTATCCGGATTTATTGGGCGTAAAGCGCGTCTAGGCGGTCTGGTAAGTCTGATGTGGAAATGCGGGGCTCAACTCCGTATTGCGTTGGAAACTGCCAGACTAGAGTACTGGAGAGGTGGGCGGAACTACAAGT	TACGTATGTCGCAAGCGTTATCCGGATTTATTGGGCGTAAAGCGCGTCTAGGCGGTCTGGTAAGTCTGATGTGGAAATGCGGGGCTCAACTCCGTATTGCGTTGGAAACTGCCAGACTAGAGTACTGGAGAGGTGGGCGGAACTACAAGT	0.0
TACGTATGTCGCAAGCGTTATCCGGATTTATTGGGCGTAAAGCGCGTCTAGGTGGTTTGGTAAGTCTGATGTGAAAATGCGGGGCTCAACTCCGTATTGCGTTGGAAACTGCCTAACTAGAGTATCGGAGAGGTGGGCGGAACTACAAGT	TACGTATGTCGCAAGCGTTATCCGGATTTATTGGGCGTAAAGCGCGTCTAGGTGGTTTGGTAAGTCTGATGTGAAAATGCGGGGCTCAACTCCGTATTGCGTTGGAAACTGCCTAACTAGAGTATCGGAGAGGTGGGCGGAACTACAAGT	0.0
