	sequence	group
TAGGGAATCTTCCGCAATGGGCGAAAGCCTGACGGAGCAACGCCGCGTGAGTGATGAAGGTCTTCGGATCGTAAAACTCTGTTATCAGGGAAGAACAAATGTGTAAGTAACTGTGCACATCTTGACGGTACCTGATCAGAAAGCCACGGC	TAGGGAATCTTCCGCAATGGGCGAAAGCCTGACGGAGCAACGCCGCGTGAGTGATGAAGGTCTTCGGATCGTAAAACTCTGTTATCAGGGAAGAACAAATGTGTAAGTAACTGTGCACATCTTGACGGTACCTGATCAGAAAGCCACGGC	1.0
TAGGGAATTTTCGGCAATGGGGGAAACCCTGACCGAGCAACGCCGCGTGAAGGAAGAAGTAATTCGTTATGTAAACTTCTGTCATAGAGGAAGAACGGTGCGTGTAGGGAATGACATGCAAGTGACGGTACTCTATAAGAAAGCCACGGC	TAGGGAATTTTCGGCAATGGGGGAAACCCTGACCGAGCAACGCCGCGTGAAGGAAGAAGTAATTCGTTATGTAAACTTCTGTCATAGAGGAAGAACGGTGCGTGTAGGGAATGACATGCAAGTGACGGTACTCTATAAGAAAGCCACGGC	1.0
TAGGGAATTTTCGGCAATGGGGGAAACCCTGACCGAGCAACGCCGCGTGAAGGAAGAAGTAATTCGTTATGTAAACTTCTGTCATAGAGGAAGAACGGTGGATATAGGGAATGATATCCAAGTGACGGTACTCTATAAGAAAGCCACGGC	TAGGGAATTTTCGGCAATGGGGGAAACCCTGACCGAGCAACGCCGCGTGAAGGAAGAAGTAATTCGTTATGTAAACTTCTGTCATAGAGGAAGAACGGTGGATATAGGGAATGATATCCAAGTGACGGTACTCTATAAGAAAGCCACGGC	1.0
TAGGGAATTTTCGGCAATGGGGGAAACCCTGACCGAGCAATGCCGCGTGAGTGAAGACGGCCTTCGGGTTGTAAAGCTCTGTTGTAAGGGAAGAACGGCATAGAGAGGGAATGCTCTATGAGTGACGGTACCTTACCAGAAAGCCACGGC	TAGGGAATTTTCGGCAATGGGGGAAACCCTGACCGAGCAATGCCGCGTGAGTGAAGACGGCCTTCGGGTTGTAAAGCTCTGTTGTAAGGGAAGAACGGCATAGAGAGGGAATGCTCTATGAGTGACGGTACCTTACCAGAAAGCCACGGC	1.0
TGAGGAATATTGGTCAATGGACGAGAGTCTGAACCAGCCAAGTAGCGTGAAGGATGACTGCCCTATGGGTTGTAAACTTCTTTTATACGGGAATAAAGTGAGGCACGCGTGCCTTTTTGTATGTACCGTATGAATAAGGATCGGCTAACT	TGAGGAATATTGGTCAATGGACGAGAGTCTGAACCAGCCAAGTAGCGTGAAGGATGACTGCCCTATGGGTTGTAAACTTCTTTTATACGGGAATAAAGTGAGGCACGCGTGCCTTTTTGTATGTACCGTATGAATAAGGATCGGCTAACT	1.0
TGAGGAATATTGGTCAATGGACGAGAGTCTGAACCAGCCAAGTAGCGTGAAGGATGACTGCCCTATGGGTTGTAAACTTCTTTTATACGGGAATAAAGTGAGGCACGTGTGCCTTTTTGTATGTACCGTATGAATAAGGATCGGCTAACT	TGAGGAATATTGGTCAATGGACGAGAGTCTGAACCAGCCAAGTAGCGTGAAGGATGACTGCCCTATGGGTTGTAAACTTCTTTTATACGGGAATAAAGTGAGGCACGTGTGCCTTTTTGTATGTACCGTATGAATAAGGATCGGCTAACT	1.0
TGAGGAATATTGGTCAATGGACGAGAGTCTGAACCAGCCAAGTAGCGTGAAGGATGACTGCCCTATGGGTTGTAAACTTCTTTTATATGGGAATAAAGTATTCCACGTGTGGAATTTTGTATGTACCATATGAATAAGGATCGGCTAACT	TGAGGAATATTGGTCAATGGACGAGAGTCTGAACCAGCCAAGTAGCGTGAAGGATGACTGCCCTATGGGTTGTAAACTTCTTTTATATGGGAATAAAGTATTCCACGTGTGGAATTTTGTATGTACCATATGAATAAGGATCGGCTAACT	1.0
TGAGGAATATTGGTCAATGGACGAGAGTCTGAACCAGCCAAGTAGCGTGAAGGATGACTGCCCTATGGGTTGTAAACTTCTTTTATATGGGAATAAAGTGAGCCACGTGTGGCTTTTTGTATGTACCATACGAATAAGGATCGGCTAACT	TGAGGAATATTGGTCAATGGACGAGAGTCTGAACCAGCCAAGTAGCGTGAAGGATGACTGCCCTATGGGTTGTAAACTTCTTTTATATGGGAATAAAGTGAGCCACGTGTGGCTTTTTGTATGTACCATACGAATAAGGATCGGCTAACT	1.0
TGAGGAATATTGGTCAATGGACGCAAGTCTGAACCAGCCATGCCGCGTGCAGGAAGACGGCTCTATGAGTTGTAAACTGCTTTTGTACGAGGGTAAACTCACCTACGTGTAGGTGACTGAAAGTATCGTACGAATAAGGATCGGCTAACT	TGAGGAATATTGGTCAATGGACGCAAGTCTGAACCAGCCATGCCGCGTGCAGGAAGACGGCTCTATGAGTTGTAAACTGCTTTTGTACGAGGGTAAACTCACCTACGTGTAGGTGACTGAAAGTATCGTACGAATAAGGATCGGCTAACT	1.0
TGAGGAATATTGGTCAATGGACGCAAGTCTGAACCAGCCATGCCGCGTGCAGGATGAAGGTGCTATGCATTGTAAACTGCTTTTGTACGAGGGTAAATTCAGATACGTGTATCTGTTTGAAAGTATCGTACGAATAAGGATCGGCTAACT	TGAGGAATATTGGTCAATGGACGCAAGTCTGAACCAGCCATGCCGCGTGCAGGATGAAGGTGCTATGCATTGTAAACTGCTTTTGTACGAGGGTAAATTCAGATACGTGTATCTGTTTGAAAGTATCGTACGAATAAGGATCGGCTAACT	1.0
TGAGGAATATTGGTCAATGGCCGAGAGGCTGAACCAGCCAAGTCGCGTGAAGGAAGAAGGATCTATGGTTTGTAAACTTCTTTTATAGGGGAATAAAGTGGAGGACGTGTCCTTTTTTGTATGTACCCTATGAATAAGCATCGGCTAACT	TGAGGAATATTGGTCAATGGCCGAGAGGCTGAACCAGCCAAGTCGCGTGAAGGAAGAAGGATCTATGGTTTGTAAACTTCTTTTATAGGGGAATAAAGTGGAGGACGTGTCCTTTTTTGTATGTACCCTATGAATAAGCATCGGCTAACT	1.0
TGAGGAATATTGGTCAATGGCCGAGAGGCTGAACCAGCCAAGTCGCGTGAGGGATGAAGGTTCTATGGATCGTAAACCTCTTTTATAAGGGAATAAAGTGCGGGACGTGTCCCGTTTTGTATGTACCTTATGAATAAGGATCGGCTAACT	TGAGGAATATTGGTCAATGGCCGAGAGGCTGAACCAGCCAAGTCGCGTGAGGGATGAAGGTTCTATGGATCGTAAACCTCTTTTATAAGGGAATAAAGTGCGGGACGTGTCCCGTTTTGTATGTACCTTATGAATAAGGATCGGCTAACT	1.0
TGAGGAATATTGGTCAATGGGCGAGAGCCTGAACCAGCCAAGTAGCGTGAAGGATGACTGCCCTATGGGTTGTAAACTTCTTTTATAAAGGAATAAAGTCGGGTATGCATACCCGTTTGCATGTACTTTATGAATAAGGATCGGCTAACT	TGAGGAATATTGGTCAATGGGCGAGAGCCTGAACCAGCCAAGTAGCGTGAAGGATGACTGCCCTATGGGTTGTAAACTTCTTTTATAAAGGAATAAAGTCGGGTATGCATACCCGTTTGCATGTACTTTATGAATAAGGATCGGCTAACT	1.0
TGAGGAATATTGGTCAATGGGCGAGAGCCTGAACCAGCCAAGTAGCGTGAAGGATGACTGCCCTATGGGTTGTAAACTTCTTTTATAAAGGAATAAAGTCGGGTATGGATACCCGTTTGCATGTACTTTATGAATAAGGATCGGCTAACT	TGAGGAATATTGGTCAATGGGCGAGAGCCTGAACCAGCCAAGTAGCGTGAAGGATGACTGCCCTATGGGTTGTAAACTTCTTTTATAAAGGAATAAAGTCGGGTATGGATACCCGTTTGCATGTACTTTATGAATAAGGATCGGCTAACT	1.0
TGAGGAATATTGGTCAATGGGCGCAGGCCTGAACCAGCCAAGTAGCGTGAAGGATGACTGCCCTATGGGTTGTAAACTTCTTTTATAAAGGAATAAAGTCGGGTATGTATACCCGTTTGCATGTACTTTATGAATAAGGATCGGCTAACT	TGAGGAATATTGGTCAATGGGCGCAGGCCTGAACCAGCCAAGTAGCGTGAAGGATGACTGCCCTATGGGTTGTAAACTTCTTTTATAAAGGAATAAAGTCGGGTATGTATACCCGTTTGCATGTACTTTATGAATAAGGATCGGCTAACT	1.0
TGAGGAATATTGGTCAATGGGCGCAGGCCTGAACCAGCCAAGTAGCGTGAAGGATGACTGCCCTATGGGTTGTAAACTTCTTTTATATGGGAATAAAGTTTTCCACGTGTGGAATTTTGTATGTACCATATGAATAAGGATCGGCTAACT	TGAGGAATATTGGTCAATGGGCGCAGGCCTGAACCAGCCAAGTAGCGTGAAGGATGACTGCCCTATGGGTTGTAAACTTCTTTTATATGGGAATAAAGTTTTCCACGTGTGGAATTTTGTATGTACCATATGAATAAGGATCGGCTAACT	1.0
TGAGGAATATTGGTCAATGGGCGGGAGCCTGAACCAGCCAAGTAGCGTGAAGGACGACGGCCCTACGGGTTGTAAACTTCTTTTATAAGGGAATAAAGTTCGCCACGTGTGGTGTTTTGTATGTACCTTATGAATAAGCATCGGCTAATT	TGAGGAATATTGGTCAATGGGCGGGAGCCTGAACCAGCCAAGTAGCGTGAAGGACGACGGCCCTACGGGTTGTAAACTTCTTTTATAAGGGAATAAAGTTCGCCACGTGTGGTGTTTTGTATGTACCTTATGAATAAGCATCGGCTAATT	1.0
TGAGGAATATTGGTCAATGGGCGTAAGCCTGAACCAGCCAAGTCGCGTGAGGGATGAAGGTTCTATGGATCGTAAACCTCTTTTATAAGGGAATAAAGTGTGGGACGTGTCCTATTTTGTATGTACCTTATGAATAAGGATCGGCTAACT	TGAGGAATATTGGTCAATGGGCGTAAGCCTGAACCAGCCAAGTCGCGTGAGGGATGAAGGTTCTATGGATCGTAAACCTCTTTTATAAGGGAATAAAGTGTGGGACGTGTCCTATTTTGTATGTACCTTATGAATAAGGATCGGCTAACT	1.0
TGAGGGATATTGGGCAATGGGGGAAACCCTGACCCAGCAACGCCGCGTGAGGGATGACGGTTTTCGGATTGTAAACCTCTGTCCTCTGTGAAGATAGTGACGGTAGCAGAGGAGGAAGCTCCGGCTAACTACGTGCCAGCAGCCGCGGTA	TGAGGGATATTGGGCAATGGGGGAAACCCTGACCCAGCAACGCCGCGTGAGGGATGACGGTTTTCGGATTGTAAACCTCTGTCCTCTGTGAAGATAGTGACGGTAGCAGAGGAGGAAGCTCCGGCTAACTACGTGCCAGCAGCCGCGGTA	1.0
TGAGGGATATTGGTCAATGGGGGAAACCCTGAACCAGCAACGCCGCGTGAGGGATGACGGCCTTCGGGTTGTAAACCTCTGTCCTCTGTGAAGATAATGACGGTAGCAGAGGAGGAAGCTCCGGCTAACTACGTGCCAGCAGCCGCGGTA	TGAGGGATATTGGTCAATGGGGGAAACCCTGAACCAGCAACGCCGCGTGAGGGATGACGGCCTTCGGGTTGTAAACCTCTGTCCTCTGTGAAGATAATGACGGTAGCAGAGGAGGAAGCTCCGGCTAACTACGTGCCAGCAGCCGCGGTA	1.0
TGGGGAATATTGCACAATGGAGGAAACTCTGATGCAGCGACGCCGCGTGAGTGAAGAAGTAATTCGTTATGTAAAGCTCTATCAGCAGGGAAGATAGTGACGGTACCTGACTAAGAAGCTCCGGCTAAATACGTGCCAGCAGCCGCGGTA	TGGGGAATATTGCACAATGGAGGAAACTCTGATGCAGCGACGCCGCGTGAGTGAAGAAGTAATTCGTTATGTAAAGCTCTATCAGCAGGGAAGATAGTGACGGTACCTGACTAAGAAGCTCCGGCTAAATACGTGCCAGCAGCCGCGGTA	1.0
TGGGGAATATTGCACAATGGAGGAAACTCTGATGCAGCGACGCCGCGTGAGTGAAGAAGTAGTTCGCTATGTAAAGCTCTATCAGCAGGGAAGATAGTGACGGTACCTGACTAAGAAGCTCCGGCTAAATACGTGCCAGCAGCCGCGGTA	TGGGGAATATTGCACAATGGAGGAAACTCTGATGCAGCGACGCCGCGTGAGTGAAGAAGTAGTTCGCTATGTAAAGCTCTATCAGCAGGGAAGATAGTGACGGTACCTGACTAAGAAGCTCCGGCTAAATACGTGCCAGCAGCCGCGGTA	1.0
TGGGGAATATTGCACAATGGAGGAAACTCTGATGCAGCGACGCCGCGTGAGTGAAGAAGTATTTCGGTATGTAAAGCTCTATCAGCAGGGAAGAAAATGACGGTACCTGACTAAGAAGCACCGGCTAAATACGTGCCAGCAGCCGCGGTA	TGGGGAATATTGCACAATGGAGGAAACTCTGATGCAGCGACGCCGCGTGAGTGAAGAAGTATTTCGGTATGTAAAGCTCTATCAGCAGGGAAGAAAATGACGGTACCTGACTAAGAAGCACCGGCTAAATACGTGCCAGCAGCCGCGGTA	1.0
TGGGGAATATTGCACAATGGGCGAAAGCCTGATGCAGCAACGCCGCGTGAAGGAAGAAGGTCTTCGGATCGTAAACTTCTGTCCTTGGGGAAGATAATGACGGTACCCTTGGAGGAAGCCCCGGCTAACTACGTGCCAGCAGCCGCGGTA	TGGGGAATATTGCACAATGGGCGAAAGCCTGATGCAGCAACGCCGCGTGAAGGAAGAAGGTCTTCGGATCGTAAACTTCTGTCCTTGGGGAAGATAATGACGGTACCCTTGGAGGAAGCCCCGGCTAACTACGTGCCAGCAGCCGCGGTA	1.0
TGGGGAATATTGCACAATGGGCGAAAGCCTGATGCAGCGACGCCGCGTGAAGGATGAAGTATTTCGGTATGTAAACTTCTATCAGCAGGGAAGAAAATGACGGTACCTGACTAAGAAGCCCCGGCTAACTACGTGCCAGCAGCCGCGGTA	TGGGGAATATTGCACAATGGGCGAAAGCCTGATGCAGCGACGCCGCGTGAAGGATGAAGTATTTCGGTATGTAAACTTCTATCAGCAGGGAAGAAAATGACGGTACCTGACTAAGAAGCCCCGGCTAACTACGTGCCAGCAGCCGCGGTA	1.0
TGGGGAATATTGCACAATGGGCGAAAGCCTGATGCAGCGACGCCGCGTGAGCGAAGAAGTATTTCGGTATGTAAAGCTCTATCAGCAGGGAAGATAATGACGGTACCTGACTAAGAAGCACCGGCTAAATACGTGCCAGCAGCCGCGGTA	TGGGGAATATTGCACAATGGGCGAAAGCCTGATGCAGCGACGCCGCGTGAGCGAAGAAGTATTTCGGTATGTAAAGCTCTATCAGCAGGGAAGATAATGACGGTACCTGACTAAGAAGCACCGGCTAAATACGTGCCAGCAGCCGCGGTA	1.0
TGGGGAATATTGCACAATGGGGGAAACCCTGATGCAGCAACGCCGCGTGAACGAAGAAGGCTCTTGGGTCGTAAAGTTCTGTTCTGAGGGAAGAAGAAAGTGACGGTACCTCAGGAGAAAGCCCCGGCTAACTACGTGCCAGCAGCCGCG	TGGGGAATATTGCACAATGGGGGAAACCCTGATGCAGCAACGCCGCGTGAACGAAGAAGGCTCTTGGGTCGTAAAGTTCTGTTCTGAGGGAAGAAGAAAGTGACGGTACCTCAGGAGAAAGCCCCGGCTAACTACGTGCCAGCAGCCGCG	1.0
TGGGGAATATTGCACAATGGGGGAAACCCTGATGCAGCAACGCCGCGTGAAGGAAGAAGGCCTTTGGGTCGTAAACTTCTGTTCTGAGGGAAGAAGAAAGTGACGGTACCTCAGGAGAAAGCCCCGGCTAACTACGTGCCAGCAGCCGCG	TGGGGAATATTGCACAATGGGGGAAACCCTGATGCAGCAACGCCGCGTGAAGGAAGAAGGCCTTTGGGTCGTAAACTTCTGTTCTGAGGGAAGAAGAAAGTGACGGTACCTCAGGAGAAAGCCCCGGCTAACTACGTGCCAGCAGCCGCG	1.0
TGGGGAATATTGCACAATGGGGGAAACCCTGATGCAGCAACGCCGCGTGAAGGAAGACGGTTTTCGGATTGTAAACTTCTGTTCTTAGTGAAGAATAATGACGGTAGCTAAGGAGCAAGCCACGGCTAACTACGTGCCAGCAGCCGCGGT	TGGGGAATATTGCACAATGGGGGAAACCCTGATGCAGCAACGCCGCGTGAAGGAAGACGGTTTTCGGATTGTAAACTTCTGTTCTTAGTGAAGAATAATGACGGTAGCTAAGGAGCAAGCCACGGCTAACTACGTGCCAGCAGCCGCGGT	1.0
TGGGGAATATTGCACAATGGGGGAAACCCTGATGCAGCAACGCCGCGTGAAGGATGAAGGCCTTTGGGTCGTAAACTTCTGTTCTAAGGGAAGATAGTGACGGTACCTTAGGAGCAAGTCCCGGCTAACTACGTGCCAGCAGCCGCGGTA	TGGGGAATATTGCACAATGGGGGAAACCCTGATGCAGCAACGCCGCGTGAAGGATGAAGGCCTTTGGGTCGTAAACTTCTGTTCTAAGGGAAGATAGTGACGGTACCTTAGGAGCAAGTCCCGGCTAACTACGTGCCAGCAGCCGCGGTA	1.0
TGGGGAATATTGCACAATGGGGGAAACCCTGATGCAGCAACGCCGCGTGAGTGAAGAAGTATTTCGGTATGTAAAGCTCTATCAGCAGGAAAGAAAATGACGGTACCTGACTAAGAAGCCCCGGCTAACTACGTGCCAGCAGCCGCGGTA	TGGGGAATATTGCACAATGGGGGAAACCCTGATGCAGCAACGCCGCGTGAGTGAAGAAGTATTTCGGTATGTAAAGCTCTATCAGCAGGAAAGAAAATGACGGTACCTGACTAAGAAGCCCCGGCTAACTACGTGCCAGCAGCCGCGGTA	1.0
TGGGGAATATTGCACAATGGGGGAAACCCTGATGCAGCGACGCCGCGTGAAGGAAGAAGTATCTCGGTATGTAAACTTCTATCAGCAGGGAAGATAGTGACGGTACCTGACTAAGAAGCCCCGGCTAACTACGTGCCAGCAGCCGCGGTA	TGGGGAATATTGCACAATGGGGGAAACCCTGATGCAGCGACGCCGCGTGAAGGAAGAAGTATCTCGGTATGTAAACTTCTATCAGCAGGGAAGATAGTGACGGTACCTGACTAAGAAGCCCCGGCTAACTACGTGCCAGCAGCCGCGGTA	1.0
TGGGGAATATTGCACAATGGGGGAAACCCTGATGCAGCGACGCCGCGTGAGCGAAGAAGTATTTCGGTATGTAAAGCTCTATCAGCAGGGAAGAAGAAATGACGGTACCTGACTAAGAAGCACCGGCTAAATACGTGCCAGCAGCCGCGG	TGGGGAATATTGCACAATGGGGGAAACCCTGATGCAGCGACGCCGCGTGAGCGAAGAAGTATTTCGGTATGTAAAGCTCTATCAGCAGGGAAGAAGAAATGACGGTACCTGACTAAGAAGCACCGGCTAAATACGTGCCAGCAGCCGCGG	1.0
TGGGGAATATTGCACAATGGGGGAAACCCTGATGCAGCGACGCCGCGTGAGCGAAGAAGTATTTCGGTATGTAAAGCTCTATCAGCAGGGAAGAAGAATGACGGTACCTGACTAAGAAGCACCGGCTAAATACGTGCCAGCAGCCGCGGT	TGGGGAATATTGCACAATGGGGGAAACCCTGATGCAGCGACGCCGCGTGAGCGAAGAAGTATTTCGGTATGTAAAGCTCTATCAGCAGGGAAGAAGAATGACGGTACCTGACTAAGAAGCACCGGCTAAATACGTGCCAGCAGCCGCGGT	1.0
TGGGGAATATTGCACAATGGGGGAAACCCTGATGCAGCGACGCCGCGTGAGCGATGAAGTATTTCGGTATGTAAAGCTCTATCAGCAGGGAAGAATTAGGACGGTACCTGACTAAGAAGCACCGGCTAAATACGTGCCAGCAGCCGCGGT	TGGGGAATATTGCACAATGGGGGAAACCCTGATGCAGCGACGCCGCGTGAGCGATGAAGTATTTCGGTATGTAAAGCTCTATCAGCAGGGAAGAATTAGGACGGTACCTGACTAAGAAGCACCGGCTAAATACGTGCCAGCAGCCGCGGT	1.0
TGGGGAATATTGCACAATGGGGGAAACCCTGATGCAGCGACGCCGCGTGAGTGAAGAAGTATTTCGGTATGTAAAGCTCTATCAGCAGGGAAGAAAGTGACGGTACCTGAATAAGAAGCCCCGGCTAACTACGTGCCAGCAGCCGCGGTA	TGGGGAATATTGCACAATGGGGGAAACCCTGATGCAGCGACGCCGCGTGAGTGAAGAAGTATTTCGGTATGTAAAGCTCTATCAGCAGGGAAGAAAGTGACGGTACCTGAATAAGAAGCCCCGGCTAACTACGTGCCAGCAGCCGCGGTA	1.0
TGGGGAATATTGCACAATGGGGGAAACCCTGATGCAGCGACGCCGCGTGAGTGAGGAAGTATTTCGGTATGTAAAGCTCTATCAGCAGGGAAGAAGAAATGACGGTACCTGACTAAGAAGCCCCGGCTAACTACGTGCCAGCAGCCGCGG	TGGGGAATATTGCACAATGGGGGAAACCCTGATGCAGCGACGCCGCGTGAGTGAGGAAGTATTTCGGTATGTAAAGCTCTATCAGCAGGGAAGAAGAAATGACGGTACCTGACTAAGAAGCCCCGGCTAACTACGTGCCAGCAGCCGCGG	1.0
TGGGGAATATTGCACAATGGGGGAAACCCTGATGCAGCGACGCCGCGTGGAGGAAGAAGGTCTTCGGATTGTAAACTCCTGTTGTTGAGGAAGATAATGACGGTACTCAACAAGGAAGTGACGGCTAACTACGTGCCAGCAGCCGCGGTA	TGGGGAATATTGCACAATGGGGGAAACCCTGATGCAGCGACGCCGCGTGGAGGAAGAAGGTCTTCGGATTGTAAACTCCTGTTGTTGAGGAAGATAATGACGGTACTCAACAAGGAAGTGACGGCTAACTACGTGCCAGCAGCCGCGGTA	1.0
TGGGGAATATTGCACAATGGGGGAAACCCTGATGCAGCGATGCCGCGTGAAGGAAGAAGATTTTCGGATTGTAAACTTCTATCAGCAAGGAAGAAAACGGACAGTACTTGAGTAAGAAGCCCCGGCTAACTACGTGCCAGCAGCCGCGGT	TGGGGAATATTGCACAATGGGGGAAACCCTGATGCAGCGATGCCGCGTGAAGGAAGAAGATTTTCGGATTGTAAACTTCTATCAGCAAGGAAGAAAACGGACAGTACTTGAGTAAGAAGCCCCGGCTAACTACGTGCCAGCAGCCGCGGT	1.0
TGGGGAATATTGCGCAATGGGCGAAAGCCTGACGCAGCGACGCCGCGTGAGGGATGAAGGTTCTCGGATCGTAAACCTCTGTCAGGGGGGAAGAAACCCCCTCGTGTGAATAATGCGAGGGCTTGACGGTACCCCCAAAGGAAGCACCGG	TGGGGAATATTGCGCAATGGGCGAAAGCCTGACGCAGCGACGCCGCGTGAGGGATGAAGGTTCTCGGATCGTAAACCTCTGTCAGGGGGGAAGAAACCCCCTCGTGTGAATAATGCGAGGGCTTGACGGTACCCCCAAAGGAAGCACCGG	1.0
TGGGGAATATTGCGCAATGGGCGAAAGCCTGACGCAGCGACGCCGCGTGAGGGATGACGGCCTTCGGGTTGTAAACCTCTTTCAGCTCCGACGAAGCGCAAGTGACGGTAGGAGCAGAAGAAGCACCGGCCAACTACGTGCCAGCAGCCG	TGGGGAATATTGCGCAATGGGCGAAAGCCTGACGCAGCGACGCCGCGTGAGGGATGACGGCCTTCGGGTTGTAAACCTCTTTCAGCTCCGACGAAGCGCAAGTGACGGTAGGAGCAGAAGAAGCACCGGCCAACTACGTGCCAGCAGCCG	1.0
TGGGGAATATTGCGCAATGGGGGAAACCCTGACGCAGCAACGCCGCGTGATTGAAGAAGGCCTTCGGGTTGTAAAGATCTTTAATCAGGGACGAAAAATGACGGTACCTGAAGAATAAGCTCCGGCTAACTACGTGCCAGCAGCCGCGGT	TGGGGAATATTGCGCAATGGGGGAAACCCTGACGCAGCAACGCCGCGTGATTGAAGAAGGCCTTCGGGTTGTAAAGATCTTTAATCAGGGACGAAAAATGACGGTACCTGAAGAATAAGCTCCGGCTAACTACGTGCCAGCAGCCGCGGT	1.0
TGGGGAATATTGCGCAATGGGGGAAACCCTGACGCAGCAACGCCGCGTGATTGAAGAAGGCCTTCGGGTTGTAAAGATCTTTAATCAGGGACGAAACAAATGACGGTACCTGAAGAATAAGCTCCGGCTAACTACGTGCCAGCAGCCGCG	TGGGGAATATTGCGCAATGGGGGAAACCCTGACGCAGCAACGCCGCGTGATTGAAGAAGGCCTTCGGGTTGTAAAGATCTTTAATCAGGGACGAAACAAATGACGGTACCTGAAGAATAAGCTCCGGCTAACTACGTGCCAGCAGCCGCG	1.0
TGGGGAATATTGCGCAATGGGGGCAACCCTGACGCAGCAACGCCGCGTGATTGAAGAAGGCCTTCGGGTTGTAAAGATCTTTAATCAGGGACGAAATTTGACGGTACCTGAAGAATAAGCTCCGGCTAACTACGTGCCAGCAGCCGCGGT	TGGGGAATATTGCGCAATGGGGGCAACCCTGACGCAGCAACGCCGCGTGATTGAAGAAGGCCTTCGGGTTGTAAAGATCTTTAATCAGGGACGAAATTTGACGGTACCTGAAGAATAAGCTCCGGCTAACTACGTGCCAGCAGCCGCGGT	1.0
TGGGGAATATTGCGCAATGGGGGCAACCCTGACGCAGCAACGCCGCGTGCAGGAAGAAGGTCTTCGGATTGTAAACTGTTGTCGCAAGGGAAGAAGACAGTGACGGTACCTTGTGAGAAAGTCACGGCTAACTACGTGCCAGCAGCCGCG	TGGGGAATATTGCGCAATGGGGGCAACCCTGACGCAGCAACGCCGCGTGCAGGAAGAAGGTCTTCGGATTGTAAACTGTTGTCGCAAGGGAAGAAGACAGTGACGGTACCTTGTGAGAAAGTCACGGCTAACTACGTGCCAGCAGCCGCG	1.0
TGGGGAATATTGCGCAATGGGGGCAACCCTGACGCAGCAATACCGCGTGAGTGAAGAAGGTTTTCGGATCGTAAAGCTCTGTTATTGGGGAAGAAAACATGACGGTACCCAATGAGGAAGTCCCGGCTAACTACGTGCCAGCAGCCGCGG	TGGGGAATATTGCGCAATGGGGGCAACCCTGACGCAGCAATACCGCGTGAGTGAAGAAGGTTTTCGGATCGTAAAGCTCTGTTATTGGGGAAGAAAACATGACGGTACCCAATGAGGAAGTCCCGGCTAACTACGTGCCAGCAGCCGCGG	1.0
TGGGGAATATTGGGCAATGGACGCAAGTCTGACCCAGCAACGCCGCGTGAAGGAAGAAGGCTTTCGGGTTGTAAACTTCTTTTGTCAGGGAACAGTAGAAGAGGGTACCTGACGAATAAGCCACGGCTAACTACGTGCCAGCAGCCGCGG	TGGGGAATATTGGGCAATGGACGCAAGTCTGACCCAGCAACGCCGCGTGAAGGAAGAAGGCTTTCGGGTTGTAAACTTCTTTTGTCAGGGAACAGTAGAAGAGGGTACCTGACGAATAAGCCACGGCTAACTACGTGCCAGCAGCCGCGG	1.0
TGGGGAATATTGGGCAATGGACGCAAGTCTGACCCAGCAACGCCGCGTGAAGGAAGAAGGCTTTCGGGTTGTAAACTTCTTTTGTCAGGGAAGAGTAGAAGACGGTACCTGACGAATAAGCCACGGCTAACTACGTGCCAGCAGCCGCGG	TGGGGAATATTGGGCAATGGACGCAAGTCTGACCCAGCAACGCCGCGTGAAGGAAGAAGGCTTTCGGGTTGTAAACTTCTTTTGTCAGGGAAGAGTAGAAGACGGTACCTGACGAATAAGCCACGGCTAACTACGTGCCAGCAGCCGCGG	1.0
TGGGGAATATTGGGCAATGGGCGCAAGCCTGACCCAGCAACGCCGCGTGAAGGAAGAAGGCTTTCGGGTTGTAAACTTCTTTTAAGAGGGAAGAGCAGAAGACGGTACCTCTAGAATAAGCCACGGCTAACTACGTGCCAGCAGCCGCGG	TGGGGAATATTGGGCAATGGGCGCAAGCCTGACCCAGCAACGCCGCGTGAAGGAAGAAGGCTTTCGGGTTGTAAACTTCTTTTAAGAGGGAAGAGCAGAAGACGGTACCTCTAGAATAAGCCACGGCTAACTACGTGCCAGCAGCCGCGG	1.0
TGGGGAATATTGGGCAATGGGCGCAAGCCTGACCCAGCAACGCCGCGTGAAGGAAGAAGGCTTTCGGGTTGTAAACTTCTTTTAAGTGGGAAGAGTAGAAGACGGTACCACTTGAATAAGCCACGGCTAACTACGTGCCAGCAGCCGCGG	TGGGGAATATTGGGCAATGGGCGCAAGCCTGACCCAGCAACGCCGCGTGAAGGAAGAAGGCTTTCGGGTTGTAAACTTCTTTTAAGTGGGAAGAGTAGAAGACGGTACCACTTGAATAAGCCACGGCTAACTACGTGCCAGCAGCCGCGG	1.0
TGGGGAATATTGGGCAATGGGCGCAAGCCTGACCCAGCAACGCCGCGTGAAGGAAGAAGGCTTTCGGGTTGTAAACTTCTTTTATTAAGGACGAAAGAAATGACGGTACTTAATGAATAAGCTCCGGCTAACTACGTGCCAGCAGCCGCG	TGGGGAATATTGGGCAATGGGCGCAAGCCTGACCCAGCAACGCCGCGTGAAGGAAGAAGGCTTTCGGGTTGTAAACTTCTTTTATTAAGGACGAAAGAAATGACGGTACTTAATGAATAAGCTCCGGCTAACTACGTGCCAGCAGCCGCG	1.0
TGGGGAATATTGGGCAATGGGCGCAAGCCTGACCCAGCAACGCCGCGTGAAGGAAGAAGGCTTTCGGGTTGTAAACTTCTTTTATTAAGGACGAAGCAATGACGGTACTTAATGAATAAGCTCCGGCTAACTACGTGCCAGCAGCCGCGG	TGGGGAATATTGGGCAATGGGCGCAAGCCTGACCCAGCAACGCCGCGTGAAGGAAGAAGGCTTTCGGGTTGTAAACTTCTTTTATTAAGGACGAAGCAATGACGGTACTTAATGAATAAGCTCCGGCTAACTACGTGCCAGCAGCCGCGG	1.0
TGGGGAATATTGGGCAATGGGCGCAAGCCTGACCCAGCAACGCCGCGTGAAGGAAGAAGGCTTTCGGGTTGTAAACTTCTTTTCTCAGGGACGAACAAATGACGGTACCTGAGGAATAAGCCACGGCTAACTACGTGCCAGCAGCCGCGG	TGGGGAATATTGGGCAATGGGCGCAAGCCTGACCCAGCAACGCCGCGTGAAGGAAGAAGGCTTTCGGGTTGTAAACTTCTTTTCTCAGGGACGAACAAATGACGGTACCTGAGGAATAAGCCACGGCTAACTACGTGCCAGCAGCCGCGG	1.0
TGGGGAATATTGGGCAATGGGCGCAAGCCTGACCCAGCAACGCCGCGTGAAGGAAGAAGGCTTTCGGGTTGTAAACTTCTTTTGTCAGGGAAGATGAACAGACTGTACCTGACGAATAAGCCACGGCTAACTACGTGCCAGCAGCCGCGG	TGGGGAATATTGGGCAATGGGCGCAAGCCTGACCCAGCAACGCCGCGTGAAGGAAGAAGGCTTTCGGGTTGTAAACTTCTTTTGTCAGGGAAGATGAACAGACTGTACCTGACGAATAAGCCACGGCTAACTACGTGCCAGCAGCCGCGG	1.0
TGGGGAATATTGGGCAATGGGCGCAAGCCTGACCCAGCAACGCCGCGTGAAGGAAGAAGGCTTTCGGGTTGTAAACTTCTTTTGTCGGGGACGAAACAAATGACGGTACCCGACGAATAAGCCACGGCTAACTACGTGCCAGCAGCCGCG	TGGGGAATATTGGGCAATGGGCGCAAGCCTGACCCAGCAACGCCGCGTGAAGGAAGAAGGCTTTCGGGTTGTAAACTTCTTTTGTCGGGGACGAAACAAATGACGGTACCCGACGAATAAGCCACGGCTAACTACGTGCCAGCAGCCGCG	1.0
TGGGGAATATTGGGCAATGGGCGCAAGCCTGACCCAGCAACGCCGCGTGAAGGAAGAAGGCTTTCGGGTTGTAAACTTCTTTTGTCGGGGACGAAACAAATGACGGTACCTGACGAATAAGCCATGGCTAACTACGTGCCAGCAGCCGCG	TGGGGAATATTGGGCAATGGGCGCAAGCCTGACCCAGCAACGCCGCGTGAAGGAAGAAGGCTTTCGGGTTGTAAACTTCTTTTGTCGGGGACGAAACAAATGACGGTACCTGACGAATAAGCCATGGCTAACTACGTGCCAGCAGCCGCG	1.0
TGGGGAATCTTCCGCAATGGGCGAAAGCCTGACGGAGCAACGCCGCGTGAGTGATGACGGCCTTCGGGTTGTAAAGCTCTGTGATCGGGGACGAACGGTCAGCAGACGAATAATCTGCTGAATTGACGGTACCCGAATAGCAAGCCACGG	TGGGGAATCTTCCGCAATGGGCGAAAGCCTGACGGAGCAACGCCGCGTGAGTGATGACGGCCTTCGGGTTGTAAAGCTCTGTGATCGGGGACGAACGGTCAGCAGACGAATAATCTGCTGAATTGACGGTACCCGAATAGCAAGCCACGG	1.0
TGGGGAATCTTCCGCAATGGGCGAAAGCCTGACGGAGCAACGCCGCGTGAGTGATGACGGCCTTCGGGTTGTAAAGCTCTGTGATCGGGGACGAACGGTCTGTAAGCTAATATCTTATGGAAGTGACGGTACCCGAATAGCAAGCCACGG	TGGGGAATCTTCCGCAATGGGCGAAAGCCTGACGGAGCAACGCCGCGTGAGTGATGACGGCCTTCGGGTTGTAAAGCTCTGTGATCGGGGACGAACGGTCTGTAAGCTAATATCTTATGGAAGTGACGGTACCCGAATAGCAAGCCACGG	1.0
TGGGGAATCTTCCGCAATGGGCGCAAGCCTGACGGAGCAACGCCGCGTGAGTGAAGAAGGGTTTCGACTCGTAAAGCTCTGTTGTCGGGGACGAATGTCAGGACTCAGAATATGGGTTCTGAATGACGGTACCTGACGAGGAAGCCACGG	TGGGGAATCTTCCGCAATGGGCGCAAGCCTGACGGAGCAACGCCGCGTGAGTGAAGAAGGGTTTCGACTCGTAAAGCTCTGTTGTCGGGGACGAATGTCAGGACTCAGAATATGGGTTCTGAATGACGGTACCTGACGAGGAAGCCACGG	1.0
TGGGGAATCTTCCGCAATGGGCGCAAGCCTGACGGAGCAACGCCGCGTGAGTGAAGAAGGGTTTCGACTCGTAAAGCTCTGTTGTCGGGGACGAATGTGGAGATGGTGAATAACCATTTTCAATGACGGTACCTGACGAGGAAGCCACGG	TGGGGAATCTTCCGCAATGGGCGCAAGCCTGACGGAGCAACGCCGCGTGAGTGAAGAAGGGTTTCGACTCGTAAAGCTCTGTTGTCGGGGACGAATGTGGAGATGGTGAATAACCATTTTCAATGACGGTACCTGACGAGGAAGCCACGG	1.0
TGGGGAATCTTCCGCAATGGGCGCAAGCCTGACGGAGCAACGCCGCGTGAGTGAAGAAGGGTTTCGACTCGTAAAGCTCTGTTGTCGGGGACGAATGTGGAGGTTGTGAATAACAGCTTCCAATGACGGTACCTGACGAGGAAGCCACGG	TGGGGAATCTTCCGCAATGGGCGCAAGCCTGACGGAGCAACGCCGCGTGAGTGAAGAAGGGTTTCGACTCGTAAAGCTCTGTTGTCGGGGACGAATGTGGAGGTTGTGAATAACAGCTTCCAATGACGGTACCTGACGAGGAAGCCACGG	1.0
TGGGGAATCTTGCGCAATGGGGGGAACCCTGACGCAGCGACGCCGCGTGCGGGACGGAGGCCTTCGGGTCGTAAACCGCTTTCAGCAGGGAAGAGTCAAGACTGTACCTGCAGAAGAAGCCCCGGCTAACTACGTGCCAGCAGCCGCGGT	TGGGGAATCTTGCGCAATGGGGGGAACCCTGACGCAGCGACGCCGCGTGCGGGACGGAGGCCTTCGGGTCGTAAACCGCTTTCAGCAGGGAAGAGTCAAGACTGTACCTGCAGAAGAAGCCCCGGCTAACTACGTGCCAGCAGCCGCGGT	1.0
TGGGGAATTTTGCGCAATGGGGGAAACCCTGACGCAGCAACGCCGCGTGCGGGACGAAGGCCTTCGGGTTGTAAACCGCTTTCAGCAGGGAAGACATCGACGGTACCTGCAGAAGAAGCCCCGGCTAACTACGTGCCAGCAGCCGCGGTA	TGGGGAATTTTGCGCAATGGGGGAAACCCTGACGCAGCAACGCCGCGTGCGGGACGAAGGCCTTCGGGTTGTAAACCGCTTTCAGCAGGGAAGACATCGACGGTACCTGCAGAAGAAGCCCCGGCTAACTACGTGCCAGCAGCCGCGGTA	1.0
TGGGGAATTTTGCGCAATGGGGGAAACCCTGACGCAGCAACGCCGCGTGCGGGACGACGGCCTTCGGGTTGTAAACCGCTTTCAGCAGGGAAGAAATTCGACGGTACCTGCAGAAGAAGCCCCGGCTAACTACGTGCCAGCAGCCGCGGT	TGGGGAATTTTGCGCAATGGGGGAAACCCTGACGCAGCAACGCCGCGTGCGGGACGACGGCCTTCGGGTTGTAAACCGCTTTCAGCAGGGAAGAAATTCGACGGTACCTGCAGAAGAAGCCCCGGCTAACTACGTGCCAGCAGCCGCGGT	1.0
TGGGGGATATTGCACAATGGGCGAAAGCCTGATGCAGCGACGCCGCGTGAGGGAAGACGGTCTTCGGATTGTAAACCTCTGTCTTTGGGGAAGAAAATGACGGTACCCAAAGAGGAAGCTCCGGCTAACTACGTGCCAGCAGCCGCGGTA	TGGGGGATATTGCACAATGGGCGAAAGCCTGATGCAGCGACGCCGCGTGAGGGAAGACGGTCTTCGGATTGTAAACCTCTGTCTTTGGGGAAGAAAATGACGGTACCCAAAGAGGAAGCTCCGGCTAACTACGTGCCAGCAGCCGCGGTA	1.0
TGGGGGATATTGCACAATGGGGGAAACCCTGATGCAGCAACGCCGCGTGAGGGAAGAAGGTTTTCGGATTGTAAACCTCTGTTCTTAGTGACGATAATGACGGTAGCTAAGGAGAAAGCTCCGGCTAACTACGTGCCAGCAGCCGCGGTA	TGGGGGATATTGCACAATGGGGGAAACCCTGATGCAGCAACGCCGCGTGAGGGAAGAAGGTTTTCGGATTGTAAACCTCTGTTCTTAGTGACGATAATGACGGTAGCTAAGGAGAAAGCTCCGGCTAACTACGTGCCAGCAGCCGCGGTA	1.0
TGGGGGATATTGCACAATGGGGGAAACCCTGATGCAGCAACGCCGCGTGTGGGAAGAAGGTTTTCGGATTGTAAACCACTGTTCTCAGGGACGATAATGACGGTACCTGAGGAGAAAGCTCCGGCTAACTACGTGCCAGCAGCCGCGGTA	TGGGGGATATTGCACAATGGGGGAAACCCTGATGCAGCAACGCCGCGTGTGGGAAGAAGGTTTTCGGATTGTAAACCACTGTTCTCAGGGACGATAATGACGGTACCTGAGGAGAAAGCTCCGGCTAACTACGTGCCAGCAGCCGCGGTA	1.0
TGGGGGATATTGCACAATGGGGGAAACCCTGATGCAGCGACGCCGCGTGAGGGAAGACGGCCTTCGGGTTGTAAACCTCTGTCTTCGGGGACGAATAAATGACGGTACCCGAGGAGGAAGCCACGGCTAACTACGTGCCAGCAGCCGCGG	TGGGGGATATTGCACAATGGGGGAAACCCTGATGCAGCGACGCCGCGTGAGGGAAGACGGCCTTCGGGTTGTAAACCTCTGTCTTCGGGGACGAATAAATGACGGTACCCGAGGAGGAAGCCACGGCTAACTACGTGCCAGCAGCCGCGG	1.0
TGGGGGATATTGCACAATGGGGGAAACCCTGATGCAGCGACGCCGCGTGGAGGAAGAAGGTTTTCGGATTGTAAACTCCTGTCGTTAGGGACGATAATGACGGTACCTAACAAGAAAGCACCGGCTAACTACGTGCCAGCAGCCGCGGTA	TGGGGGATATTGCACAATGGGGGAAACCCTGATGCAGCGACGCCGCGTGGAGGAAGAAGGTTTTCGGATTGTAAACTCCTGTCGTTAGGGACGATAATGACGGTACCTAACAAGAAAGCACCGGCTAACTACGTGCCAGCAGCCGCGGTA	1.0
TGGGGGATATTGCGCAATGGGGGGAACCCTGACGCAGCAACGCCGCGTGAAGGAAGAAGGTCTTCGGATTGTAAACTTTTGTCTTATGGGAAGAAAGAAATGACGGTACCATAGGAGGAAGCCACGGCTAACTACGTGCCAGCAGCCGCG	TGGGGGATATTGCGCAATGGGGGGAACCCTGACGCAGCAACGCCGCGTGAAGGAAGAAGGTCTTCGGATTGTAAACTTTTGTCTTATGGGAAGAAAGAAATGACGGTACCATAGGAGGAAGCCACGGCTAACTACGTGCCAGCAGCCGCG	1.0
TAGGGAATATTGGGCAATGGGCGCAAGCCTGACCCAGCAACGCCGCGTGAGGGAAGAAGGTTTTCGGATTGTAAACCTCTGTCCTATGTGACGAAGGAAGTGACGGTAGCATAGGAGGAAGCCCCGGCTAACTACGTGCCAGCAGCCGCG	TAGGGAATATTGGGCAATGGGCGCAAGCCTGACCCAGCAACGCCGCGTGAGGGAAGAAGGTTTTCGGATTGTAAACCTCTGTCCTATGTGACGAAGGAAGTGACGGTAGCATAGGAGGAAGCCCCGGCTAACTACGTGCCAGCAGCCGCG	0.0
TAGGGAATCTTCCACAATGGACGAAAGTCTGATGGAGCAACGCCGCGTGAGTGAAGAAGGGTTTCGGCTCGTAAAGCTCTGTTGGTAGTGAAGAAAGATAGAGGTAGTAACTGGCCTTTATTTGACGGTAATTACTTAGAAAGTCACGGC	TAGGGAATCTTCCACAATGGACGAAAGTCTGATGGAGCAACGCCGCGTGAGTGAAGAAGGGTTTCGGCTCGTAAAGCTCTGTTGGTAGTGAAGAAAGATAGAGGTAGTAACTGGCCTTTATTTGACGGTAATTACTTAGAAAGTCACGGC	0.0
TAGGGAATCTTCCACAATGGACGCAAGTCTGATGGAGCAACGCCGCGTGAGTGAAGAAGGCTTTCGGGTCGTAAAACTCTGTTGTTGGAGAAGAATGGTCGGCAGAGTAACTGTTGTCGGCGTGACGGTATCCAACCAGAAAGCCACGGC	TAGGGAATCTTCCACAATGGACGCAAGTCTGATGGAGCAACGCCGCGTGAGTGAAGAAGGCTTTCGGGTCGTAAAACTCTGTTGTTGGAGAAGAATGGTCGGCAGAGTAACTGTTGTCGGCGTGACGGTATCCAACCAGAAAGCCACGGC	0.0
TAGGGAATCTTCCACAATGGACGCAAGTCTGATGGAGCAACGCCGCGTGAGTGAAGAAGGGTTTCGGCTCGTAAAGCTCTGTTGGTAGTGAAGAAAGATAGAGGTAGTAACTGGCCTTTATTTGACGGTAATTACTTAGAAAGTCACGGC	TAGGGAATCTTCCACAATGGACGCAAGTCTGATGGAGCAACGCCGCGTGAGTGAAGAAGGGTTTCGGCTCGTAAAGCTCTGTTGGTAGTGAAGAAAGATAGAGGTAGTAACTGGCCTTTATTTGACGGTAATTACTTAGAAAGTCACGGC	0.0
TAGGGAATCTTCCACAATGGGCGCAAGCCTGATGGAGCAACACCGCGTGAGTGAAGAAGGGTTTCGGCTCGTAAAGCTCTGTTGTTAAAGAAGAACACGTATGAGAGTAACTGTTCATACGTTGACGGTATTTAACCAGAAAGTCACGGC	TAGGGAATCTTCCACAATGGGCGCAAGCCTGATGGAGCAACACCGCGTGAGTGAAGAAGGGTTTCGGCTCGTAAAGCTCTGTTGTTAAAGAAGAACACGTATGAGAGTAACTGTTCATACGTTGACGGTATTTAACCAGAAAGTCACGGC	0.0
TAGGGAATCTTCCACAATGGGCGCAAGCCTGATGGAGCAACACCGCGTGAGTGAAGAAGGGTTTCGGCTCGTAAAGCTCTGTTGTTAAAGAAGAACACGTATGAGATTAACTGTTCATACGTTGACGGTATTTAACCAGAAAGTCACGGC	TAGGGAATCTTCCACAATGGGCGCAAGCCTGATGGAGCAACACCGCGTGAGTGAAGAAGGGTTTCGGCTCGTAAAGCTCTGTTGTTAAAGAAGAACACGTATGAGATTAACTGTTCATACGTTGACGGTATTTAACCAGAAAGTCACGGC	0.0
TAGGGAATCTTCCACAATGGGCGCAAGCCTGATGGAGCAACACCGCGTGAGTGAAGAAGGGTTTCGGCTCGTAAAGCTCTGTTGTTAGAGAAGAACGTGCGTGAGAGCAACTGTTCACGCAGTGACGGTATCTAACCAGAAAGTCACGGC	TAGGGAATCTTCCACAATGGGCGCAAGCCTGATGGAGCAACACCGCGTGAGTGAAGAAGGGTTTCGGCTCGTAAAGCTCTGTTGTTAGAGAAGAACGTGCGTGAGAGCAACTGTTCACGCAGTGACGGTATCTAACCAGAAAGTCACGGC	0.0
TAGGGAATCTTCCACAATGGGCGCAAGCCTGATGGAGCAACACCGCGTGAGTGAAGAAGGGTTTCGGCTCGTAAAGCTCTGTTGTTGGAGAAGAACGTGCGTGAGAGTAACTGTTCACGCAGTGACGGTATCCAACCAGAAAGTCACGGC	TAGGGAATCTTCCACAATGGGCGCAAGCCTGATGGAGCAACACCGCGTGAGTGAAGAAGGGTTTCGGCTCGTAAAGCTCTGTTGTTGGAGAAGAACGTGCGTGAGAGTAACTGTTCACGCAGTGACGGTATCCAACCAGAAAGTCACGGC	0.0
TAGGGAATCTTCCGCAATGGACGCAAGTCTGACGGAGCAACGCCGCGTGAGTGAAGAAGGTTTTCGGATCGTAAAACTCTGTTGTTAGAGAAGAACAAGTGCTAGAGTAACTGTTAGCGCCTTGACGGTATCTAACCAGAAAGCCACGGC	TAGGGAATCTTCCGCAATGGACGCAAGTCTGACGGAGCAACGCCGCGTGAGTGAAGAAGGTTTTCGGATCGTAAAACTCTGTTGTTAGAGAAGAACAAGTGCTAGAGTAACTGTTAGCGCCTTGACGGTATCTAACCAGAAAGCCACGGC	0.0
TAGGGAATCTTCCGCAATGGGCGAAAGCCTGACGGAGCAACGCCGCGTGAGTGAAGAAGGATTTCGGTTCGTAAAGCTCTGTTGTTAGGGAAGAATGATTGTATAGTAACTATATACAGTAGAGACGGTACCTAACCAGAAAGCCACGGC	TAGGGAATCTTCCGCAATGGGCGAAAGCCTGACGGAGCAACGCCGCGTGAGTGAAGAAGGATTTCGGTTCGTAAAGCTCTGTTGTTAGGGAAGAATGATTGTATAGTAACTATATACAGTAGAGACGGTACCTAACCAGAAAGCCACGGC	0.0
TAGGGAATCTTCCGCAATGGGCGAAAGCCTGACGGAGCAACGCCGCGTGAGTGAAGAAGGATTTCGGTTCGTAAAGCTCTGTTGTTAGGGAAGAATGATTGTGTAGTAACTATACACAGTAGAGACGGTACCTAACCAGAAAGCCACGGC	TAGGGAATCTTCCGCAATGGGCGAAAGCCTGACGGAGCAACGCCGCGTGAGTGAAGAAGGATTTCGGTTCGTAAAGCTCTGTTGTTAGGGAAGAATGATTGTGTAGTAACTATACACAGTAGAGACGGTACCTAACCAGAAAGCCACGGC	0.0
TAGGGAATCTTCGGCAATGGACGAAAGTCTGACCGAGCAACGCCGCGTGAGTGAAGAAGGTTTTCGGATCGTAAAACTCTGTTGGTAGAGAAGAACGTTGGTGAGAGTGGAAAGCTCATCAAGTGACGGTAACTACCCAGAAAGGGACGG	TAGGGAATCTTCGGCAATGGACGAAAGTCTGACCGAGCAACGCCGCGTGAGTGAAGAAGGTTTTCGGATCGTAAAACTCTGTTGGTAGAGAAGAACGTTGGTGAGAGTGGAAAGCTCATCAAGTGACGGTAACTACCCAGAAAGGGACGG	0.0
TAGGGAATCTTCGGCAATGGACGAAAGTCTGACCGAGCAACGCCGCGTGAGTGAAGAAGGTTTTCGGATCGTAAAACTCTGTTGTTAGAGAAGAACAAGGATGAGAGTAACTGTTCATCCCTTGACGGTATCTAACCAGAAAGCCACGGC	TAGGGAATCTTCGGCAATGGACGAAAGTCTGACCGAGCAACGCCGCGTGAGTGAAGAAGGTTTTCGGATCGTAAAACTCTGTTGTTAGAGAAGAACAAGGATGAGAGTAACTGTTCATCCCTTGACGGTATCTAACCAGAAAGCCACGGC	0.0
TAGGGAATCTTCGGCAATGGACGAAAGTCTGACCGAGCAACGCCGCGTGAGTGAAGAAGGTTTTCGGATCGTAAAGCTCTGTTGTAAGAGAAGAACGGGTGTGAGAGTGGAAAGTTCACACTGTGACGGTATCTTACCAGAAAGGGACGG	TAGGGAATCTTCGGCAATGGACGAAAGTCTGACCGAGCAACGCCGCGTGAGTGAAGAAGGTTTTCGGATCGTAAAGCTCTGTTGTAAGAGAAGAACGGGTGTGAGAGTGGAAAGTTCACACTGTGACGGTATCTTACCAGAAAGGGACGG	0.0
TAGGGAATCTTCGGCAATGGACGCAAGTCTGACCGAGCAACGCCGCGTGAGTGAAGACGGTTTTCGGATCGTAAAGCTCTGTTGTAGGGGAAGAACGTGTGTAAGAGTGGAAAGCTTACACAGTGACGGTACCCTACCAGAAAGGGACGG	TAGGGAATCTTCGGCAATGGACGCAAGTCTGACCGAGCAACGCCGCGTGAGTGAAGACGGTTTTCGGATCGTAAAGCTCTGTTGTAGGGGAAGAACGTGTGTAAGAGTGGAAAGCTTACACAGTGACGGTACCCTACCAGAAAGGGACGG	0.0
TAGGGAATCTTCGGCAATGGACGGAAGTCTGACCGAGCAACGCCGCGTGAGTGAAGAAGGTTTTCGGATCGTAAAGCTCTGTTGTAAGAGAAGAACGAGTGTGAGAGTGGAAAGTTCACACTGTGACGGTATCTTACCAGAAAGGGACGG	TAGGGAATCTTCGGCAATGGACGGAAGTCTGACCGAGCAACGCCGCGTGAGTGAAGAAGGTTTTCGGATCGTAAAGCTCTGTTGTAAGAGAAGAACGAGTGTGAGAGTGGAAAGTTCACACTGTGACGGTATCTTACCAGAAAGGGACGG	0.0
TAGGGAATCTTCGGCAATGGGCGAAAGCCTGACCGAGCAACGCCGCGTGAATGATGAAGGCCTTCGGGTTGTAAAATTCTGTTATAAGGGAAGAACGACTTTAGTAGGAAATGGCTAGAGTGTGACGGTACCTTATGAGAAAGCCACGGC	TAGGGAATCTTCGGCAATGGGCGAAAGCCTGACCGAGCAACGCCGCGTGAATGATGAAGGCCTTCGGGTTGTAAAATTCTGTTATAAGGGAAGAACGACTTTAGTAGGAAATGGCTAGAGTGTGACGGTACCTTATGAGAAAGCCACGGC	0.0
TAGGGAATCTTCGGCAATGGGCGAAAGCCTGACCGAGCAACGCCGCGTGAATGATGAAGGCCTTCGGGTTGTAAAATTCTGTTATAAGGGAAGAATGGCTCTAGTAGGAAATGGCTAGAGTGTGACGGTACCTTATGAGAAAGCCACGGC	TAGGGAATCTTCGGCAATGGGCGAAAGCCTGACCGAGCAACGCCGCGTGAATGATGAAGGCCTTCGGGTTGTAAAATTCTGTTATAAGGGAAGAATGGCTCTAGTAGGAAATGGCTAGAGTGTGACGGTACCTTATGAGAAAGCCACGGC	0.0
TAGGGAATCTTCGGCAATGGGGGCAACCCTGACCGAGCAACGCCGCGTGAGTGAAGAAGGTTTTCGGATCGTAAAGCTCTGTTGTAAGAGAAGAACGAGTGTGAGAGTGGAAAGTTCACACTGTGACGGTAACTTACCAGAAAGGGACGG	TAGGGAATCTTCGGCAATGGGGGCAACCCTGACCGAGCAACGCCGCGTGAGTGAAGAAGGTTTTCGGATCGTAAAGCTCTGTTGTAAGAGAAGAACGAGTGTGAGAGTGGAAAGTTCACACTGTGACGGTAACTTACCAGAAAGGGACGG	0.0
TAGGGAATCTTCGGCAATGGGGGCAACCCTGACCGAGCAACGCCGCGTGAGTGAAGAAGGTTTTCGGATCGTAAAGCTCTGTTGTAAGTCAAGAACGGGTGTGAGAGTGGAAAGTTCACACTGTGACGGTAGCTTACCAGAAAGGGACGG	TAGGGAATCTTCGGCAATGGGGGCAACCCTGACCGAGCAACGCCGCGTGAGTGAAGAAGGTTTTCGGATCGTAAAGCTCTGTTGTAAGTCAAGAACGGGTGTGAGAGTGGAAAGTTCACACTGTGACGGTAGCTTACCAGAAAGGGACGG	0.0
TAGGGAATCTTCGGCAATGGGGGGAACCCTGACCGAGCAACGCCGCGTGAGTGAAGAAGGTTTTCGGATCGTAAAGCTCTGTTGTAAGTCAAGAACGGGTGTGAGAGTGGAAAGTTCACACTGTGACGGTAGCTTACCAGAAAGGGACGG	TAGGGAATCTTCGGCAATGGGGGGAACCCTGACCGAGCAACGCCGCGTGAGTGAAGAAGGTTTTCGGATCGTAAAGCTCTGTTGTAAGTCAAGAACGGGTGTGAGAGTGGAAAGTTCACACTGTGACGGTAGCTTACCAGAAAGGGACGG	0.0
TAGGGAATCTTCGGCAATGGGGGGAACCCTGACCGAGCAACGCCGCGTGAGTGAAGAAGGTTTTCGGATCGTAAAGCTCTGTTGTTAAGGAAGAACGAGTGTGAGAATGGAAAGTTCATACTGTGACGGTACTTAACCAGAAAGGGACGG	TAGGGAATCTTCGGCAATGGGGGGAACCCTGACCGAGCAACGCCGCGTGAGTGAAGAAGGTTTTCGGATCGTAAAGCTCTGTTGTTAAGGAAGAACGAGTGTGAGAATGGAAAGTTCATACTGTGACGGTACTTAACCAGAAAGGGACGG	0.0
TAGGGAATCTTCGGCAATGGGGGGAACCCTGACCGAGCAACGCCGCGTGAGTGAAGAAGGTTTTCGGATCGTAAAGCTCTGTTGTTAAGGAAGAACGTGTGTGAGAGTGGAAAGTTCACACAGTGACGGTACTTAACCAGAAAGGGACGG	TAGGGAATCTTCGGCAATGGGGGGAACCCTGACCGAGCAACGCCGCGTGAGTGAAGAAGGTTTTCGGATCGTAAAGCTCTGTTGTTAAGGAAGAACGTGTGTGAGAGTGGAAAGTTCACACAGTGACGGTACTTAACCAGAAAGGGACGG	0.0
TAGGGAATCTTGCACAATGGGCGAAAGCCTGATGCAGCAACGCCGCGTGAAGGATGAAGGCCTTCGGGTTGTAAACTTCTGTTCTAAGGGAAGAAACAAATGACGGTACCTTAGGAGCAAGCCCCGGCTAACTACGTGCCAGCAGCCGCG	TAGGGAATCTTGCACAATGGGCGAAAGCCTGATGCAGCAACGCCGCGTGAAGGATGAAGGCCTTCGGGTTGTAAACTTCTGTTCTAAGGGAAGAAACAAATGACGGTACCTTAGGAGCAAGCCCCGGCTAACTACGTGCCAGCAGCCGCG	0.0
TAGGGAATTTTCGGCAATGGGGGAAACCCTGACCGAGCAACGCCGCGTGAAGGAAGAAGGTTTTCGGATTGTAAACTTCTGTTATAAAGGAAGAACGGCGGCTACAGGAAATGGTAGCCGAGTGACGGTACTTTATTAGAAAGCCACGGC	TAGGGAATTTTCGGCAATGGGGGAAACCCTGACCGAGCAACGCCGCGTGAAGGAAGAAGGTTTTCGGATTGTAAACTTCTGTTATAAAGGAAGAACGGCGGCTACAGGAAATGGTAGCCGAGTGACGGTACTTTATTAGAAAGCCACGGC	0.0
TAGGGAATTTTCGGCAATGGGGGAAACCCTGACCGAGCAACGCCGCGTGAGGGAAGAAGTATTTCGGTATGTAAACCTCTGTTATAAAGGAAGAACGGTATGAATAGGAAATGATTCATAAGTGACGGTACTTTATGAGAAAGCCACGGC	TAGGGAATTTTCGGCAATGGGGGAAACCCTGACCGAGCAACGCCGCGTGAGGGAAGAAGTATTTCGGTATGTAAACCTCTGTTATAAAGGAAGAACGGTATGAATAGGAAATGATTCATAAGTGACGGTACTTTATGAGAAAGCCACGGC	0.0
TAGGGAATTTTCGGCAATGGGGGAAACCCTGACCGAGCAACGCCGCGTGAGTGATGACGGCCTTCGGGTTGTAAAGCTCTGTTGTAAGGGAAGAACGGTAGATAGAGAATATCTAAGTGACGGTACCTTACCAGAAAGCCACGGCTAACT	TAGGGAATTTTCGGCAATGGGGGAAACCCTGACCGAGCAACGCCGCGTGAGTGATGACGGCCTTCGGGTTGTAAAGCTCTGTTGTAAGGGAAGAACGGTAGATAGAGAATATCTAAGTGACGGTACCTTACCAGAAAGCCACGGCTAACT	0.0
TAGGGAATTTTCGGCAATGGGGGGAACCCTGACCGAGCAACGCCGCGTGAAGGAAGAAGGAATTCGTTCTGTAAACTTCTGTTATAAAGGAAGAACGGCGGATATAGGGAATGATATCCGAGTGACGGTACTTTATGAGAAAGCCACGGC	TAGGGAATTTTCGGCAATGGGGGGAACCCTGACCGAGCAACGCCGCGTGAAGGAAGAAGGAATTCGTTCTGTAAACTTCTGTTATAAAGGAAGAACGGCGGATATAGGGAATGATATCCGAGTGACGGTACTTTATGAGAAAGCCACGGC	0.0
TAGGGAATTTTCGTCAATGGGGGGAACCCTGAACGAGCAATGCCGCGTGAGTGAAGAAGGTCTTCGGATCGTAAAGCTCTGTTGTAAGAGAAAAACGGACTCCATAGGGAATGATGGAGGAGTGATGGTATCTTACCAGAAAGCCACGGC	TAGGGAATTTTCGTCAATGGGGGGAACCCTGAACGAGCAATGCCGCGTGAGTGAAGAAGGTCTTCGGATCGTAAAGCTCTGTTGTAAGAGAAAAACGGACTCCATAGGGAATGATGGAGGAGTGATGGTATCTTACCAGAAAGCCACGGC	0.0
TCGAGAATCATTCACAATGGGGGAAACCCTGATGGTGCGACGCCGCGTGGGGGAATGAAGGTCTTCGGATTGTAAACCCCTGTCATGTGGGAGCAAATTAAAAAGATAGTACCACAAGAGGAAGAGACGGCTAACTCTGTGCCAGCAGCC	TCGAGAATCATTCACAATGGGGGAAACCCTGATGGTGCGACGCCGCGTGGGGGAATGAAGGTCTTCGGATTGTAAACCCCTGTCATGTGGGAGCAAATTAAAAAGATAGTACCACAAGAGGAAGAGACGGCTAACTCTGTGCCAGCAGCC	0.0
TCGGGAATATTGCGCAATGGAGGAAACTCTGACGCAGTGACGCCGCGTGCAGGAAGAAGGTTTTCGGATTGTAAACTGCTTTAGACAGGGAAGAGAAAGGACAGTACCTGTAGAATAAGCTCCGGCTAACTACGTGCCAGCAGCCGCGGT	TCGGGAATATTGCGCAATGGAGGAAACTCTGACGCAGTGACGCCGCGTGCAGGAAGAAGGTTTTCGGATTGTAAACTGCTTTAGACAGGGAAGAGAAAGGACAGTACCTGTAGAATAAGCTCCGGCTAACTACGTGCCAGCAGCCGCGGT	0.0
TGAGGAATATTGGTCAATGGACGAAAGTCTGAACCAGCCAAGTAGCGTGCAGGATGACGGCCCTCTGGGTTGTAAACTGCTTTTAGTTGGGAATAAAAAGAGGGACGTGTCCCTTATTGTATGTACCATCAGAAAAAGGACCGGCTAATT	TGAGGAATATTGGTCAATGGACGAAAGTCTGAACCAGCCAAGTAGCGTGCAGGATGACGGCCCTCTGGGTTGTAAACTGCTTTTAGTTGGGAATAAAAAGAGGGACGTGTCCCTTATTGTATGTACCATCAGAAAAAGGACCGGCTAATT	0.0
TGAGGAATATTGGTCAATGGACGAGAGTCTGAACCAGCCAAGTAGCGTGAAGGATGACTGCCCTATGGGTTGTAAACTTCTTTTATACGGGAATAAAGTGAGCCACGTGTGGCTTTTTGTATGTACCGTATGAATAAGGATCGGCTAACT	TGAGGAATATTGGTCAATGGACGAGAGTCTGAACCAGCCAAGTAGCGTGAAGGATGACTGCCCTATGGGTTGTAAACTTCTTTTATACGGGAATAAAGTGAGCCACGTGTGGCTTTTTGTATGTACCGTATGAATAAGGATCGGCTAACT	0.0
TGAGGAATATTGGTCAATGGACGAGAGTCTGAACCAGCCAAGTAGCGTGAAGGATGACTGCCCTATGGGTTGTAAACTTCTTTTATACGGGAATAAAGTTAGCCACGTGTGGTTTTTTGCATGTACCGTATGAATAAGGATCGGCTAACT	TGAGGAATATTGGTCAATGGACGAGAGTCTGAACCAGCCAAGTAGCGTGAAGGATGACTGCCCTATGGGTTGTAAACTTCTTTTATACGGGAATAAAGTTAGCCACGTGTGGTTTTTTGCATGTACCGTATGAATAAGGATCGGCTAACT	0.0
TGAGGAATATTGGTCAATGGGCGAGAGCCTGAACCAGCCAAGTAGCGTGCAGGATGACGGCCCTATGGGTTGTAAACTGCTTTTATAGGGGAATAAAGTGAGCCACGTGTGGTTTTTTGCATGTACCCTATGAATAAGGACCGGCTAATT	TGAGGAATATTGGTCAATGGGCGAGAGCCTGAACCAGCCAAGTAGCGTGCAGGATGACGGCCCTATGGGTTGTAAACTGCTTTTATAGGGGAATAAAGTGAGCCACGTGTGGTTTTTTGCATGTACCCTATGAATAAGGACCGGCTAATT	0.0
TGAGGAATATTGGTCAATGGGCGATGGCCTGAACCAGCCAAGTAGCGTGAAGGATGACTGCCCTATGGGTTGTAAACTTCTTTTATAAAGGAATAAAGTCGGGTATGCATACCCGTTTGCATGTACTTTATGAATAAGGATCGGCTAACT	TGAGGAATATTGGTCAATGGGCGATGGCCTGAACCAGCCAAGTAGCGTGAAGGATGACTGCCCTATGGGTTGTAAACTTCTTTTATAAAGGAATAAAGTCGGGTATGCATACCCGTTTGCATGTACTTTATGAATAAGGATCGGCTAACT	0.0
TGAGGAATATTGGTCAATGGGCGCGAGCCTGAACCAGCCAAGTAGCGTGAAGGATGACTGCCCTATGGGTTGTAAACTTCTTTTATATTAGAATAAAGTGCAGTATGTATACTGTTTTGTATGTATAATATGAATAAGGATCGGCTAACT	TGAGGAATATTGGTCAATGGGCGCGAGCCTGAACCAGCCAAGTAGCGTGAAGGATGACTGCCCTATGGGTTGTAAACTTCTTTTATATTAGAATAAAGTGCAGTATGTATACTGTTTTGTATGTATAATATGAATAAGGATCGGCTAACT	0.0
TGAGGAATATTGGTCAATGGGCGCTAGCCTGAACCAGCCAAGTAGCGTGAAGGATGAAGGCTCTATGGGTCGTAAACTTCTTTTATATAAGAATAAAGTGCAGTATGTATACTGTTTTGTATGTATTATATGAATAAGGATCGGCTAACT	TGAGGAATATTGGTCAATGGGCGCTAGCCTGAACCAGCCAAGTAGCGTGAAGGATGAAGGCTCTATGGGTCGTAAACTTCTTTTATATAAGAATAAAGTGCAGTATGTATACTGTTTTGTATGTATTATATGAATAAGGATCGGCTAACT	0.0
TGAGGAATATTGGTCAATGGGCGTTAGCCTGAACCAGCCAAGTAGCGTGAAGGATGAAGGCTCTATGGGTCGTAAACTTCTTTTATATAAGAATAAAGTGCAGTATGTATACTGTTTTGTATGTATTATATGAATAAGGATCGGCTAACT	TGAGGAATATTGGTCAATGGGCGTTAGCCTGAACCAGCCAAGTAGCGTGAAGGATGAAGGCTCTATGGGTCGTAAACTTCTTTTATATAAGAATAAAGTGCAGTATGTATACTGTTTTGTATGTATTATATGAATAAGGATCGGCTAACT	0.0
TGAGGAATATTGGTCAATGGTCGGCAGACTGAACCAGCCAAGTCGCGTGAGGGAAGACGGCCCTACGGGTTGTAAACCTCTTTTGTCGGAGAGTAAAGTACGCTACGCGTAGCGTATTGCAAGTATCCGAAGAAAAAGCATCGGCTAACT	TGAGGAATATTGGTCAATGGTCGGCAGACTGAACCAGCCAAGTCGCGTGAGGGAAGACGGCCCTACGGGTTGTAAACCTCTTTTGTCGGAGAGTAAAGTACGCTACGCGTAGCGTATTGCAAGTATCCGAAGAAAAAGCATCGGCTAACT	0.0
TGAGGAATATTGGTCAATGGTCGGCAGACTGAACCAGCCAAGTCGCGTGAGGGAAGACGGCCCTACGGGTTGTAAACCTCTTTTGTCGGAGAGTAAAGTACGCTACGTGTAGCGTATTGCAAGTATCCGAAGAAAAAGCATCGGCTAACT	TGAGGAATATTGGTCAATGGTCGGCAGACTGAACCAGCCAAGTCGCGTGAGGGAAGACGGCCCTACGGGTTGTAAACCTCTTTTGTCGGAGAGTAAAGTACGCTACGTGTAGCGTATTGCAAGTATCCGAAGAAAAAGCATCGGCTAACT	0.0
TGAGGAATATTGGTCAATGGTCGGCAGACTGAACCAGCCAAGTCGCGTGAGGGAAGACGGCCCTACGGGTTGTAAACCTCTTTTGTCGGAGAGTAAAGTACGCTACGTGTAGTGTATTGCAAGTATCCGAAGAAAAAGCATCGGCTAACT	TGAGGAATATTGGTCAATGGTCGGCAGACTGAACCAGCCAAGTCGCGTGAGGGAAGACGGCCCTACGGGTTGTAAACCTCTTTTGTCGGAGAGTAAAGTACGCTACGTGTAGTGTATTGCAAGTATCCGAAGAAAAAGCATCGGCTAACT	0.0
TGAGGAATCTTCCACAATGGGCGAAAGCCTGATGGAGCAACGCCGCGTGAAGGATGAAGGCCTTCGGGTTGTAAACTTCTTTTATGAGTGAAGAATATGACGGTAACTCATGAATAAGCACCGGCTAACTACGTGCCAGCAGCCGCGGTC	TGAGGAATCTTCCACAATGGGCGAAAGCCTGATGGAGCAACGCCGCGTGAAGGATGAAGGCCTTCGGGTTGTAAACTTCTTTTATGAGTGAAGAATATGACGGTAACTCATGAATAAGCACCGGCTAACTACGTGCCAGCAGCCGCGGTC	0.0
TGGGGAATATTGCACAATGGAGGAAACTCTGATGCAGCGACGCCGCGTGAAGGATGAAGTATTTCGGTATGTAAACTTCTATCAGCAGGGAAGAAAATGACGGTACCTGACTAAGAAGCCCCGGCTAACTACGTGCCAGCAGCCGCGGTA	TGGGGAATATTGCACAATGGAGGAAACTCTGATGCAGCGACGCCGCGTGAAGGATGAAGTATTTCGGTATGTAAACTTCTATCAGCAGGGAAGAAAATGACGGTACCTGACTAAGAAGCCCCGGCTAACTACGTGCCAGCAGCCGCGGTA	0.0
TGGGGAATATTGCACAATGGGCGAAAGCCTGATGCAGCAACGCCGCGTGAGCGAAGAAGGTCTTCGGATCGTAAAGCTCTGTCCTTGGGGAAGATAATGACGGTACCCTTGGAGGAAGCCCCGGCTAACTACGTGCCAGCAGCCGCGGTA	TGGGGAATATTGCACAATGGGCGAAAGCCTGATGCAGCAACGCCGCGTGAGCGAAGAAGGTCTTCGGATCGTAAAGCTCTGTCCTTGGGGAAGATAATGACGGTACCCTTGGAGGAAGCCCCGGCTAACTACGTGCCAGCAGCCGCGGTA	0.0
TGGGGAATATTGCACAATGGGCGAAAGCCTGATGCAGCAACGCCGCGTGAGCGATGAAGGCCTTCGGGTCGTAAAGCTCTGTCCTCAAGGAAGATAATGACGGTACTTGAGGAGGAAGCCCCGGCTAACTACGTGCCAGCAGCCGCGGTA	TGGGGAATATTGCACAATGGGCGAAAGCCTGATGCAGCAACGCCGCGTGAGCGATGAAGGCCTTCGGGTCGTAAAGCTCTGTCCTCAAGGAAGATAATGACGGTACTTGAGGAGGAAGCCCCGGCTAACTACGTGCCAGCAGCCGCGGTA	0.0
TGGGGAATATTGCACAATGGGCGAAAGCCTGATGCAGCAACGCCGCGTGAGGGAAGACGGTTTTCGGATTGTAAACCTCTGTTTTCGGTGACGAACAAATGACGGTAACCGAGTAGGAAGCCACGGCTAACTACGTGCCAGCAGCCGCGG	TGGGGAATATTGCACAATGGGCGAAAGCCTGATGCAGCAACGCCGCGTGAGGGAAGACGGTTTTCGGATTGTAAACCTCTGTTTTCGGTGACGAACAAATGACGGTAACCGAGTAGGAAGCCACGGCTAACTACGTGCCAGCAGCCGCGG	0.0
TGGGGAATATTGCACAATGGGCGAAAGCCTGATGCAGCGACGCCGCGTGAGGGATGACGGCCTTCGGGTTGTAAACCTCTTTCGCTCATGGTCAAGCCGCAGCTTTGGGTTGTGGTGAGGGTAGTGGGTAAAGAAGCGCCGGCTAACTAC	TGGGGAATATTGCACAATGGGCGAAAGCCTGATGCAGCGACGCCGCGTGAGGGATGACGGCCTTCGGGTTGTAAACCTCTTTCGCTCATGGTCAAGCCGCAGCTTTGGGTTGTGGTGAGGGTAGTGGGTAAAGAAGCGCCGGCTAACTAC	0.0
TGGGGAATATTGCACAATGGGCGCAAGCCTGATGCAGCAACGCCGCGTGAAGGAAGACGGTTTTCGGATTGTAAACTTCTGTTCTTAGTGAAGAATAATGACGGTAGCTAAGGAGCAAGCCACGGCTAACTACGTGCCAGCAGCCGCGGT	TGGGGAATATTGCACAATGGGCGCAAGCCTGATGCAGCAACGCCGCGTGAAGGAAGACGGTTTTCGGATTGTAAACTTCTGTTCTTAGTGAAGAATAATGACGGTAGCTAAGGAGCAAGCCACGGCTAACTACGTGCCAGCAGCCGCGGT	0.0
TGGGGAATATTGCACAATGGGCGCAAGCCTGATGCAGCCATGCCGCGTGTATGAAGAAGGCCTTCGGGTTGTAAAGTACTTTCAGCGGGGAGGAAGGGAGTAAAGTTAATACCTTTACTCATTGACGTTACCCGCAGAAGAAGCACCGGC	TGGGGAATATTGCACAATGGGCGCAAGCCTGATGCAGCCATGCCGCGTGTATGAAGAAGGCCTTCGGGTTGTAAAGTACTTTCAGCGGGGAGGAAGGGAGTAAAGTTAATACCTTTACTCATTGACGTTACCCGCAGAAGAAGCACCGGC	0.0
TGGGGAATATTGCACAATGGGCGCAAGCCTGATGCAGCCATGCCGCGTGTATGAAGAAGGCCTTCGGGTTGTAAAGTACTTTCAGCGGGGAGGAAGGGAGTAAAGTTAATACCTTTGCTCATTGACGTTACCCGCAGAAGAAGCACCGGC	TGGGGAATATTGCACAATGGGCGCAAGCCTGATGCAGCCATGCCGCGTGTATGAAGAAGGCCTTCGGGTTGTAAAGTACTTTCAGCGGGGAGGAAGGGAGTAAAGTTAATACCTTTGCTCATTGACGTTACCCGCAGAAGAAGCACCGGC	0.0
TGGGGAATATTGCACAATGGGCGCAAGCCTGATGCAGCGACGCCGCGTGAAGGATGAAGGTCTTCGGATCGTAAACTTCTATCAGCAGGGAAGAAACCATGACGGTACCTGACTAAGAAGCCCCGGCTAACTACGTGCCAGCAGCCGCGG	TGGGGAATATTGCACAATGGGCGCAAGCCTGATGCAGCGACGCCGCGTGAAGGATGAAGGTCTTCGGATCGTAAACTTCTATCAGCAGGGAAGAAACCATGACGGTACCTGACTAAGAAGCCCCGGCTAACTACGTGCCAGCAGCCGCGG	0.0
TGGGGAATATTGCACAATGGGCGCAAGCCTGATGCAGCGACGCCGCGTGAGGGATGACGGCCTTCGGGTTGTAAACCTCTGTTAGCAGGGAAGAAGAGAAATTGACGGTACCTGCAGAGAAAGCGCCGGCTAACTACGTGCCAGCAGCCG	TGGGGAATATTGCACAATGGGCGCAAGCCTGATGCAGCGACGCCGCGTGAGGGATGACGGCCTTCGGGTTGTAAACCTCTGTTAGCAGGGAAGAAGAGAAATTGACGGTACCTGCAGAGAAAGCGCCGGCTAACTACGTGCCAGCAGCCG	0.0
TGGGGAATATTGCACAATGGGCGCAAGCCTGATGCAGCGACGCCGCGTGAGGGATGACGGCCTTCGGGTTGTAAACCTCTGTTAGCAGGGAAGAAGAGAGATTGACGGTACCTGCAGAGAAAGCGCCGGCTAACTACGTGCCAGCAGCCG	TGGGGAATATTGCACAATGGGCGCAAGCCTGATGCAGCGACGCCGCGTGAGGGATGACGGCCTTCGGGTTGTAAACCTCTGTTAGCAGGGAAGAAGAGAGATTGACGGTACCTGCAGAGAAAGCGCCGGCTAACTACGTGCCAGCAGCCG	0.0
TGGGGAATATTGCACAATGGGCGCAAGCCTGATGCAGCGACGCCGCGTGAGGGATGACGGCCTTCGGGTTGTAAACCTCTGTTAGCATCGAAGAAGCGAAAGTGACGGTAGGTGCAGAGAAAGCGCCGGCTAACTACGTGCCAGCAGCCG	TGGGGAATATTGCACAATGGGCGCAAGCCTGATGCAGCGACGCCGCGTGAGGGATGACGGCCTTCGGGTTGTAAACCTCTGTTAGCATCGAAGAAGCGAAAGTGACGGTAGGTGCAGAGAAAGCGCCGGCTAACTACGTGCCAGCAGCCG	0.0
TGGGGAATATTGCACAATGGGCGCAAGCCTGATGCAGCGACGCCGCGTGAGGGATGGAGGCCTTCGGGTTGTAAACCTCTTTCGCCAGTGAAGCAGGCCTGTCCCTTGTGGGTGGGTTGACGGTAGCTGGATAAGAAGCGCCGGCTAACT	TGGGGAATATTGCACAATGGGCGCAAGCCTGATGCAGCGACGCCGCGTGAGGGATGGAGGCCTTCGGGTTGTAAACCTCTTTCGCCAGTGAAGCAGGCCTGTCCCTTGTGGGTGGGTTGACGGTAGCTGGATAAGAAGCGCCGGCTAACT	0.0
TGGGGAATATTGCACAATGGGCGCAAGCCTGATGCAGCGACGCCGCGTGAGGGATGGAGGCCTTCGGGTTGTAAACCTCTTTTATCGGGGAGCAAGCGAGAGTGAGTTTACCCGTTGAATAAGCACCGGCTAACTACGTGCCAGCAGCCG	TGGGGAATATTGCACAATGGGCGCAAGCCTGATGCAGCGACGCCGCGTGAGGGATGGAGGCCTTCGGGTTGTAAACCTCTTTTATCGGGGAGCAAGCGAGAGTGAGTTTACCCGTTGAATAAGCACCGGCTAACTACGTGCCAGCAGCCG	0.0
TGGGGAATATTGCACAATGGGCGCAAGCCTGATGCAGCGACGCCGCGTGAGGGATGGAGGCCTTCGGGTTGTAAACCTCTTTTGTTTGGGAGCAAGCCTTCGGGTGAGTGTACCTTTCGAATAAGCGCCGGCTAACTACGTGCCAGCAGC	TGGGGAATATTGCACAATGGGCGCAAGCCTGATGCAGCGACGCCGCGTGAGGGATGGAGGCCTTCGGGTTGTAAACCTCTTTTGTTTGGGAGCAAGCCTTCGGGTGAGTGTACCTTTCGAATAAGCGCCGGCTAACTACGTGCCAGCAGC	0.0
TGGGGAATATTGCACAATGGGCGCAAGCCTGATGCAGCGACGCCGCGTGAGGGATGGAGGCCTTCGGGTTGTGAACCTCTTTCGCCAGTGAAGCAGGCCTGCTCCTTGGTGGGTGGGTTGACGGTAGCTGGATAAGAAGCGCCGGCTAAC	TGGGGAATATTGCACAATGGGCGCAAGCCTGATGCAGCGACGCCGCGTGAGGGATGGAGGCCTTCGGGTTGTGAACCTCTTTCGCCAGTGAAGCAGGCCTGCTCCTTGGTGGGTGGGTTGACGGTAGCTGGATAAGAAGCGCCGGCTAAC	0.0
TGGGGAATATTGCACAATGGGCGCAAGCCTGATGCAGCGACGCCGCGTGAGGGATGGAGGCCTTCGGGTTGTGAACCTCTTTCGCTCATGGTCAAGCCGCAACAATGGTTGTGGTGAGGGTAGTGGGTAAAGAAGCGCCGGCTAACTACG	TGGGGAATATTGCACAATGGGCGCAAGCCTGATGCAGCGACGCCGCGTGAGGGATGGAGGCCTTCGGGTTGTGAACCTCTTTCGCTCATGGTCAAGCCGCAACAATGGTTGTGGTGAGGGTAGTGGGTAAAGAAGCGCCGGCTAACTACG	0.0
TGGGGAATATTGCACAATGGGGGAAACCCTGATGCAGCAACGCCGCGTGAAGGAAGAAGGCCTTTGGGTCGTAAACTTCTGTTCTGAGGGAAGAAAGTGACGGTACCTCAGGAGCAAGTCCCGGCTAACTACGTGCCAGCAGCCGCGGTA	TGGGGAATATTGCACAATGGGGGAAACCCTGATGCAGCAACGCCGCGTGAAGGAAGAAGGCCTTTGGGTCGTAAACTTCTGTTCTGAGGGAAGAAAGTGACGGTACCTCAGGAGCAAGTCCCGGCTAACTACGTGCCAGCAGCCGCGGTA	0.0
TGGGGAATATTGCACAATGGGGGAAACCCTGATGCAGCAACGCCGCGTGAAGGAAGAAGGTTTTCGGATCGTAAACTTCTATCAACAGGGACGAAGAAAGTGACGGTACCTGAATAAGAAGCCCCGGCTAACTACGTGCCAGCAGCCGCG	TGGGGAATATTGCACAATGGGGGAAACCCTGATGCAGCAACGCCGCGTGAAGGAAGAAGGTTTTCGGATCGTAAACTTCTATCAACAGGGACGAAGAAAGTGACGGTACCTGAATAAGAAGCCCCGGCTAACTACGTGCCAGCAGCCGCG	0.0
TGGGGAATATTGCACAATGGGGGAAACCCTGATGCAGCAACGCCGCGTGAAGGAAGAAGGTTTTCGGATCGTAAACTTCTATCAATAGGGACGAAATAAATGACGGTACCTAAATAAGAAGCCCCGGCTAACTACGTGCCAGCAGCCGCG	TGGGGAATATTGCACAATGGGGGAAACCCTGATGCAGCAACGCCGCGTGAAGGAAGAAGGTTTTCGGATCGTAAACTTCTATCAATAGGGACGAAATAAATGACGGTACCTAAATAAGAAGCCCCGGCTAACTACGTGCCAGCAGCCGCG	0.0
TGGGGAATATTGCACAATGGGGGAAACCCTGATGCAGCGACGCCGCGTGAAGGAAGAAGGCCTTCGGGTTGTAAACTTCTGTCTTCAGGGACGATAATGACGGTACCTGAGGAGGAAGCTCCGGCTAACTACGTGCCAGCAGCCGCGGTA	TGGGGAATATTGCACAATGGGGGAAACCCTGATGCAGCGACGCCGCGTGAAGGAAGAAGGCCTTCGGGTTGTAAACTTCTGTCTTCAGGGACGATAATGACGGTACCTGAGGAGGAAGCTCCGGCTAACTACGTGCCAGCAGCCGCGGTA	0.0
TGGGGAATATTGCACAATGGGGGAAACCCTGATGCAGCGACGCCGCGTGAGCGAAGAAGTATCTCGGTATGTAAAGCTCTATCAGCAGGGAAGAAGAATGACGGTACCTGACTAAGAAGCTCCGGCTAAATACGTGCCAGCAGCCGCGGT	TGGGGAATATTGCACAATGGGGGAAACCCTGATGCAGCGACGCCGCGTGAGCGAAGAAGTATCTCGGTATGTAAAGCTCTATCAGCAGGGAAGAAGAATGACGGTACCTGACTAAGAAGCTCCGGCTAAATACGTGCCAGCAGCCGCGGT	0.0
TGGGGAATATTGCACAATGGGGGAAACCCTGATGCAGCGACGCCGCGTGAGCGAAGAAGTATTTCGGTATGTAAAGCTCTATCAGCAGGGAAGAAAATGACGGTACCTGACTAAGAAGCACCGGCTAAATACGTGCCAGCAGCCGCGGTA	TGGGGAATATTGCACAATGGGGGAAACCCTGATGCAGCGACGCCGCGTGAGCGAAGAAGTATTTCGGTATGTAAAGCTCTATCAGCAGGGAAGAAAATGACGGTACCTGACTAAGAAGCACCGGCTAAATACGTGCCAGCAGCCGCGGTA	0.0
TGGGGAATATTGCACAATGGGGGAAACCCTGATGCAGCGACGCCGCGTGAGCGAAGAAGTATTTCGGTATGTAAAGCTCTATCAGCAGGGAAGAAAATGACGGTACCTGACTAAGAAGCCCCGGCTAACTACGTGCCAGCAGCCGCGGTA	TGGGGAATATTGCACAATGGGGGAAACCCTGATGCAGCGACGCCGCGTGAGCGAAGAAGTATTTCGGTATGTAAAGCTCTATCAGCAGGGAAGAAAATGACGGTACCTGACTAAGAAGCCCCGGCTAACTACGTGCCAGCAGCCGCGGTA	0.0
TGGGGAATATTGCACAATGGGGGAAACCCTGATGCAGCGACGCCGCGTGAGCGATGAAGTATTTCGGTATGTAAAGCTCTATCAGCAGGGAAGAAAATGACGGTACCTGACTAAGAAGCCCCGGCTAACTACGTGCCAGCAGCCGCGGTA	TGGGGAATATTGCACAATGGGGGAAACCCTGATGCAGCGACGCCGCGTGAGCGATGAAGTATTTCGGTATGTAAAGCTCTATCAGCAGGGAAGAAAATGACGGTACCTGACTAAGAAGCCCCGGCTAACTACGTGCCAGCAGCCGCGGTA	0.0
TGGGGAATATTGCACAATGGGGGAAACCCTGATGCAGCGACGCCGCGTGAGCGATGAAGTATTTCGGTATGTAAAGCTCTATCAGCAGGGAAGATAATGACGGTACCTGACTAAGAAGCTCCGGCTAAATACGTGCCAGCAGCCGCGGTA	TGGGGAATATTGCACAATGGGGGAAACCCTGATGCAGCGACGCCGCGTGAGCGATGAAGTATTTCGGTATGTAAAGCTCTATCAGCAGGGAAGATAATGACGGTACCTGACTAAGAAGCTCCGGCTAAATACGTGCCAGCAGCCGCGGTA	0.0
TGGGGAATATTGCACAATGGGGGAAACCCTGATGCAGCGACGCCGCGTGAGGGAAGAAGGTTTTCGGATTGTAAACCTCTGTCTTCAGGGACGATAGTGACGGTACCTGAGGAGGAAGCTCCGGCTAACTACGTGCCAGCAGCCGCGGTA	TGGGGAATATTGCACAATGGGGGAAACCCTGATGCAGCGACGCCGCGTGAGGGAAGAAGGTTTTCGGATTGTAAACCTCTGTCTTCAGGGACGATAGTGACGGTACCTGAGGAGGAAGCTCCGGCTAACTACGTGCCAGCAGCCGCGGTA	0.0
TGGGGAATATTGCACAATGGGGGAAACCCTGATGCAGCGACGCCGCGTGAGTGAAGAAGTATCTCGGTATGTAAAGCTCTATCAGCAGGGAAGAAAATGACGGTACCTGACTAAGAAGCCCCGGCTAACTACGTGCCAGCAGCCGCGGTA	TGGGGAATATTGCACAATGGGGGAAACCCTGATGCAGCGACGCCGCGTGAGTGAAGAAGTATCTCGGTATGTAAAGCTCTATCAGCAGGGAAGAAAATGACGGTACCTGACTAAGAAGCCCCGGCTAACTACGTGCCAGCAGCCGCGGTA	0.0
TGGGGAATATTGCACAATGGGGGAAACCCTGATGCAGCGACGCCGCGTGAGTGAAGAAGTATTTCGGTATGTAAAGCTCTATCAGCAGGGAAGAAGAAAGACGGTACCTGACTAAGAAGCCCCGGCTAACTACGTGCCAGCAGCCGCGGT	TGGGGAATATTGCACAATGGGGGAAACCCTGATGCAGCGACGCCGCGTGAGTGAAGAAGTATTTCGGTATGTAAAGCTCTATCAGCAGGGAAGAAGAAAGACGGTACCTGACTAAGAAGCCCCGGCTAACTACGTGCCAGCAGCCGCGGT	0.0
TGGGGAATATTGCACAATGGGGGAAACCCTGATGCAGCGACGCCGCGTGGAGGAAGAAGGTCTTCGGATTGTAAACTCCTGTCCCAGGGGACGATAATGACGGTACCCTGGGAGGAAGCACCGGCTAACTACGTGCCAGCAGCCGCGGTA	TGGGGAATATTGCACAATGGGGGAAACCCTGATGCAGCGACGCCGCGTGGAGGAAGAAGGTCTTCGGATTGTAAACTCCTGTCCCAGGGGACGATAATGACGGTACCCTGGGAGGAAGCACCGGCTAACTACGTGCCAGCAGCCGCGGTA	0.0
TGGGGAATATTGCACAATGGGGGGAACCCTGATGCAGCGACGCCGCGTGAGCGAAGAAGGTTTTCGAATCGTAAAGCTCTGTCCTATGAGAAGATAATGACGGTATCATAGGAGGAAGCCCCGGCTAAATACGTGCCAGCAGCCGCGGTA	TGGGGAATATTGCACAATGGGGGGAACCCTGATGCAGCGACGCCGCGTGAGCGAAGAAGGTTTTCGAATCGTAAAGCTCTGTCCTATGAGAAGATAATGACGGTATCATAGGAGGAAGCCCCGGCTAAATACGTGCCAGCAGCCGCGGTA	0.0
TGGGGAATATTGCACAATGGGGGGAACCCTGATGCAGCGACGCCGCGTGAGGGAAGAAGGTTTTCGGATTGTAAACCTCTGTCCTTGGTGACGATAATGACGGTAGCCAAGGAGGAAGCCACGGCTAACTACGTGCCAGCAGCCGCGGTA	TGGGGAATATTGCACAATGGGGGGAACCCTGATGCAGCGACGCCGCGTGAGGGAAGAAGGTTTTCGGATTGTAAACCTCTGTCCTTGGTGACGATAATGACGGTAGCCAAGGAGGAAGCCACGGCTAACTACGTGCCAGCAGCCGCGGTA	0.0
TGGGGAATATTGCGCAATGGGGGAAACCCTGACGCAGCAACGCCGCGTGATTGAAGAAGGCCTTCGGGTTGTAAAGATCTTTAATCAGGGACGAAACATGACGGTACCTGAAGAATAAGCTCCGGCTAACTACGTGCCAGCAGCCGCGGT	TGGGGAATATTGCGCAATGGGGGAAACCCTGACGCAGCAACGCCGCGTGATTGAAGAAGGCCTTCGGGTTGTAAAGATCTTTAATCAGGGACGAAACATGACGGTACCTGAAGAATAAGCTCCGGCTAACTACGTGCCAGCAGCCGCGGT	0.0
TGGGGAATATTGCGCAATGGGGGAAACCCTGACGCAGCAACGCCGCGTGATTGAAGAAGGCCTTCGGGTTGTAAAGATCTTTAATTCGGGACGAATTTTGACGGTACCGAAAGAATAAGCTCCGGCTAACTACGTGCCAGCAGCCGCGGT	TGGGGAATATTGCGCAATGGGGGAAACCCTGACGCAGCAACGCCGCGTGATTGAAGAAGGCCTTCGGGTTGTAAAGATCTTTAATTCGGGACGAATTTTGACGGTACCGAAAGAATAAGCTCCGGCTAACTACGTGCCAGCAGCCGCGGT	0.0
TGGGGAATATTGCGCAATGGGGGCAACCCTGACGCAGCAACGCCGCGTGAGCGATGAAGGTTTTCGGATCGTAAAGCTCTGTTCTGAGGGAAGATAGTGACGGTACCTCAGGAGAAAGCCCCGGCTAACTACGTGCCAGCAGCCGCGGTA	TGGGGAATATTGCGCAATGGGGGCAACCCTGACGCAGCAACGCCGCGTGAGCGATGAAGGTTTTCGGATCGTAAAGCTCTGTTCTGAGGGAAGATAGTGACGGTACCTCAGGAGAAAGCCCCGGCTAACTACGTGCCAGCAGCCGCGGTA	0.0
TGGGGAATATTGCGCAATGGGGGCAACCCTGACGCAGCCATGCCGCGTGAATGAAGAAGGCCTTCGGGTTGTAAAGTTCTTTCGGTAGCGAGGAAGGCACTTAGTTTAATAAACTAGGTGATTGACGTTAACTACAGAAGAAGCACCGGC	TGGGGAATATTGCGCAATGGGGGCAACCCTGACGCAGCCATGCCGCGTGAATGAAGAAGGCCTTCGGGTTGTAAAGTTCTTTCGGTAGCGAGGAAGGCACTTAGTTTAATAAACTAGGTGATTGACGTTAACTACAGAAGAAGCACCGGC	0.0
TGGGGAATATTGCGCAATGGGGGCAACCCTGACGCAGCCATGCCGCGTGAATGAAGAAGGCCTTCGGGTTGTAAAGTTCTTTCGGTAGCGAGGAAGGCATTTAGTTTAATAAACTAGGTGATTGACGTTAACTACAGAAGAAGCACCGGC	TGGGGAATATTGCGCAATGGGGGCAACCCTGACGCAGCCATGCCGCGTGAATGAAGAAGGCCTTCGGGTTGTAAAGTTCTTTCGGTAGCGAGGAAGGCATTTAGTTTAATAAACTAGGTGATTGACGTTAACTACAGAAGAAGCACCGGC	0.0
TGGGGAATATTGCGCAATGGGGGCAACCCTGACGCAGCCATGCCGCGTGAATGAAGAAGGCCTTCGGGTTGTAAAGTTCTTTCGGTAGCGAGGAAGGCATTTAGTTTAATAAACTGGATGATTGACGTTAACTACAGAAGAAGCACCGGC	TGGGGAATATTGCGCAATGGGGGCAACCCTGACGCAGCCATGCCGCGTGAATGAAGAAGGCCTTCGGGTTGTAAAGTTCTTTCGGTAGCGAGGAAGGCATTTAGTTTAATAAACTGGATGATTGACGTTAACTACAGAAGAAGCACCGGC	0.0
TGGGGAATATTGCGCAATGGGGGCAACCCTGACGCAGCCATGCCGCGTGAATGAAGAAGGCCTTCGGGTTGTAAAGTTCTTTCGGTAGCGAGGAAGGCATTTAGTTTAATAGACTAGGTGATTGACGTTAACTACAGAAGAAGCACCGGC	TGGGGAATATTGCGCAATGGGGGCAACCCTGACGCAGCCATGCCGCGTGAATGAAGAAGGCCTTCGGGTTGTAAAGTTCTTTCGGTAGCGAGGAAGGCATTTAGTTTAATAGACTAGGTGATTGACGTTAACTACAGAAGAAGCACCGGC	0.0
TGGGGAATATTGGACAATGGACCGAGAGTCTGATCCAGCAATTCTGTGTGCACGATGAAGTTTTTCGGAATGTAAAGTGCTTTCAGTTGGGAAGAAAAAAATGACGGTACCAACAGAAGAAGTGACGGCTAAATACGTGCCAGCAGCCGC	TGGGGAATATTGGACAATGGACCGAGAGTCTGATCCAGCAATTCTGTGTGCACGATGAAGTTTTTCGGAATGTAAAGTGCTTTCAGTTGGGAAGAAAAAAATGACGGTACCAACAGAAGAAGTGACGGCTAAATACGTGCCAGCAGCCGC	0.0
TGGGGAATATTGGGCAATGGACGCAAGTCTGACCCAGCAACGCCGCGTGAAGGAAGAAGGCTTTCGGGTTGTAAACTTCTTTTGTCAGGGAAGAGCAGAAGACGGTACCTGACGAATAAGCCACGGCTAACTACGTGCCAGCAGCCGCGG	TGGGGAATATTGGGCAATGGACGCAAGTCTGACCCAGCAACGCCGCGTGAAGGAAGAAGGCTTTCGGGTTGTAAACTTCTTTTGTCAGGGAAGAGCAGAAGACGGTACCTGACGAATAAGCCACGGCTAACTACGTGCCAGCAGCCGCGG	0.0
TGGGGAATATTGGGCAATGGAGGAAACTCTGACCCAGCAACGCCGCGTGGAGGAAGAAGGTTTTCGGATCGTAAACTCCTGTCCTTGGAGACGAGTAGAAGACGGTATCCAAGGAGGAAGCCCCGGCTAACTACGTGCCAGCAGCCGCGG	TGGGGAATATTGGGCAATGGAGGAAACTCTGACCCAGCAACGCCGCGTGGAGGAAGAAGGTTTTCGGATCGTAAACTCCTGTCCTTGGAGACGAGTAGAAGACGGTATCCAAGGAGGAAGCCCCGGCTAACTACGTGCCAGCAGCCGCGG	0.0
TGGGGAATATTGGGCAATGGGCGAAAGCCTGACCCAGCAACGCCGCGTGAAGGAAGAAGGCCTTCGGGTTGTAAACTTCTTTTAAGAGGGACGAAGAAGTGACGGTACCTCTTGAATAAGCCACGGCTAACTACGTGCCAGCAGCCGCGG	TGGGGAATATTGGGCAATGGGCGAAAGCCTGACCCAGCAACGCCGCGTGAAGGAAGAAGGCCTTCGGGTTGTAAACTTCTTTTAAGAGGGACGAAGAAGTGACGGTACCTCTTGAATAAGCCACGGCTAACTACGTGCCAGCAGCCGCGG	0.0
TGGGGAATATTGGGCAATGGGCGAAAGCCTGACCCAGCAACGCCGCGTGAAGGAAGAAGGTCTTCGGATTGTAAACTTCTTTTATGAGGGACGAAGGAAGTGACGGTACCTCATGAATAAGCCACGGCTAACTACGTGCCAGCAGCCGCG	TGGGGAATATTGGGCAATGGGCGAAAGCCTGACCCAGCAACGCCGCGTGAAGGAAGAAGGTCTTCGGATTGTAAACTTCTTTTATGAGGGACGAAGGAAGTGACGGTACCTCATGAATAAGCCACGGCTAACTACGTGCCAGCAGCCGCG	0.0
TGGGGAATATTGGGCAATGGGCGAAAGCCTGACCCAGCAACGCCGCGTGAAGGAAGAAGGTTTTCGGATCGTAAACTTCTATCCTTGGTGAAGATAATGACGGTAGCCAAGAAGGAAGCCCCGGCTAACTACGTGCCAGCAGCCGCGGTA	TGGGGAATATTGGGCAATGGGCGAAAGCCTGACCCAGCAACGCCGCGTGAAGGAAGAAGGTTTTCGGATCGTAAACTTCTATCCTTGGTGAAGATAATGACGGTAGCCAAGAAGGAAGCCCCGGCTAACTACGTGCCAGCAGCCGCGGTA	0.0
TGGGGAATATTGGGCAATGGGCGAAAGCCTGACCCAGCAACGCCGCGTGAGGGAAGAAGGGTTTCGGCTCGTAAACCTCTGTCCTATGGGACGAAGGAAGTGACGGTACCATAGGAGGAAGCCCCGGCTAACTACGTGCCAGCAGCCGCG	TGGGGAATATTGGGCAATGGGCGAAAGCCTGACCCAGCAACGCCGCGTGAGGGAAGAAGGGTTTCGGCTCGTAAACCTCTGTCCTATGGGACGAAGGAAGTGACGGTACCATAGGAGGAAGCCCCGGCTAACTACGTGCCAGCAGCCGCG	0.0
TGGGGAATATTGGGCAATGGGCGAAAGCCTGACCCAGCAACGCCGCGTGAGGGAAGAAGGTTTTCGGATTGTAAACCTCTGTCCTCAGGGACGAAGGAAGTGACGGTACCTGAGGAGGAAGCCCCGGCTAACTACGTGCCAGCAGCCGCG	TGGGGAATATTGGGCAATGGGCGAAAGCCTGACCCAGCAACGCCGCGTGAGGGAAGAAGGTTTTCGGATTGTAAACCTCTGTCCTCAGGGACGAAGGAAGTGACGGTACCTGAGGAGGAAGCCCCGGCTAACTACGTGCCAGCAGCCGCG	0.0
TGGGGAATATTGGGCAATGGGCGAAAGCCTGACCCAGCAACGCCGCGTGAGTGAAGAAGGCTTTCGGGTTGTAAAGCTCTGTCCTAGGGGACGAAGGAAGTGACGGTACCCAAGGAGGAAGCCCCGGCTAACTACGTGCCAGCAGCCGCG	TGGGGAATATTGGGCAATGGGCGAAAGCCTGACCCAGCAACGCCGCGTGAGTGAAGAAGGCTTTCGGGTTGTAAAGCTCTGTCCTAGGGGACGAAGGAAGTGACGGTACCCAAGGAGGAAGCCCCGGCTAACTACGTGCCAGCAGCCGCG	0.0
TGGGGAATATTGGGCAATGGGCGAAAGCCTGACCCAGCAACGCCGCGTGAGTGAAGAAGGCTTTCGGGTTGTAAAGCTCTGTCCTTGGGGACGAAGGAAGTGACGGTACCCAAGGAGGAAGCCCCGGCTAACTACGTGCCAGCAGCCGCG	TGGGGAATATTGGGCAATGGGCGAAAGCCTGACCCAGCAACGCCGCGTGAGTGAAGAAGGCTTTCGGGTTGTAAAGCTCTGTCCTTGGGGACGAAGGAAGTGACGGTACCCAAGGAGGAAGCCCCGGCTAACTACGTGCCAGCAGCCGCG	0.0
TGGGGAATATTGGGCAATGGGCGAAAGCCTGACCCAGCGACGCCGCGTGAAGGATGAAGGTCTTCGGATTGTAAACTTCTGTCTACAGGGACGAACAAATGACGGTACCTGTAAAGAAAGCCACGGCTAACTACGTGCCAGCAGCCGCGG	TGGGGAATATTGGGCAATGGGCGAAAGCCTGACCCAGCGACGCCGCGTGAAGGATGAAGGTCTTCGGATTGTAAACTTCTGTCTACAGGGACGAACAAATGACGGTACCTGTAAAGAAAGCCACGGCTAACTACGTGCCAGCAGCCGCGG	0.0
TGGGGAATATTGGGCAATGGGCGAAAGCCTGACCCAGCGACGCCGCGTGAGGGAAGAAGGTCTTCGGATTGTAAACCTCTTTCAGCAGGGAAGAAGAAAGTGACGGTACCTGCAGAAGAAGTCACGGCTAACTACGTGCCAGCAGCCGCG	TGGGGAATATTGGGCAATGGGCGAAAGCCTGACCCAGCGACGCCGCGTGAGGGAAGAAGGTCTTCGGATTGTAAACCTCTTTCAGCAGGGAAGAAGAAAGTGACGGTACCTGCAGAAGAAGTCACGGCTAACTACGTGCCAGCAGCCGCG	0.0
TGGGGAATATTGGGCAATGGGCGAAAGCCTTACCCAGCAACGCCGCGTGAGGGAAGAAGGTTTTCGGATTGTAAACCTCTGTCCTGGGGGACGAAGGAAGTGACGGTACCCCGGGAGGAAGCCCCGGCTAACTACGTGCCAGCAGCCGCG	TGGGGAATATTGGGCAATGGGCGAAAGCCTTACCCAGCAACGCCGCGTGAGGGAAGAAGGTTTTCGGATTGTAAACCTCTGTCCTGGGGGACGAAGGAAGTGACGGTACCCCGGGAGGAAGCCCCGGCTAACTACGTGCCAGCAGCCGCG	0.0
TGGGGAATATTGGGCAATGGGCGCAAGCCTGACCCAGCAACGCCGCGTGAAGGAAGAAGGCTCTCGGGTTGTAAACTTCTTTTATCAGGGACGAAAGAAATGACGGTACCTGATGAATAAGCCACGGCTAACTACGTGCCAGCAGCCGCG	TGGGGAATATTGGGCAATGGGCGCAAGCCTGACCCAGCAACGCCGCGTGAAGGAAGAAGGCTCTCGGGTTGTAAACTTCTTTTATCAGGGACGAAAGAAATGACGGTACCTGATGAATAAGCCACGGCTAACTACGTGCCAGCAGCCGCG	0.0
TGGGGAATATTGGGCAATGGGCGCAAGCCTGACCCAGCAACGCCGCGTGAAGGAAGAAGGCTTTCGGGTTGTAAACTTCTTTTATTAGGGACGATAATGACGGTACCTATTGAATAAGCTCCGGCTAACTACGTGCCAGCAGCCGCGGTA	TGGGGAATATTGGGCAATGGGCGCAAGCCTGACCCAGCAACGCCGCGTGAAGGAAGAAGGCTTTCGGGTTGTAAACTTCTTTTATTAGGGACGATAATGACGGTACCTATTGAATAAGCTCCGGCTAACTACGTGCCAGCAGCCGCGGTA	0.0
TGGGGAATATTGGGCAATGGGCGCAAGCCTGACCCAGCAACGCCGCGTGAAGGAAGAAGGCTTTCGGGTTGTAAACTTCTTTTGTCAGGGACGAGTAGAAGACGGTACCTGACGAATAAGCCACGGCTAACTACGTGCCAGCAGCCGCGG	TGGGGAATATTGGGCAATGGGCGCAAGCCTGACCCAGCAACGCCGCGTGAAGGAAGAAGGCTTTCGGGTTGTAAACTTCTTTTGTCAGGGACGAGTAGAAGACGGTACCTGACGAATAAGCCACGGCTAACTACGTGCCAGCAGCCGCGG	0.0
TGGGGAATATTGGGCAATGGGCGCAAGCCTGACCCAGCAACGCCGCGTGAAGGAAGAAGGCTTTCGGGTTGTAAACTTCTTTTGTCGGGGACGAGTAGAAGACGGTACCTGACGAATAAGCCACGGCTAACTACGTGCCAGCAGCCGCGG	TGGGGAATATTGGGCAATGGGCGCAAGCCTGACCCAGCAACGCCGCGTGAAGGAAGAAGGCTTTCGGGTTGTAAACTTCTTTTGTCGGGGACGAGTAGAAGACGGTACCTGACGAATAAGCCACGGCTAACTACGTGCCAGCAGCCGCGG	0.0
TGGGGAATATTGGGCAATGGGCGCAAGCCTGACCCAGCAACGCCGCGTGAAGGAAGAAGGCTTTCGGGTTGTAAACTTCTTTTGTCGGGGACGAGTAGAAGACGGTACCTGGCGAATAAGCCACGGCTAACTACGTGCCAGCAGCCGCGG	TGGGGAATATTGGGCAATGGGCGCAAGCCTGACCCAGCAACGCCGCGTGAAGGAAGAAGGCTTTCGGGTTGTAAACTTCTTTTGTCGGGGACGAGTAGAAGACGGTACCTGGCGAATAAGCCACGGCTAACTACGTGCCAGCAGCCGCGG	0.0
TGGGGAATATTGGGCAATGGGCGCAAGCCTGACCCAGCAACGCCGCGTGAGGGAAGAAGGCCTTCGGGTTGTAAACCTCTGTCCTATGGGAAGAAGAAAGTGACGGTACCATAGGAGGAAGCTCCGGCTAACTACGTGCCAGCAGCCGCG	TGGGGAATATTGGGCAATGGGCGCAAGCCTGACCCAGCAACGCCGCGTGAGGGAAGAAGGCCTTCGGGTTGTAAACCTCTGTCCTATGGGAAGAAGAAAGTGACGGTACCATAGGAGGAAGCTCCGGCTAACTACGTGCCAGCAGCCGCG	0.0
TGGGGAATATTGGGCAATGGGCGCAAGCCTGACCCAGCAACGCCGCGTGAGGGAAGAAGGTTTTCGGATTGTAAACCTCTGTCGCAGAAGACGAAGGAAGTGACGGTATTCTGTGAGGAAGCCCCGGCTAACTACGTGCCAGCAGCCGCG	TGGGGAATATTGGGCAATGGGCGCAAGCCTGACCCAGCAACGCCGCGTGAGGGAAGAAGGTTTTCGGATTGTAAACCTCTGTCGCAGAAGACGAAGGAAGTGACGGTATTCTGTGAGGAAGCCCCGGCTAACTACGTGCCAGCAGCCGCG	0.0
TGGGGAATATTGGGCAATGGGCGCAAGCCTGACCCAGCAACGCCGCGTGAGGGAAGAAGGTTTTCGGATTGTAAACCTCTGTCGCAGGGGACGAAGGAAGTGACGGTACCCTGTAAGAAAGCCCCGGCTAACTACGTGCCAGCAGCCGCG	TGGGGAATATTGGGCAATGGGCGCAAGCCTGACCCAGCAACGCCGCGTGAGGGAAGAAGGTTTTCGGATTGTAAACCTCTGTCGCAGGGGACGAAGGAAGTGACGGTACCCTGTAAGAAAGCCCCGGCTAACTACGTGCCAGCAGCCGCG	0.0
TGGGGAATATTGGGCAATGGGGGAAACCCTGACCCAGCAACGCCGCGTGAAGGAAGAAGGCCTTCGGGTTGTAAACTTCTTTTACCAGGGACGAAGGACGTGACGGTACCTGGAGAAAAAGCAACGGCTAACTACGTGCCAGCAGCCGCG	TGGGGAATATTGGGCAATGGGGGAAACCCTGACCCAGCAACGCCGCGTGAAGGAAGAAGGCCTTCGGGTTGTAAACTTCTTTTACCAGGGACGAAGGACGTGACGGTACCTGGAGAAAAAGCAACGGCTAACTACGTGCCAGCAGCCGCG	0.0
TGGGGAATATTGGGCAATGGGGGAAACCCTGACCCAGCAACGCCGCGTGAAGGAAGAAGGCTTTCGGGTTGTAAACTTCTTTTACCAGGGACGAAGAAAGTGACGGTACCTGGAGAAAAAGCCACGGCTAACTACGTGCCAGCAGCCGCG	TGGGGAATATTGGGCAATGGGGGAAACCCTGACCCAGCAACGCCGCGTGAAGGAAGAAGGCTTTCGGGTTGTAAACTTCTTTTACCAGGGACGAAGAAAGTGACGGTACCTGGAGAAAAAGCCACGGCTAACTACGTGCCAGCAGCCGCG	0.0
TGGGGAATATTGGGCAATGGGGGAAACCCTGACCCAGCAACGCCGCGTGAAGGAAGAAGGCTTTCGGGTTGTAAACTTCTTTTACCAGGGACGAAGGACGTGACGGTACCTGGAGAAAAAGCCACGGCTAACTACGTGCCAGCAGCCGCG	TGGGGAATATTGGGCAATGGGGGAAACCCTGACCCAGCAACGCCGCGTGAAGGAAGAAGGCTTTCGGGTTGTAAACTTCTTTTACCAGGGACGAAGGACGTGACGGTACCTGGAGAAAAAGCCACGGCTAACTACGTGCCAGCAGCCGCG	0.0
TGGGGAATATTGGGCAATGGGGGAAACCCTGACCCAGCAACGCCGCGTGAAGGAAGAAGGTCTTCGGATTGTAAACTTCTGTCCTCAGGGAAGAAACAAATGACGGTACCTGAGGAGGAAGCTCCGGCTAACTACGTGCCAGCAGCCGCG	TGGGGAATATTGGGCAATGGGGGAAACCCTGACCCAGCAACGCCGCGTGAAGGAAGAAGGTCTTCGGATTGTAAACTTCTGTCCTCAGGGAAGAAACAAATGACGGTACCTGAGGAGGAAGCTCCGGCTAACTACGTGCCAGCAGCCGCG	0.0
TGGGGAATATTGGGCAATGGGGGAAACCCTGACCCAGCAACGCCGCGTGAAGGAAGAAGGTTTTCGGATTGTAAACTTCTGTCCTAAGGGAAGAAAGAAATGACGGTACCTTAGGAGGAAGCCCCGGCTAACTACGTGCCAGCAGCCGCG	TGGGGAATATTGGGCAATGGGGGAAACCCTGACCCAGCAACGCCGCGTGAAGGAAGAAGGTTTTCGGATTGTAAACTTCTGTCCTAAGGGAAGAAAGAAATGACGGTACCTTAGGAGGAAGCCCCGGCTAACTACGTGCCAGCAGCCGCG	0.0
TGGGGAATATTGGGCAATGGGGGCAACCCTGACCCAGCAACGCCGCGTGAAGGAAGAAGGCTTTCGGGTTGTAAACTTCTTTTACCAGGGACGAAGGACGTGACGGTACCTGGAGAAAAAGCCACGGCTAACTACGTGCCAGCAGCCGCG	TGGGGAATATTGGGCAATGGGGGCAACCCTGACCCAGCAACGCCGCGTGAAGGAAGAAGGCTTTCGGGTTGTAAACTTCTTTTACCAGGGACGAAGGACGTGACGGTACCTGGAGAAAAAGCCACGGCTAACTACGTGCCAGCAGCCGCG	0.0
TGGGGAATCTTCCGCAATGGACGAAAGTCTGACGGAGCAACGCCGCGTGAACGATGACGGCCTTCGGGTTGTAAAGTTCTGTTATATGGGACGAACAGGACATCGGTTAATACCCGGTGTCTTTGACGGTACCGTAAGAGAAAGCCACGG	TGGGGAATCTTCCGCAATGGACGAAAGTCTGACGGAGCAACGCCGCGTGAACGATGACGGCCTTCGGGTTGTAAAGTTCTGTTATATGGGACGAACAGGACATCGGTTAATACCCGGTGTCTTTGACGGTACCGTAAGAGAAAGCCACGG	0.0
TGGGGAATCTTCCGCAATGGACGAAAGTCTGACGGAGCAACGCCGCGTGAGTGATGACGGCCTTCGGGTTGTAAAGCTCTGTTAATCGGGACGAAAGGCCTTCTTGCGAATAGTTAGAAGGATTGACGGTACCGGAATAGAAAGCCACGG	TGGGGAATCTTCCGCAATGGACGAAAGTCTGACGGAGCAACGCCGCGTGAGTGATGACGGCCTTCGGGTTGTAAAGCTCTGTTAATCGGGACGAAAGGCCTTCTTGCGAATAGTTAGAAGGATTGACGGTACCGGAATAGAAAGCCACGG	0.0
TGGGGAATCTTCCGCAATGGACGAAAGTCTGACGGAGCAACGCCGCGTGAGTGATGACGGCCTTCGGGTTGTAAAGCTCTGTTAATCGGGACGAATGGTTCTTGTGCGAATAGTGCGAGGATTTGACGGTACCGGAATAGAAAGCCACGG	TGGGGAATCTTCCGCAATGGACGAAAGTCTGACGGAGCAACGCCGCGTGAGTGATGACGGCCTTCGGGTTGTAAAGCTCTGTTAATCGGGACGAATGGTTCTTGTGCGAATAGTGCGAGGATTTGACGGTACCGGAATAGAAAGCCACGG	0.0
TGGGGAATCTTCCGCAATGGGCGAAAGCCTGACGGAGCAACGCCGCGTGAGTGATGACGGCCTTCGGGTTGTAAAACTCTGTGATCCGGGACGAAAAGGCAGAGTGCGAAGAACAAACTGCATTGACGGTACCGGAAAAGCAAGCCACGG	TGGGGAATCTTCCGCAATGGGCGAAAGCCTGACGGAGCAACGCCGCGTGAGTGATGACGGCCTTCGGGTTGTAAAACTCTGTGATCCGGGACGAAAAGGCAGAGTGCGAAGAACAAACTGCATTGACGGTACCGGAAAAGCAAGCCACGG	0.0
TGGGGAATCTTCCGCAATGGGCGAAAGCCTGACGGAGCAATGCCGCGTGAGTGAAGAAGGCCTTCGGGTTGTAAAGCTCTATCGTAGCCGAAGAGAGCGTGGGATAGTAACTGATTCTACGAGGACGGTAGGCTACAAGGAAGCCCCGGC	TGGGGAATCTTCCGCAATGGGCGAAAGCCTGACGGAGCAATGCCGCGTGAGTGAAGAAGGCCTTCGGGTTGTAAAGCTCTATCGTAGCCGAAGAGAGCGTGGGATAGTAACTGATTCTACGAGGACGGTAGGCTACAAGGAAGCCCCGGC	0.0
TGGGGAATCTTCCGCAATGGGCGAAAGCCTGACGGAGCAATGCCGCGTGAGTGATGAAGGAATTCGTTCCGTAAAGCTCTTTTGTTTATGACGAATGTGCAGATTGTGAATAATGATCTGTAATGACGGTAGTAAACGAATAAGCCACGG	TGGGGAATCTTCCGCAATGGGCGAAAGCCTGACGGAGCAATGCCGCGTGAGTGATGAAGGAATTCGTTCCGTAAAGCTCTTTTGTTTATGACGAATGTGCAGATTGTGAATAATGATCTGTAATGACGGTAGTAAACGAATAAGCCACGG	0.0
TGGGGAATCTTGCACAATGGGCGAAAGCCTGATGCAGCGACGCCGCGTGCGGGATGAAGGCCTTCGGGTTGTAAACCGCTTTCAGCAGGGACGAGGCGAAAGTGACGGTACCTGCAGAAGAAGCCCCGGCTAACTACGTGCCAGCAGCCG	TGGGGAATCTTGCACAATGGGCGAAAGCCTGATGCAGCGACGCCGCGTGCGGGATGAAGGCCTTCGGGTTGTAAACCGCTTTCAGCAGGGACGAGGCGAAAGTGACGGTACCTGCAGAAGAAGCCCCGGCTAACTACGTGCCAGCAGCCG	0.0
TGGGGAATCTTGCGCAATGGGGGCAACCCTGACGCAGCGACGCCGCGTGCGGGACGGAGGCCTTCGGGTCGTAAACCGCTTTCAGCAGGGAAGAGACAAGACTGTACCTGCAGAAGAAGCCCCGGCTAACTACGTGCCAGCAGCCGCGGT	TGGGGAATCTTGCGCAATGGGGGCAACCCTGACGCAGCGACGCCGCGTGCGGGACGGAGGCCTTCGGGTCGTAAACCGCTTTCAGCAGGGAAGAGACAAGACTGTACCTGCAGAAGAAGCCCCGGCTAACTACGTGCCAGCAGCCGCGGT	0.0
TGGGGAATTTTGCGCAATGGGGGAAACCCTGACGCAGCAACGCCGCGTGCGGGACGAAGGCCTTCGGGTTGTAAACCGCTTTCAGCAGGGAAGACATAGACGGTACCTGCAGAAGAAGCTCCGGCTAACTACGTGCCAGCAGCCGCGGTA	TGGGGAATTTTGCGCAATGGGGGAAACCCTGACGCAGCAACGCCGCGTGCGGGACGAAGGCCTTCGGGTTGTAAACCGCTTTCAGCAGGGAAGACATAGACGGTACCTGCAGAAGAAGCTCCGGCTAACTACGTGCCAGCAGCCGCGGTA	0.0
TGGGGAATTTTGCGCAATGGGGGCAACCCTGACGCAGCAACGCCGCGTGCGGGACGAAGGCCTTCGGGTCGTAAACCGCTTTCAGCAGGGAAGACAGCGACGGTACCTGCAGAAGAAGCCCCGGCTAACTACGTGCCAGCAGCCGCGGTA	TGGGGAATTTTGCGCAATGGGGGCAACCCTGACGCAGCAACGCCGCGTGCGGGACGAAGGCCTTCGGGTCGTAAACCGCTTTCAGCAGGGAAGACAGCGACGGTACCTGCAGAAGAAGCCCCGGCTAACTACGTGCCAGCAGCCGCGGTA	0.0
TGGGGAATTTTGCGCAATGGGGGCAACCCTGACGCAGCAACGCCGCGTGCGGGACGAAGGCCTTCGGGTTGTAAACCGCTTTCAGCAGGGAAGACTTTGACGGTACCTGCAGAAGAAGCTCCGGCTAACTACGTGCCAGCAGCCGCGGTA	TGGGGAATTTTGCGCAATGGGGGCAACCCTGACGCAGCAACGCCGCGTGCGGGACGAAGGCCTTCGGGTTGTAAACCGCTTTCAGCAGGGAAGACTTTGACGGTACCTGCAGAAGAAGCTCCGGCTAACTACGTGCCAGCAGCCGCGGTA	0.0
TGGGGAATTTTGCGCAATGGGGGCAACCCTGACGCAGCAACGCCGCGTGCGGGACGAAGGCGTCCGCGTCGTAAACCGCTTTCAGCGGGGAACACTTCAACGAGGGTACCCGCAGAAGAAGCCCCGGCTAAATACGTGCCAGCAGCCGCG	TGGGGAATTTTGCGCAATGGGGGCAACCCTGACGCAGCAACGCCGCGTGCGGGACGAAGGCGTCCGCGTCGTAAACCGCTTTCAGCGGGGAACACTTCAACGAGGGTACCCGCAGAAGAAGCCCCGGCTAAATACGTGCCAGCAGCCGCG	0.0
TGGGGAATTTTGCGCAATGGGGGCAACCCTGACGCAGCAACGCCGCGTGCGGGACGACGGCCTTCGGGTTGTAAACCGCTTTCAGCAGGGAAGAACCTCTGACGGTACCTGCAGAAGAAGCCCCGGCTAACTACGTGCCAGCAGCCGCGG	TGGGGAATTTTGCGCAATGGGGGCAACCCTGACGCAGCAACGCCGCGTGCGGGACGACGGCCTTCGGGTTGTAAACCGCTTTCAGCAGGGAAGAACCTCTGACGGTACCTGCAGAAGAAGCCCCGGCTAACTACGTGCCAGCAGCCGCGG	0.0
TGGGGAATTTTGCGCAATGGGGGCAACCCTGACGCAGCAACGCCGCGTGCGGGACGACGGCCTTCGGGTTGTAAACCGCTTTCAGCAGGGAAGAACCTTTGACGGTACCTGCAGAAGAAGCCCCGGCTAACTACGTGCCAGCAGCCGCGG	TGGGGAATTTTGCGCAATGGGGGCAACCCTGACGCAGCAACGCCGCGTGCGGGACGACGGCCTTCGGGTTGTAAACCGCTTTCAGCAGGGAAGAACCTTTGACGGTACCTGCAGAAGAAGCCCCGGCTAACTACGTGCCAGCAGCCGCGG	0.0
TGGGGAATTTTGCGCAATGGGGGCAACCCTGACGCAGCGACGCCGCGTGCGGGACGAAGTCATTCGTGACGTAAACCGCTTTCAGCGAGGAAGAACCATGACGGTACTCGCAGAAGAAGCCCCGGCTAACTACGTGCCAGCAGCCGCGGT	TGGGGAATTTTGCGCAATGGGGGCAACCCTGACGCAGCGACGCCGCGTGCGGGACGAAGTCATTCGTGACGTAAACCGCTTTCAGCGAGGAAGAACCATGACGGTACTCGCAGAAGAAGCCCCGGCTAACTACGTGCCAGCAGCCGCGGT	0.0
TGGGGAATTTTGGACAATGGGCGCAAGCCTGATCCAGCTATTCCGCGTGTGGGATGAAGGCCCTCGGGTTATAAACCACTTTTGTAGAGAACGAAAAGACACCTTCGAATAAAGGGTGTTGCTGACGGTACTCTAAGAATAAGCACCGGC	TGGGGAATTTTGGACAATGGGCGCAAGCCTGATCCAGCTATTCCGCGTGTGGGATGAAGGCCCTCGGGTTATAAACCACTTTTGTAGAGAACGAAAAGACACCTTCGAATAAAGGGTGTTGCTGACGGTACTCTAAGAATAAGCACCGGC	0.0
TGGGGAATTTTGGACAATGGGCGCAAGCCTGATCCAGCTATTCCGCGTGTGGGATGAAGGCCCTCGGGTTGTAAACCACTTTTGTAGAGAACGAAAAGACACCTTTTAATAAAGGGTGTTGCTGACGGTACTCTAAGAATAAGCACCGGC	TGGGGAATTTTGGACAATGGGCGCAAGCCTGATCCAGCTATTCCGCGTGTGGGATGAAGGCCCTCGGGTTGTAAACCACTTTTGTAGAGAACGAAAAGACACCTTTTAATAAAGGGTGTTGCTGACGGTACTCTAAGAATAAGCACCGGC	0.0
TGGGGAATTTTGGACAATGGGGGCAACCCTGATCCAGCCATGCCGCGTGCAGGATGAAGGTCTTCGGATTGTAAACTGCTTTTGTCAGGGACGAAAAGGGATGCGATAACACCGCATTCCGCTGACGGTACCTGAAGAATAAGCACCGGC	TGGGGAATTTTGGACAATGGGGGCAACCCTGATCCAGCCATGCCGCGTGCAGGATGAAGGTCTTCGGATTGTAAACTGCTTTTGTCAGGGACGAAAAGGGATGCGATAACACCGCATTCCGCTGACGGTACCTGAAGAATAAGCACCGGC	0.0
TGGGGGATATTGCACAATGGGGGAAACCCTGATGCAGCAACGCCGCGTGAAGGAAGAAGGTCTTCGGATTGTAAACTTCTGTCCTCAGGGAAGATAATGACGGTACCTGAGGAGGAAGCTCCGGCTAACTACGTGCCAGCAGCCGCGGTA	TGGGGGATATTGCACAATGGGGGAAACCCTGATGCAGCAACGCCGCGTGAAGGAAGAAGGTCTTCGGATTGTAAACTTCTGTCCTCAGGGAAGATAATGACGGTACCTGAGGAGGAAGCTCCGGCTAACTACGTGCCAGCAGCCGCGGTA	0.0
TGGGGGATATTGCACAATGGGGGAAACCCTGATGCAGCAACGCCGCGTGAAGGAAGACGGTTTTCGGATTGTAAACTTCTGTTCTTAGTGACGATAATGACGGTAGCTAAGGAGAAAGCTCCGGCTAACTACGTGCCAGCAGCCGCGGTA	TGGGGGATATTGCACAATGGGGGAAACCCTGATGCAGCAACGCCGCGTGAAGGAAGACGGTTTTCGGATTGTAAACTTCTGTTCTTAGTGACGATAATGACGGTAGCTAAGGAGAAAGCTCCGGCTAACTACGTGCCAGCAGCCGCGGTA	0.0
TGGGGGATATTGCACAATGGGGGAAACCCTGATGCAGCAACGCCGCGTGAAGGATGAAGGTTTTCGGATTGTAAACTTCTGTTCTTAGTGACGATAATGACGGTAGCTAAGAAGAAAGCTCCGGCTAACTACGTGCCAGCAGCCGCGGTA	TGGGGGATATTGCACAATGGGGGAAACCCTGATGCAGCAACGCCGCGTGAAGGATGAAGGTTTTCGGATTGTAAACTTCTGTTCTTAGTGACGATAATGACGGTAGCTAAGAAGAAAGCTCCGGCTAACTACGTGCCAGCAGCCGCGGTA	0.0
TGGGGGATATTGCACAATGGGGGAAACCCTGATGCAGCAACGCCGCGTGAGGGAAGAAGGTCTTCGGATTGTAAACCTAAGTAGTCAGGGACGAAAGAAATGACGGTACCTGAAGAGTAAGCTCCGGCTAACTACGTGCCAGCAGCCGCG	TGGGGGATATTGCACAATGGGGGAAACCCTGATGCAGCAACGCCGCGTGAGGGAAGAAGGTCTTCGGATTGTAAACCTAAGTAGTCAGGGACGAAAGAAATGACGGTACCTGAAGAGTAAGCTCCGGCTAACTACGTGCCAGCAGCCGCG	0.0
TGGGGGATATTGCACAATGGGGGAAACCCTGATGCAGCGACGCCGCGTGAGGGAAGACGGTCCTCTGGATTGTAAACCTCTGTCTTCGGGGACGAAACGAGACGGTACCCGAGGAGGAAGCCACGGCTAACTACGTGCCAGCAGCCGCGG	TGGGGGATATTGCACAATGGGGGAAACCCTGATGCAGCGACGCCGCGTGAGGGAAGACGGTCCTCTGGATTGTAAACCTCTGTCTTCGGGGACGAAACGAGACGGTACCCGAGGAGGAAGCCACGGCTAACTACGTGCCAGCAGCCGCGG	0.0
TGGGGGATATTGCACAATGGGGGGAACCCTGATGCAGCAACGCCGCGTGAGGGAAGAAGGTTTTCGGATTGTAAACCTCTGTCTTTGGTGACGATAATGACGGTAGCCAAGGAGGAAGCTCCGGCTAACTACGTGCCAGCAGCCGCGGTA	TGGGGGATATTGCACAATGGGGGGAACCCTGATGCAGCAACGCCGCGTGAGGGAAGAAGGTTTTCGGATTGTAAACCTCTGTCTTTGGTGACGATAATGACGGTAGCCAAGGAGGAAGCTCCGGCTAACTACGTGCCAGCAGCCGCGGTA	0.0
TGGGGGATATTGCGCAATGGGGGAAACCCTGACGCAGCAACGCCGCGTGAAGGAAGAAGGCCTTCGGGTTGTAAACTTCTTTAAGTGTGGAAGATAATGACGGTACACACAGAATAAGCCACGGCTAACTACGTGCCAGCAGCCGCGGTA	TGGGGGATATTGCGCAATGGGGGAAACCCTGACGCAGCAACGCCGCGTGAAGGAAGAAGGCCTTCGGGTTGTAAACTTCTTTAAGTGTGGAAGATAATGACGGTACACACAGAATAAGCCACGGCTAACTACGTGCCAGCAGCCGCGGTA	0.0
TGGGGGATATTGCGCAATGGGGGAAACCCTGACGCAGCAACGCCGCGTGAAGGAAGAAGGTCTTCGGATTGTAAACTTCTTTTGTCAGGGACGAAGAAAGTGACGGTACCTGACGAATAAGCTCCGGCTAACTACGTGCCAGCAGCCGCG	TGGGGGATATTGCGCAATGGGGGAAACCCTGACGCAGCAACGCCGCGTGAAGGAAGAAGGTCTTCGGATTGTAAACTTCTTTTGTCAGGGACGAAGAAAGTGACGGTACCTGACGAATAAGCTCCGGCTAACTACGTGCCAGCAGCCGCG	0.0
TGGGGGATATTGCGCAATGGGGGCAACCCTGACGCAGCAACGCCGCGTGAAGGATGAAGGTTTTCGGATTGTAAACTTCTTTTATTAAGGACGAAACTTGACGGTACTTAATGAATAAGCTCCGGCTAACTACGTGCCAGCAGCCGCGGT	TGGGGGATATTGCGCAATGGGGGCAACCCTGACGCAGCAACGCCGCGTGAAGGATGAAGGTTTTCGGATTGTAAACTTCTTTTATTAAGGACGAAACTTGACGGTACTTAATGAATAAGCTCCGGCTAACTACGTGCCAGCAGCCGCGGT	0.0
TGGGGGATATTGGTCAATGGGGGAAACCCTGAACCAGCAATGCCGCGTGAGGGAAGAAGGTCTTCGGATTGTAAACCTAAGTAGTCAGGGACGAAAGAAATGACGGTACCTGAAGAGTAAGCTCCGGCTAACTACGTGCCAGCAGCCGCG	TGGGGGATATTGGTCAATGGGGGAAACCCTGAACCAGCAATGCCGCGTGAGGGAAGAAGGTCTTCGGATTGTAAACCTAAGTAGTCAGGGACGAAAGAAATGACGGTACCTGAAGAGTAAGCTCCGGCTAACTACGTGCCAGCAGCCGCG	0.0
